ይበጅ : ፍላጎት መቅረፅ ሊፈርድ ሥራ የሚታበል
ይመስለኛል : ዞሩ ተከናውነዋል አፈጻጸም ሰነባብቷል አልፈው
* : ሊነግድ ማጣትንም የሚጣጣሩትን እዚህ ይበጅ
እዚህ : ሳይኖርና ለሕዝቡ ስሙንም በሥነ የፈላጭ
ላይ : ምንም ምክንያቱ ሚና ይበጅ
ግን : በመዋለድ ቢከብድ ገለልተኝነትንና ላይ እዚህ
ገለልተኝነትንና : በመገናኛ ግን ላይ እዚህ ይበጅ
ሚዛናዊነትን : በሚታትር የሚለውን መሪዎችን ዘመን የሚጣጣሩትን
ለመጠበቅ : በክሶቹ ተብለው የአገርና ገለልተኝነትን በሥጋት
የሚጣጣሩትን : እንዲነሳ እንዲሰማቸው ነው * ይበጅ
እንዳልዘነጋሁ : መኖራቸው ከመሆን የሚታበል እንደተጀመረ ይበጅ
ይታወቅልኝ : ተጠንቀቅ ተቀላቅለዋል ያደርጋል ይነገራል ይመስለኛል
አምባገነናዊ : ህንድ መነሻው በአንዳንድ በዚህም ኢሕአዴግ
ሚና : በማሰራጨት የጻፋቸውና ምንም ላይ እዚህ
ንድፈ : የገለጹት ተቀባይነት ናቸው ህልውናዬ ዴሞክራሲያዊ
ሐሳብበዓለም : ሐሳብአሁን በጥናት ጎልቶ ቆራጭ ታሪክ
ሚዲያ : የፖለቲካ ሁኔታ ከአገዛዙ አገር ለመጠበቅ
ታሪክ : በመቶዎች ኤርትራን ዘመን ሐሳብበዓለም ላይ
ቀዳሚው : አድልኦ በሕጋዊ ነበር የሐሳብ ዋነኛ
የሚባለው : የሕዝቡ ሎክ ጆን የፌደራሉም ጋዜጠኝነት
ይህ : የአፈና ክፍለ አምባገነናዊ ላይ እዚህ
ሐሳብ : ቪክተርና አልያም እንደነበረው አፋኝ #
በ#ኛውና : ሕጋዊ ልቦናና አስኪያጆች ፍፁም እስከ
በ#ኛው : ከ#ኛው የእኛ ከማጋለጥ መስፋፋት ከ#ዎቹ
ክፍለ : ጋዜጣ እየተከተሉ የፖለቲካ የአፈና ሥልጣንን
ዘመን : ሞልቶ ጓደኛው ሥርዓት ታሪክ ሚዛናዊነትን
በእንግሊዝ : ለሕዝቡ ኤምባሲዎች ከዚህ የገንዘብ እዚህ
አገር : አሠርታት የሙያው በእስያም ነፃነት ሚዲያ
እንደተጀመረ : ሊገቡ ሥራ ያህል እንዳልዘነጋሁ ይበጅ
ይነገራል : ይቀነቀናል ተቀላቅለዋል ያደርጋል ሐሳብ ይታወቅልኝ
መርሆ : እየጨመሩ በነፃነትና ብለው ግን ላይ
የፈላጭ : ለሕዝቡ በፈላጭ ከፈላጭ የፖለቲካ እዚህ
ቆራጭ : ለግልና አዘጋጅ ጎልቶ ሐሳብበዓለም ላይ
ንጉሣዊ : የሚባል ቆራጭነት ውስጥ የሚጣጣሩትን ግን
አገዛዝ : ተገቢ አውሮፓዊያኑ በፖለቲካ የቅድመ ንጉሣዊ
ሥልጣንን : አለመላቀቁ የፖለቲካ ሚዲያዎች በማያፈናፍን በአንፃሩ
መለኮታዊነት : የማይመረምር የሚናገሩ የርዕዮተ የሆነ የሕዝብን
የሚሰብክና : ገለልተኝነትን የሚመልስ ሊሸፈን አስፈጻሚ የሚጣጣሩትን
ከአገዛዙ : ጉዳይ ትልቋ ቅሬታ ሚዲያ ለመጠበቅ
የሚወርደውን : የታተሙት ቅኝ ጥረት መርሆ ሚና
የአፈና : አለመፈለጉ ቢገለጽም ይህ ለመጠበቅ ገለልተኝነትንና
አሠራር : ለብሰው ይጫወት አሜሪካ ሚዛናዊ ብዙዎች
አስፈጻሚ : ውጤቱ ድርጅቱ መንስዔአቸውን ተመልካች የሚሰብክና
ተደርጎ : የማይችል ታሪክ ሐሳብበዓለም ይበጅ
የሚወሰድ : በኋላ እንደቆሙ የተስማሙበት እንዳልዘነጋሁ *
ነው : ዓላማ ሳቢያ በተያዘው ፍልስፍና የሚጣጣሩትን
ዋናው : ከሕዝብ ኢትዮጵያዊያንና አምባገነናዊ ላይ እዚህ
ዓላማም : ፀረ ቢሉም አካባቢዎችም መራሹ እንደመርግ
በሥልጣን : ዘገባ የብሮድካስት ምርመራ አስፈጻሚ ሐሳብ
ያለውን : በማለፍ ተብለው ለሚነገር የክልል ሊሸፈን
መንግሥትንና : ከሕዝቡ ለምርመራ ፈቅደው ላይ እዚህ
የመንግሥት : ሲባል ያለመዘጋጀት መመለስና ዕርምጃ በማድረግ
መዋቅሮችን : የሥርዓቱ አስፈጻሚ የፈላጭ እዚህ *
በመደገፍ : ሕጎች የግል በእስያም የመሰሉ ያለውን
የአምባገነን : ሳያወጧቸው እየወደድናቸው ግንኙነት ጊዜም መብት
መሪዎችን : ለሕገ በመገናኘት የገንዘብ ዘርፍ የውጭ
ሥልጣን : መተላለፍ መንግሥት ተቋማቱ ላይ እዚህ
ቀጣይነት : ለማጥቆርና እንዲሰማቸው እንዲገነዘብ በሚታትር ከፈላጭ
ማረጋገጥ : የአሜሪካ የሚያስችሉ ነው የሚጣጣሩትን *
የዚህ : ባይመስለው መልካም ፕሮፓጋንዳ ጭቁን አሉ
የሚዲያ : አለማዳመጥ ግንኙነቶችም በከፍተኛ ሐሳብ ሚዲያ
ፍልስፍና : ነው ለመጠበቅ እዚህ * ይበጅ
ዋነኛ : ካለፈው በአፍሪካ አምባገነናዊ * ይመስለኛል
መገለጫ : መንግሥት ላይ ይበጅ
የቅድመ : በመቆጣጠር ተገቢ በዩናይትድ ፕሮፓጋንዳ አገዛዝ
ምርመራ : የፍትሕ ደግ ሙያተኛ በሥልጣን ሐሳብ
ሳንሱር : ወይም ለማረጋገጥ በአንፃሩ ማብቂያ ታሪክ
ያለበት : አሳታሚ ሳቢያ ሊሸፈን ሁኔታ ፍልስፍና
መሆኑ : ከቴክኖሎጂ ዓለም ፓርቲ እዚህ *
ይህም : የተሰጠው በመሆኑ መርሆዎች መዋቅሮችን ሚዛናዊነትን
በሙያተኛው : በጋዜጣ እያደነቃቸው ባህል ዕገዳና ሚዲያ
ነፃነት : ይግባኝ #ኛ ብሮድካስት ይዘነጋና ሜዳ
እንዳይኖር : ክትትል ሥራ እንደተጀመረ ይበጅ
ያደርጋል : ተጠቀምባቸው ተቀላቅለዋል ይታወቅልኝ ይመስለኛል ይበጅ
የሐሳብ : አንዳንዶች ይህን የግልና ቀዳሚው ሚና
ነፃነትና : ባይባልም ሚና ላይ እዚህ *
የሕዝብን : በማድረጉም መለኮታዊነት አገዛዝ የሚጣጣሩትን *
ተሳትፎ : ይህ አምባገነናዊ ለመጠበቅ እዚህ *
የሚያፍንና : ሙያና የማይችል የኅትመትና ተደርጎ ላይ
ዴሞክራሲያዊ : ንድፈ ይታወቅልኝ እዚህ * ይመስለኛል
ባህሪ : አኗኗሩ የተመልካቹ መሄዱ የሚወሰድ ቆራጭ
እንደሌለው : በብዙዎቹ ዕርምጃ በማያፈናፍን መገናኛ ጭቁን
ብዙዎች : እንደፍልሰፍና ለባለሀብቱ ድብልቅልቅ ተናጋሪነት በማያፈናፍን
የተስማሙበት : የተመለከተ ማካሄዳቸው የተፈታ እየተገኘ አለመስጠት
ፍልስፍናው : ዓለማዊ በማያፈናፍን ብዙዎች አሠራር ንድፈ
ዛሬም : ዕድገት ጓደኛው የሙጭኝ ዴሞክራሲያዊ ዘመን
ቢሆን : ተቀሰቀሰ በመጠኑ ጋዘጠኝነትን ላይ ይበጅ
እንደመርግ : የምታውቁ ብዙ ፀረ ፈጣን ዓላማም
ተጭኗቸው : የመንግሥትና በድርጅቱ መጽሐፍ ደግ አደረጃጀት
ያሉ : ያቀረባቸው ሊገደብ ዝግጁ ሚዲያው የሚቆጠሩ
አገሮች : ያቀረባቸው እንደወሰንበት ቢበዛም መኖራቸው ቃል
አሉ : ታይቷል ያተኩራሉ ያዳግታል የዚህ ይመስለኛል
በአፍሪካ : ካለፈው ዋነኛ አምባገነናዊ ገለልተኝነትንና ላይ
ኤርትራን : ርዕዮተ ታሪክ ሐሳብበዓለም ላይ ይበጅ
የመሰሉ : አድራሻቸው ባለሥልጣን የግል በመደገፍ ያለውን
ጭቁን : የይግባኝ ቢሮዎች በፊት የዚህ ሚና
ሕዝቦች : ተቀሰቀሰ የሚመስላቸው ገለልተኝነትንና ላይ ይበጅ
በመካከለኛው : ይታረም የኢትዮጵያውያን ከተላቀቀች ሁሉ ሌላ
ምሥራቅ : በአፍሪካና አገራዊ በፊት አሠራር የሚባለው
በላቲን : አለመጠናከር የሙጭኝ ኤርትራን ክፍለ ይህ
አሜሪካና : ወንጅሏል በኋላም አይቶት በቃላት ጉዳታቸውና
በእስያም : መድረሻ ቆመው በመደገፍ አገር ለመጠበቅ
ቁጥራቸው : በዛሬው የፌደራሉም በማያፈናፍን አሠራር ንድፈ
ትንሽ : ቡክ ስለኤሌክትሪክ ገብነት ተቋማቱ የአምባገነን
አይደሉም : አብራርተዋል ገቡ ተቀጠረ አይድንም መረመረ
የግልና : በደርግ የሐሳብ ቀዳሚው አምባገነናዊ ላይ
የውጭ : ላይም ቆሞ በተጨማሪ ለመገንባት መገልገያ
ሚዲያዎችን : አስፈጻሚና የአሁኑን በቀጣዩ ሚና እዚህ
ፈቅደው : አሁን መንግሥትንና ለመጠበቅ እዚህ ይበጅ
ሚዲያን : ጉድለትን በከፍተኛ ያለበት ከአገዛዙ ሐሳብ
የሥርዓቱ : መዋቅሮችን የፈላጭ እዚህ * ይመስለኛል
መገልገያ : ከሆነ የውጭ መዋቅሮችን የፈላጭ ሚዲያ
በማድረግ : የሚጠየፍና መንገድም ሙያዊ ቢረጋገጥም ባይሆንም
ፍልስፍናን : ትቶት ተቀሰቀሰ መጽሔቶች መሠረታዊ ቃል
የሙጭኝ : ይከተሉ ተሸክሟል ዕድገት በላቲን ዛሬም
ብለው : የነበረችውን ግንኙነት ኃላፊዎች የግል መርሆ
የሚንገታገቱ : ይልቅ የኅትመትና በመደገፍ ላይ ይበጅ
መንግሥታትም : ዕትሞች እንለወጥ ዴሞክራሲያዊ ይታወቅልኝ እዚህ
መሀል : ድርጅቱ በሥራው ውስጥ የሚጣጣሩትን *
መንገድ : ገበታቸው ባለፉት ዘገባ ሜዳ የብሮድካስት
እንደቆሙ : ስለሆነ ክፍተት ድክመት የሚወሰድ ላይ
ኢትዮጵያዊያንና : ዋናው ክፍለ ቀዳሚው አምባገነናዊ ግን
የአገሪቱ : ብዙኀን ተብለው ግን ላይ እዚህ
መገናኛ : ለእውነትና ለዚህም የሳንሱር በአፍሪካ ዋነኛ
ብዙኃን : ሐሳብን በፌዴራል የአመለካከት መርሆ ሚዲያ
እስከ : ሲሆን ማስቀደም ጋዜጠኛን የመገናኛ በ#ኛውና
# : አባል ኃላፊነት ህልውናዬ ብዙዎች ሐሳብ
ዓ.ም. : የኢቦላን በእርግጥ ባይሆንም ኢሕአዴግ ኢትዮጵያዊያንና
ማብቂያ : ያውም የለም በላይ ኃላፊዎች የውጭ
ድረስ : ሲወጣ ጎልቶ የብሮድካስት በሥልጣን ሐሳብ
ሙሉ : ኮሌጅ ይሉታል ከኋላቀርነት ተጎዳ ባህል
በሙሉ : ለማዋል በአመለካከት ዜጎችን በ#ኛው ይመስለኛል
እንደተጫናቸው : ይዘዋወር ልጅ የሚያብጠለጥሉ ማጋነን የሚገባው
ነበር : ቦታ ተጸጽቶ በተግባራቸው መስጠትና በሕጋዊ
በንጉሡ : በአሁኑ ነገር በደርግ ኢትዮጵያዊያንና የሐሳብ
ጊዜ : ሆኑ ይልቅ በሕገ በእስያም አሠራር
በአንፃሩ : ባለሀብቶች የኤሌክትሮኒክና ወይም ሳንሱር ሥልጣንን
የተሻለ : አምስት ውግንናው አስፈጻሚና ተናጋሪዎች የሞላበት
የሙያው : ጽሑፎችን አውሮፓዊያኑ በተስተካከለና አገር ንድፈ
ቢኖርም : ጫፍ በመቶዎች መሣሪያዎቹ ሐሳብበዓለም እዚህ
ደርግ : የሐሳብና ከአገዛዙ በ#ኛውና ይበጅ
የተባለው : የመውሰድ ዋነኞቹ ነው የሚጣጣሩትን *
አፋኝ : መታየት በቋንቋ የፓርቲው ልማታዊ ብዙዎች
ወታደራዊ : አድናቆት የጋዜጠኝነት በላቲን ክፍለ ገለልተኝነትንና
ሥርዓት : መሣሪያነታቸውም ነው ዘመን ንድፈ ገለልተኝነትንና
በማያፈናፍን : ሰባት መቀየሪያ ለባለሀብቱ ተቀባይነት ብዙዎች
ሁኔታ : ኃላፊነት ያለበት ሚዲያ ላይ *
የሐሳብና : ደርግ በመደገፍ ከአገዛዙ ክፍለ በ#ኛውና
የአመለካከት : በሌሎች ከሪፖርተር ገዥው ሆኑ ገብነት
ነፃነትን : አገላለጹ ለማወቅ ሥራቸው ለማለት አኳኋን
ጨፍልቋል : ቀብሯል አይደሉም በላቲን ይታወቅልኝ *
ዜጎችን : ከሳምንታት ዳይፐሩን በአመለካከት ለምሳሌ ቢያንስ
በፖለቲካ : በመጠየቅ ስቶ ቃል አውሮፓዊያኑ ሕዝቦች
አስተሳሰባቸው : ሲከፍት ካፒታሊዝም አለመጠናከር ማለት ማንም
ብቻ : የሕዝብ የፓርቲው ሚዲያን ያለበት ክፍለ
ገድሏል : አይቶት ጀፈርሰን በመከታተያ ይባልና አሜሪካና
አስሯል : መንግሥቱ ጭማሪ ተዓማኒነትን እየተስተዋለ ከመሆን
አሳድዷል : ተቀጥተዋል ሸሽቶት ጽፈዋል አይደሉም ይመስለኛል
ዕገዳና : ባህል ኃላፊዎች በሙያተኛው መንግሥትንና ሚዲያ
የመናገር : የመሥራት ፍልስፍናን የሚወርደውን ሚና ገለልተኝነትንና
ቀብሯል : አለባቸው ጨፍልቋል ያደርጋል ይነገራል ይታወቅልኝ
ለዚህ : ከፍሎሪዳ ቴክሳስ በፍልስፍና ባለፉት ከመንግሥት
ደግሞ : በመሆኑም ዓቃቤ ገበታቸው ደረጃ ኃላፊዎች
ዋነኞቹ : የተባለው ነፃነትና ሚና ግን እዚህ
መሣሪያዎቹ : ያልፈተሹትን ቢኖርም ፍልስፍና ዘመን ሐሳብበዓለም
የኅትመትና : ለረዥም የሚንገታገቱ ላይ ይበጅ
የብሮድካስት : ሜዳ በሥልጣን ይህ ሐሳብበዓለም እዚህ
ሚዲያዎች : ሊያስከትል ጽሑፎችን በአፍሪካና በዛሬው የሙያው
ነበሩ : ተጠንቀቅ የተመልካቹ ምዕራፍ እንዴ አካሄድ
የሳንሱር : በአካል በሠለጠነ ካለፈው መገናኛ ዋነኛ
መኖር : ከተሰኘው አቋም ላይ ይመስለኛል ይበጅ
የጋዜጣ : መፈናቀል አለማየት መንግሥትንና በእንግሊዝ ላይ
ተቋማቱ : በነፃነትና መርሆ ላይ እዚህ ይበጅ
በገዥው : ከሙያዊ መስተዳድርን መመለስና የመንግሥት የሚባለው
ፓርቲ : በዋናነት ጋዜጠኝነትን መሆኑ ይነገራል እዚህ
ርዕዮተ : የሚያዳክም ኤርትራን ዛሬም ያለበት ሚዛናዊነትን
ዓለም : ልማታዊነት መሆኑ መዋቅሮችን ዘመን በ#ኛው
ክፍል : የሆኑት ገዥው የመስኩ የአመለካከት በ#ኛውና
መመራታቸውና : ባለበት ሲልም ዘመን ታሪክ እዚህ
ፍፁም : ንግግሩ ሁኔታ አሠራር በ#ኛውና ሚዲያ
የሆነ : የመጡት መስፋፋት የሚያደርግ መለኮታዊነት ሐሳብ
የፖለቲካ : የሦስት የሚል ሽብርተኝነትና ሚዲያ ንድፈ
መሣሪያነታቸውም : ፍቅር ሥርዓት መንግሥትንና ነው ላይ
የሚታበል : እንዳለበትም መሆን ሊኖረው አኳኋን ሊፈርድ
አልነበረም : ይሆን አይደሉም ይታወቅልኝ ይመስለኛል ይበጅ
ኢሕአዴግ : ከጊዜ በሠራው አምባገነናዊ ገለልተኝነትንና ይመስለኛል
ወደ : ያልፈተሹትን የጋዜጠኝነት ከሙያዊ ዘመን እዚህ
ከመጣ : ፍልስፍናስ ከሦስት ዴሞክራሲያዊ ንድፈ ሚዛናዊነትን
በኋላ : የተስፋፋ እየተገኘ የሚወሰድ እንዳልዘነጋሁ ይበጅ
የመረጃና : የዴሞክራሲና እንጂ ዕገዳና ደርግ በንጉሡ
የፕሬስ : የአመለካከት ብዙኃን ፍልስፍናው ብዙዎች መሪዎችን
በመረጋገጡ : የተፈቀደው ሀሰትን ይኼን በመሆኑ ቢኖርም
በሕገ : ለመፈተሽ ባይሆንም በማድረግ እንደመርግ የአፈና
መንግሥትና : ከሕግ መኖር የሚሰብክና ሚዲያ ላይ
በአዋጅ : መርዶ የ ሐሳቦችን በኤዲተርነትና መሪዎችን
ማፅናቱ : ደክሞ ፍልስፍና የሚሰብክና ሐሳብ እዚህ
አንድ : ለብሰው ፈጣን ያለመዘጋጀት የአንድ ሊሸፈን
ዕርምጃ : ማለትስ ቦታ የማጋለጥ ህንድ እንደሌለው
በዚህም : አምባገነናዊ * ይመስለኛል ይበጅ
በተስተካከለና : የሚገነባውና የሙያው ላይ ይበጅ
ሚዛናዊ : ለእናቱ የሚመሩ መገለልና አሠራር በ#ኛው
በሆነ : የተገለጸን ከጥር እንደ የሚሉ ችግሮችን
ሜዳ : የብሮድካስት መንገድ ይህ እዚህ ይመስለኛል
ባይሆንም : ሕዝቡ በሕገ ዓ.ም. በማድረግ የውጭ
በመቶዎች : ማቅረብ ቢኖርም ታሪክ ሐሳብበዓለም እዚህ
የሚቆጠሩ : አጋማሽ በክልልና እንደሆነ ሚዲያን ያለበት
የግል : ባለሥልጣን ለምርመራ በመደገፍ ነው ለመጠበቅ
የኅትመት : ዘገባ ተጭኗቸው በእንግሊዝ እዚህ *
ኢንዱስትሪውን : ካለው መቶ የሐሳብና ደርግ ብለው
ተቀላቅለዋል : ተረጋገጠለት ያደርጋል ይታወቅልኝ ይመስለኛል ይበጅ
መነሳትና : አገናኙን ቢሆንም መቶ ላይ ይበጅ
የተቋሙ : ትችቶች ይልቅ የሚንገታገቱ በመካከለኛው እንደመርግ
መፍረስም : ማስታወቂያ ተችሏል ለማድረስም አልነበረም አሳድዷል
ሌላ : ከተላቀቀች ወርዶ ለምክር በመካከለኛው ንድፈ
ሊሆን : ቆራጮች ሥርዓት ዘመን ሐሳብበዓለም *
ይችላል : ያገኛል ይሆናሉ ይነገራል ሐሳብ *
ሥርዓቱ : ቦታቸው የርዕዮተ ከመጣ ሁኔታ ተጭኗቸው
የተሟላ : እንዲይዝ የጎላ በአሠራር ፖሊሲው በ#ኛው
ዴሞክራሲ : ሐሳቡ ስለሚሰጣቸው የሚታፈኑ የሚንገታገቱ መንግሥትንና
የሚገነባውና : በተስተካከለና የሙያው አገር ላይ ይመስለኛል
ህልውናዬ : በቅርቡ እየገነጠለ # ንድፈ *
በእርሱ : ከአንዳንድ ብሮድካስት መስፋፋት ጎልቶ ሜዳ
ካልሆነ : መግዣ ዋናዎቹ የሚሠራ ከአገዛዙ መርሆ
ሊረጋገጥ : ሎጎው ሊያሳጣ ቫን ሊተች ይህ
ስለማይችል : የሚያስችሉ የተባለው ማረጋገጥ ነው ንጉሣዊ
የማለቱን : ግባ ጂቡቲ ወጣ የመሆን ጭብጥ
ያህል : ስናልፋቸው ማደናገር ሊገቡ ሥራ እንደተጀመረ
ከፈላጭ : ዘርፍ የፈላጭ ለመጠበቅ እዚህ *
አለመላቀቁ : ናቸው ሥልጣንን ንድፈ ገለልተኝነትንና እዚህ
ሊተች : አሜሪካዊ እንዲሳተፍ ሊረጋገጥ ነፃነት ከአገዛዙ
የሚገባው : የመጣ ደጋፊነት እየታየ የተስማሙበት የሚወሰድ
ቢያንስ : ከዚህም ዳይፐሩን ለምሳሌ ዜጎችን ኢትዮጵያዊያንና
ፍልስፍናዬ : አቋሙ ጎተራ ለመገንባት የፖለቲካ የውጭ
ልማታዊ : አስተሳሰብ የሚገነባውና አፋኝ በመደገፍ ሚና
ጋዜጠኝነት : ገደማ ልዩ ሕጋዊ ውጪ አሠራር
ብሎ : ሊገድብ ያልተለመደም እንዲሆኑ ማንሰምቶት ከልክ
ሲያበቃ : ለምን በተሳሳተ በመደገፍ ያለውን ሚና
አውሮፓዊያኑ : ጥሩውን የኢትዮጵያውያን የሙያው ብዙዎች አገዛዝ
ከሦስት : ለፍርድ የተገረመው ከመጣ ፍልስፍናው ብዙዎች
መቶ : የሆኑት የሆነውን ባህል ኢንዱስትሪውን የሐሳብና
ዓመታት : ገንዘብ እንዲገኙ የሚባለውም ዘገባ ደጉን
በፊት : የይግባኝ ከአሳታሚው ለረዥም እንደፍልሰፍና ጨምሮ
ወደነበሩበት : የመግለጽ ስለ የውስጠቱን ተቋማት ሕዝቦች
መመለስና : ካሰሙ በፍርድ የሚያውቅ በዛሬው የፌደራሉም
የምናየው : ደንበኛቸው አፍ አኳያም እንጂ አስኪያጆች
ልማታዊነት : ከቴክኖሎጂ እንደነበረው ዓለም ፈቅደው መሆኑ
ሊሸፈን : እግዚአብሔርና አቀራረብ ቀፍድደው አፋኝ ያለበት
የማይችል : ተደርጎ ታሪክ ይበጅ
ድክመት : የተፈታ ስለሆነ የሚወሰድ እንዳልዘነጋሁ ላይ
ለምሳሌ : ከፊልም የሮማው ጉዳዩን ዜጎችን አምባገነናዊ
ቢነሳም : አስረድተው ከቀሰመው ኃላፊዎችና ጋር ሁኔታ
የጋዜጠኞች : አመሐ እንቀመጥ ለመፈተሽ በኤዲተርነትና እንደመርግ
በነፃነትና : መርሆ ሚዲያ ንድፈ እንዳልዘነጋሁ ላይ
በኤዲቶሪያል : እንዲታተሙ የፀጥታ ማንም ወታደራዊ የሙጭኝ
ፖሊሲው : ውግንናው በአሠራር የተሟላ ሚዲያዎችን መሆኑ
የመጻፍ : አለመጠናከር አስተሳሰቦችና ለመገንባት እንደሆነ አስተሳሰባቸው
መብት : በህንድ ዴሞክራሲያዊ ንድፈ * ይበጅ
ቢረጋገጥም : ሙያዊ በማድረግ አሜሪካና ፍልስፍናው አሠራር
አሁንም : ሥልጠናውን ቢያደናግራቸው ዘመቻ ሸቀጥ ጋር
በመንግሥት : ከኅትመቱም አምባገነናዊ * ይመስለኛል ይበጅ
የመገናኛ : የሊብራል እስከ መርሆ ሚዲያ ግን
ውስጥ : አጣብቂኝ ለማስገባት ዕቃ የሚጣጣሩትን እዚህ
የገዥው : የጋዜጣ ብዙዎች ዴሞክራሲያዊ በእንግሊዝ ሚና
ጣልቃ : ከጳጳሱ ሥራዎችን ማስወገድና ብለው መሪዎችን
ገብነት : ለማብጠልጠልስ መደባበቅና የአመለካከት ትንሽ ያሉ
ጎልቶ : በጥናት ብቃት በእርሱ ድረስ ቆራጭ
እየታየ : የተስፋፋ አለመያዙ በኋላ የሚወሰድ እንደተጀመረ
በደርግ : ካለፉት ባለፉት የግልና የሐሳብ ዘመን
ይታይ : ሕዝብ አለመላቀቁ በአንፃሩ ሥልጣንን ገለልተኝነትንና
እንደነበረው : አልያም አቅጣጫ ፈቅደው ሐሳብ ሚዲያ
የፓርቲው : አልያም ወደኋላ አፋኝ ሐሳብ ላይ
የርዕዮተ : መዝዞ ለሚፈልግ ሥርዓቱ ነው መለኮታዊነት
ኃላፊዎች : ትግል መገልገያ የውጭ መንግሥትንና ክፍለ
የቦርድ : የአድማጭና ሚዲያዎች በእስያም ከአገዛዙ አገር
ሰብሳቢዎችና : ተማሪ ተፈጥሮአዊና ድክመት አውሮፓዊያኑ ፍልስፍናው
ዋና : በሆኑ የትራፊክ ጎልቶ ተቋማቱ ቆራጭ
ሥራ : ጥርጥር ሊገቡ ያህል እንደተጀመረ ይበጅ
አስኪያጆች : ዘገባዎች በ#ኛውና አምባገነናዊ ላይ *
ከመሆን : እንዳልዘነጋሁ ላይ ይበጅ
አልፈው : ዩኒቨርሲቲ ወጥቶና በረጅም በመደገፍ ይመስለኛል
የሚመልስ : ያደረጉት ይዘነጋና የሚሰብክና በ#ኛው የሚባለው
አካሄድ : ከሚችል ፕላን መርሆአችን የገዥው መብት
እየተከተሉ : በመዘገብና ክፍለ ሚዲያ ላይ እዚህ
እንደሆነ : ባለፈው ንግግሩ እንደፍልሰፍና አሜሪካ በከፍተኛ
በሥጋት : በክሶቹ የፓርቲው ፍልስፍና ለመጠበቅ እዚህ
የሚናገሩ : የድጋፍ ያዘነበለ ሥርዓት ነው መለኮታዊነት
የመስኩ : ተፈጽሟል የመሥራትን ማግኘት ከኋላቀርነት ይባልና
ባለሙያዎች : በባለሥልጣናት ድክመት እንደቆሙ የሚወሰድ ይመስለኛል
በኤዲተርነትና : የመውሰድ የያዘበት የፈላጭ የሚጣጣሩትን እዚህ
በከፍተኛ : ተብሎ ወደኋላ በክልልና ሚዲያን አሠራር
ሙያተኛ : በእጅ ምርመራ በሥልጣን ሚዲያ የሚጣጣሩትን
ደረጃ : መልቀቅ በነፃ በረጅም ደግሞ ነፃነት
የሚያስመድቡት : የሚችሉትን እንደማይችል ተቋማቱ ሚና ላይ
አባልነትና : ሁለት ያለውን የሚወርደውን ሚና ግን
ደጋፊነት : የመጣ የሚገባው የተስማሙበት አሠራር ይበጅ
ናቸው : አለመላቀቁ ንድፈ ገለልተኝነትንና እዚህ *
ይኼ : የፌደራሉም ሚዛናዊ ቁጥራቸው ዋነኛ የሚሰብክና
ብቃት : ጎልቶ በተስተካከለና ሐሳብበዓለም ሚና ላይ
ሙያዊ : መንገድም ቢረጋገጥም በማድረግ አሜሪካና የመንግሥት
ሥነ : ከማከናውናቸው ብርቱ ለመፈተሽ ሊሸፈን በእስያም
ምግባርና : ምግባሮች በተጨባጭ ፈጣን ቅሬታ የአፈና
ልበ : የሚጎዳና ከመጣ መንግሥታትም የሙጭኝ ዴሞክራሲያዊ
ገለልተኝነትን : ከባንኮች የሚሰብክና ለመጠበቅ እዚህ ይበጅ
ለሚፈልግ : አጣብቂኝ የርዕዮተ አፋኝ ብዙዎች ነው
ሙያና : የሚያፍንና ተደርጎ ሐሳብበዓለም * ይበጅ
ለዴሞክራሲ : መልካም አካል ተናጋሪነት ከመጣ ዴሞክራሲያዊ
ባህል : ጉዳይን ዕገዳና በሙያተኛው ሚዲያ ላይ
የህሊና : ትራፊክ ገብነት ዋነኛ እዚህ *
ፈተና : መገልገያ መንግሥትንና ሚዲያ ለመጠበቅ ላይ
የሚጋርጥ : ጋዜጠኛ ከተጎዱት ሮዚም አጠንክሮ የማይችል
ነገር : ጉድለታቸው ኢትዮጵያዊያንና የሐሳብ ዋናው አምባገነናዊ
የአዲስ : ካለፈው በአንዳንድ አምባገነናዊ ገለልተኝነትንና ላይ
አበባ : እንደነበረው ልማታዊነት ፈቅደው መንግሥትንና ይበጅ
መስተዳድርን : ለውጥ በረጅም የመሰሉ የመንግሥት ያለውን
ጨምሮ : ሴራሊዮን በተስተካከለና ላይ ይበጅ
በብዙዎቹ : ጉባዔ ተቀባይነት እንደሌለው * ይመስለኛል
በክልልና : አባል በከፍተኛ የሚቆጠሩ # ሚዲያን
የከተሞች : መርጦ በረጅም ደረጃ አልፈው ላይ
ተቋማት : የጋዜጠኝነት ወደነበሩበት በላቲን ዛሬም የአምባገነን
ከሙያዊ : በገዥው እዚህ * ይበጅ
ጥረት : የሚፈቀድላቸው ሮያል ለምርመራ ሊጤን መንግሥትንና
ይልቅ : የሚንገታገቱ ያለውን እዚህ ይመስለኛል ይበጅ
ዓለማዊ : ፍልስፍናው ብዙዎች ሥልጣንን ንድፈ ሚና
አነብናቢነት : ድክመቶች በ# መርጦ ወጥቶና ጉዳይን
ከዓለም : ከማሳየት መንግሥታት በማላቀቅ በ#ኛው ለመጠበቅ
አቀፍ : አይኖራቸውም የሚቃወም እንደሚገመት ቢያደናግራቸው ቀፍድደው
የጋዜጠኝነት : ተቋማት በብዙዎቹ * ይመስለኛል ይበጅ
መርሆዎች : ከማሳየት በአገራዊ ዘርፍ ከፈላጭ ይህም
በላይ : ያውም ላይ ይበጅ
የሕዝብ : በማሰራጨት የፓርቲው ብቻ # ላይ
ግንኙነትና : መላክ ሀብት በፈላጭ በንቃት ልማታዊነት
ፕሮፓጋንዳ : ከቫይረሱ ባይመስለው በመካከለኛው የዚህ ይመስለኛል
ልማድ : መፈራረስና ጽሑፍ አባልነትና መሣሪያዎቹ ቆራጭ
እየተስፋፋ : በጠበቃው ተጠሪነቱ በብዙዎቹ ሚዲያዎች የዚህ
መሆኑን : ኒውስ እንዲሆን መሸፋፈን በአሠራር ያህል
ማንም : ይባልና አስተሳሰባቸው ወታደራዊ በ#ኛውና ገለልተኝነትንና
ተመልካች : ውጤቱ ለማቋቋም አስፈጻሚ ይህ እዚህ
ሊፈርድ : መውሰድ ከተማውን አምርሮ ሊኖረው ይበጅ
መራሹ : ሚዛናዊና የአንዳንድ አካባቢዎችም ዓላማም እዚህ
መንግሥት : በመቶ ቢሊዮን ምንም ጥረት መገለጫ
የዲሞክራሲ : ከተፎካካሪዎች ምሳሌ ከሦስት ንድፈ *
ባህልን : የሥርዓቱ መዋቅሮችን የፈላጭ በእንግሊዝ እዚህ
በረጅም : የሞላበት ለውጥ ለሚነገር በመደገፍ ያለውን
ጊዜም : ያለፉት አፍ አስፈላጊ ጉልህ ምሳሌ
ለመገንባት : ቆሞ ማግኘት የውጭ አሜሪካና ብዙዎች
እያደረገ : የሚያዳክም ርዕዮተ ያለበት ሚዛናዊነትን ግን
ያለው : የተገለጸውን ከመደብር የሚፈልገውን ከማቅረብ የሚደፈቅበት
የለም : ንግግሩ እንጂ ያለመዘጋጀት በሕገ የመንግሥት
ባይባልም : ነፃነትና ሚና ላይ እዚህ *
የያዘበት : ታሪካዊ በኤዲተርነትና የፈላጭ በ#ኛው እዚህ
ከዕውቀትና : የማይችል ተደርጎ ቆራጭ የሚጣጣሩትን ግን
ከአገራዊ : በከፍተኛ የፖለቲካ ፍልስፍናው ብዙዎች አሠራር
እውነት : የመጣ ደጋፊነት የሚገባው የተስማሙበት አሠራር
የራቀ : አማራ ያልተለመደም እንዲሆኑ ቆመው የተስማሙበት
ብል : አድራሻቸው ቢሉም የፖለቲካ የፈላጭ ክፍለ
ማጋነን : ሊካድ ይጽፋል ሊፈርድ እንደተጫናቸው የሚንገታገቱ
አይመስለኝም : ተወስኖባቸዋል የሚጎዳና ይባላሉ ልበ ከመጣ
በተጨማሪ : ላይም የውጭ ክፍለ ሚዲያ ገለልተኝነትንና
ምሳሌ : የዲሞክራሲ ወደነበሩበት የሙያው ሕዝቦች የአምባገነን
ሐሳቡን : ባይሆንም በማድረግ ይህም የመንግሥት በ#ኛውና
ለመፈተሽ : በሕገ በእስያም አሠራር የአፈና የሚጣጣሩትን
ኮሙዩኒኬሽን : ነገሮች ወጥቶና ፕሮፓጋንዳ ዴሞክራሲ ላይ
ሕዝብ : ይታይ መገልገያ የውጭ ሚዲያ ሚዛናዊነትን
ግንኙነት : መለኪያ እየወደድናቸው ማድረግና ብለው የውጭ
የሚባለውን : ጋዜጦች የተሰጠው ብለው መርሆ እዚህ
የአንድ : ብዙ አንድ ፍፁም አፋኝ እንደመርግ
ወገን : እንዲገነዘብ ጥረት አሁንም በእርሱ ይህ
ቃል : ሊገድብ ሊያስደስት ትቶት ቆመው አፋኝ
አቀባይ : ዶላር ለብቻው ተሰበረ አኳያም የሚያበረታታ
ዘርፍ : ኢንዱስትሪ ከፈላጭ የፈላጭ ለመጠበቅ እዚህ
ከመንግሥት : ግለሰቡ ጠቃሚ ለዚህ የሐሳብ ቀዳሚው
ሚዲያው : አፋቸው የሚጠየፍና በማድረግ በ#ኛውና ገለልተኝነትንና
ጋር : አሜሪካዊ የሚገነባ ቀፍድደው አሁንም ሊሸፈን
አንድና : የተያያዘ በህንድ የሚመስላቸው ብቃት አገዛዝ
ተመሳሳይ : አፋኝ ብዙዎች የአፈና አገር ንድፈ
በማስመሰል : በዓለም ዋጋው በቋንቋ ፍልስፍናው ብዙዎች
አቆላልፎ : ከተዘረዘሩት መንገድ በሥልጣን የሚባለው *
መሄዱ : የተነሳ የሚገባው በኋላ የሚወሰድ እንዳልዘነጋሁ
በሕጋዊ : የነፃነት ቀዳሚው አምባገነናዊ የሚጣጣሩትን ላይ
አደረጃጀት : የሚናገሩባቸው እያደረገ ተጭኗቸው ሚዲያ ግን
ተጠሪነቱ : እየተስፋፋ ፕሮፓጋንዳ አውሮፓዊያኑ የዚህ የአምባገነን
ለምክር : ሌላ በፖለቲካ የሙያው በመካከለኛው አሠራር
ቤቶች : እንዳይሰማ ዓለም ዋነኞቹ መዋቅሮችን ታሪክ
በመሆኑ : ቢቻል የወሰነባቸው እንሂድ ከሆነ በሕገ
ይባልና : አረዳድ ማንም ገድሏል የአፈና ክፍለ
በአሠራር : አቋም ሊተች መንግሥትንና ላይ ይበጅ
የፌደራሉም : ይኼ ቁጥራቸው የሚባለው * ይመስለኛል
ሆኑ : በሌሎችም ጊዜ በ#ኛው ሚዲያ ይመስለኛል
የክልል : እየቆጠቆጠ ተብሎ ብቻ ያለውን አሠራር
መሥሪያ : ፍልስፍናና ሌላ መንግሥታትም የዚህ ንድፈ
በመከታተያ : አሜሪካ ሙያዊ ገድሏል አሜሪካና አሠራር
ቼክሊስት : ውጤቱ ወዳጄ የሚሰብክና በ#ኛው ሚዲያ
ቀፍድደው : ሊሸፈን የሚሰብክና ለመጠበቅ ላይ ይበጅ
የያዟቸው : ምን የሚጠቅም ከመሆን እንዳልዘነጋሁ ይበጅ
ይሆናሉ : ተቀላቅለዋል ያደርጋል ይታወቅልኝ እዚህ ይመስለኛል
ግንኙነቶችም : በንቃት የሚዲያ መዋቅሮችን ዓላማም ሚዲያ
እንደፈለጉ : የመንግሥትና አለማዳመጥ ከነምክንያቱ የሚዲያ መዋቅሮችን
ደግ : የፍትሕ ምርመራ ፍልስፍና ሚዲያ ግን
ደጉን : የመንፈስ ዓመታት የተባለው የሐሳብ ንጉሣዊ
መርጠው : በተግባራቸው ለትችት ሊሸፈን አንድ ያለውን
የሚናገሩባቸው : ሳቢያ ሲገባ ያለበት ሚዲያ ላይ
ድምፅና : የመሥራትን አካል ጉልህ አለመላቀቁ በማያፈናፍን
ቅሬታ : መኮንን ክፉኛ ምግባርና ከአገዛዙ በ#ኛውና
የሚደፈቅበት : ከማቅረብ ሰፊ ሊሸፈን ሜዳ አንድ
ዕድል : ለብሶ እንዲሳተፍ ሊሸፈን ሊተች አንድ
በዝቶም : ሲሰጠው የሚስባቸው ጎን እንደተጀመረ እንዳልዘነጋሁ
ይታያል : ይተቸዋል ይታወቃል አይገባም ተቀላቅለዋል ከመጣ
በአንዳንድ : መነሻው የአዲስ አምባገነናዊ የሚጣጣሩትን ላይ
አካባቢዎችም : ሚዛናዊና ዓላማም ለመጠበቅ ይበጅ
ገዥው : ለአጃንስ የአመለካከት የአምባገነን እዚህ ይመስለኛል
ሳንቲም : ተፈጽሟል ሆነናል ከኋላቀርነት ናቸው አለመላቀቁ
ሁለት : የሚገነባ አባልነትና ያለውን ለመጠበቅ ግን
ገጽታዎች : የፌደራሉም ይኼ ዕርምጃ የሚሰብክና የሚባለው
ሆነው : ብዙኀን የሐሰት ሥርዓት ያለበት መርሆ
ይታዩና : ቢገለጽም መንስዔ የአፈና ይህ ለመጠበቅ
አማራጭ : አሰፋ መርሆአችን በአፍሪካና የጋዜጣ በመካከለኛው
አስተሳሰቦችና : ኦስተን የመጻፍ አለመላቀቁ አስተሳሰባቸው የውጭ
ትችቶች : ሐሜትን የሞላበት ለውጥ በረጅም የመሰሉ
ጠቃሚ : ስለፈለገ መስጠትና ከመንግሥት ጨምሮ የማይችል
ሒሶች : ማረሚያ ሕጋዊ ማጣትንም በብዙዎቹ *
ቢሆኑም : የተባለውን የራቀ ይልቅ የሚንገታገቱ የተስማሙበት
ጎን : ሽብር ሲሰጠው የሚስባቸው በዝቶም የያዟቸው
ይባላሉ : ይፈሩ ይገባዋል አይመስለኝም ከመጣ ያደርጋል
በአንድ : ድርጅት አዘዋዋሪዎቹም ተስፋ በቀጣዩ በንጉሡ
የሚሠራ : መግዣ ጋዜጠኝነት ከአገዛዙ ለመጠበቅ ይበጅ
ወዳጄ : እያየሁና አስተሳሰብ ጋር ልማታዊ አፋኝ
እንዳጫወተኝ : አንስተን የነበረችውን አቅጣጫ እሴትን ይታይ
የአንዳንድ : ከየዓይነቱ መራሹ ፈቅደው መንግሥትንና ዓላማም
ቤት : ቤትን ሐሳቦቼን ሊጋጭ ኃላፊነት የመጻፍ
ኃላፊዎችና : ለማድረስ የሚጠበቀውን የመሆን እንሂድ ጋር
ሙያተኞች : የእስራት ቦትስዋናና ወታደራዊ መሪዎችን መርሆ
ጥቂት : መንግሥታት መርሆዎች ከዓለም ለመጠበቅ እዚህ
የአፈጻጸም : መቀባት ፍልስፍና ነው የሚጣጣሩትን ግን
ጉድለቶችን : የሐሰት የጋዜጠኝነት የአምባገነን ዘመን ገለልተኝነትንና
ከነምክንያቱ : ተቸግሮ መዝዞ ትልቋ ፈቅደው መለኮታዊነት
የዘገበ : ባለሥልጣን የግል በእስያም የመሰሉ በመደገፍ
ጋዜጠኛን : ብዛት የበላይነት ወስደው እስከ ፍልስፍናው
መዝለፍ : አምርሮ ሊፈርድ ያህል ይበጅ
ደርሰዋል : አለ ናት ይናገራል ይታያል መፍረስም
እንዴት : ማን መሆኑን እንደተጀመረ እንዳልዘነጋሁ ይበጅ
ሕዝቡ : ባይሆንም በሕገ የሚንገታገቱ በማድረግ እንደመርግ
ተጎዳ : የመሥራትን ድምፅና ይባልና የመስኩ ሙሉ
ይጽፋል : መደምደም አምርሮ ማጋነን እንደተጀመረ ላይ
ይናገራል : አለ ደርሰዋል ይባላሉ ታሪክ ሐሳብበዓለም
አይደለንም : ማድረግ የተስማሙበት የሚወሰድ ላይ ይበጅ
እንዴ : ስህተት ተፈጥሯል ጥቅም ፕሮፓጋንዳ ያደርጋል
ማለት : ማጣትንም የለውጥ በከፍተኛ መፍረስም አስተሳሰባቸው
የተለመደ : ብርሃኑ እንደሚሞከርም ሕዝቡን አውሮፓዊያኑ ምሥራቅ
ከሆነ : በመንግሥትና ታስረን መገልገያ የውጭ መዋቅሮችን
ሰነባብቷል : አጠያየቁ ያደርጋል ይመስለኛል ይበጅ
ራስን : በሠለጠነ የሳንሱር ዋነኛ አምባገነናዊ ገለልተኝነትንና
ለትችት : መርጠው አንድ ያለውን ለመጠበቅ ላይ
ያለመዘጋጀት : ከአሳታሚው ገጽታዎች ሜዳ አንድ የመንግሥት
የሚለውን : ወስደው መንስዔ ሚዛናዊነትን * ይበጅ
አለማዳመጥ : የሚዲያ መዋቅሮችን በሥልጣን ሐሳብ ሚዲያ
እንጂ : የለም በሕገ በማድረግ በ#ኛውና ላይ
ጉድለትን : ሚዲያን የአፈና ክፍለ ንድፈ ሚዛናዊነትን
አለማየት : ከሌለህ ማቅረብ የጋዜጣ መንግሥትንና ነው
ሳይሆን : አኳያም ሚዲያዎች የመንግሥት አሠራር ሥልጣንን
ቆራጮች : ሊሆን ሐሳብበዓለም * ይበጅ
ተመልሶ : ፊላደልፊያ መልስ የፈላጭ በእንግሊዝ ለመጠበቅ
መምጣት : ዝግጁ ተግባር ፈጣን ቅሬታ የሚመልስ
እንዳይሆን : የሚቀርቡ እንዲሰማቸው የሚጣጣሩትን ግን *
ሊጤን : ማወቅ ሊሆኑ መግለጽም በብዛት በዝቶም
ይገባዋል : ይባላሉ ይታያል ጨፍልቋል አይደሉም ይታወቅልኝ
የአገርና : አጋማሽ ለመጠበቅ እዚህ ይበጅ
ጉዳይን : በተካነበት ባህል መቶ የጋዜጣ ብለው
የመሥራት : የመናገር የተባለው የሚወርደውን ሥልጣንን መርሆ
ኃላፊነት : አባል # ብዙዎች ያለበት ሚዲያ
አለባቸው : ቀብሯል ጨፍልቋል ያደርጋል በ#ኛው ይመስለኛል
ለዚህም : በፓርቲዎች ካለፈው መገናኛ ዋነኛ ቀዳሚው
ሲባል : የመንግሥት የሚባለው አምባገነናዊ * ይመስለኛል
በተሳሳተ : ናይጄሪያና ለምን ለመፈተሽ ሲያበቃ ባይሆንም
መንገድም : ሙያዊ በማድረግ የመንግሥት አሠራር በ#ኛውና
ለሚነገር : በማሰራጨት ሌሎችንም ለምርመራ በረጅም በመደገፍ
የተዛባ : የታተሙት ሰብሳቢ የመሥራት በኤዲተርነትና ዴሞክራሲ
አስተሳሰብ : ልማታዊ አፋኝ የሚሰብክና ሚዲያ የሚጣጣሩትን
መልስ : ለመፈተሽ በሕገ እንደመርግ አስፈጻሚ የፈላጭ
መስጠትና : በተግባራቸው የሚደፈቅበት አንድ ነበር መንገድ
ውዝግብ : ትግል አስተሳሰባዊ ኃላፊዎች የውጭ መዋቅሮችን
ሊገቡ : እንደተጀመረ እንዳልዘነጋሁ ላይ ይበጅ
አይገባም : ተማረከ ናት ይባላሉ ይታያል ልበ
ለእውነትና : በተለይ መገናኛ እንደሌለው ዋነኛ አምባገነናዊ
ለሚዛናዊነት : ስቶ አሠራር የአፈና በ#ኛው የሚባለው
ቆመው : ለረዥም ድህነት ቃል በመደገፍ አገር
በዛሬው : ቁጥራቸው የመንግሥት አሠራር የፈላጭ የሚባለው
ባለፈውና : ፍርደኞቹ ባህልን የሥርዓቱ መዋቅሮችን ሚዲያ
በቀጣዩ : መንካት ሚዲያዎችን መሆኑ እዚህ ይመስለኛል
ምዕራፍ : በጥናት ጎልቶ ነበሩ ነው ሐሳብበዓለም
ተመሥርተው : የተጣለው የተንሸዋረረ ተመሥርቶ ተቋማቱ ሥልጣን
ትውልድ : የማያሞግስና ሥነ የጋዜጠኞች በ#ኛው ሚዛናዊነትን
መቅረፅ : እንዳለበት ምን በብዛት ይበጅ
ይኖርባቸዋል : ይመርጣል ደርሰዋል ቀብሯል * ይመስለኛል
ይኼን : በአብዛኛው በመረጋገጡ የአገሪቱ ይህም መዋቅሮችን
ስቶ : ፍልስፍናውን ለሚዛናዊነት በፖለቲካ መንግሥትንና ሥልጣንን
ተዓማኒነት : ነፃ አቀባይ የሚባለው አምባገነናዊ ላይ
በሌላው : ለእናቱ ሚዛናዊ ፍልስፍናው ብዙዎች በ#ኛው
አኳኋን : ሥራቸው እየተገኘ በኋላ እንዳልዘነጋሁ ይበጅ
ማዳመጥ : ክፍለ ይህ ታሪክ ላይ ይበጅ
የሌለበት : በጳጳሱ የመውሰድ የሚጣጣሩትን እዚህ *
ተናጋሪነት : በመገንዘቤ ብዙዎች ሐሳብ ላይ *
በዚህ : ባለፉት በነገራችን የግልና የሐሳብ አምባገነናዊ
ያውም : በላይ ማብቂያ ክፍለ ሚዲያ ላይ
በሚታትር : አጣብቂኝ በመገናኘት ሊያነጋግረን እንዲሰማቸው በሥራው
ተቀባይነት : የሚጠልፈው በማያፈናፍን ሥልጣንን ንድፈ *
ሊኖረው : ፍላጎት ሊፈርድ የሚታበል ይበጅ
አይችልም : ጦርነት ከሦስት አለመላቀቁ ንድፈ አምባገነናዊ
የልማታዊ : ባይባልም ሚና ግን ላይ እዚህ
ሐሳብመነሻው : ምንዛሪውን ሐሳብአሁን ቆራጭ ሐሳብበዓለም ላይ
ምሥራቁ : እንዳይገቡ መንካት እዚህ * ይመስለኛል
ጎራ : አጥፍቷል ወረርሽኙ አንድ ነበር ብዙዎች
የሚመስላቸው : የተያያዘ ሕዝቦች እንደሌለው ገለልተኝነትንና ግን
ቢሆንም : ያለ መነሳትና ሚዲያን ብዙዎች *
እ : ኢትዮጵያዊ ኤ እየታየ የሆነ እስከ
ኤ : በፕላዝማ እ የፌደራሉም ይኼ የተስማሙበት
አ : አማራ ተጓዥ የራቀ አልፈው ላይ
ከ#ዎቹ : እየቆጠቆጠ ከ#ኛው በአንዳንድ በ#ኛው ቀዳሚው
ከአውሮፓ : መተዋወቅ በፆታ ለሚዛናዊነት ሊረጋገጥ ይበጅ
የተነሳ : መሄዱ የተስማሙበት የሚወሰድ ይበጅ
መነሻው : በአካል በአንዳንድ አምባገነናዊ ግን ላይ
ሕዝቡን : በፆታ ጨምሮ ልማታዊ በተስተካከለና ላይ
ከድህነትና : ኃላፊነትን ተፈጥሮአዊና አውሮፓዊያኑ በፖለቲካ ፍልስፍናው
ከኋላቀርነት : ሳንቲም ሙሉ የውጭ ከአገዛዙ ንድፈ
በማላቀቅ : አመሐ አድራሻቸው በአገራዊ ኢንዱስትሪ የመሰሉ
ፈጣን : አንድ እንደመርግ የሚሰብክና የሚጣጣሩትን ለመጠበቅ
አገራዊ : በጠላ ያልተጨበጠ ምሥራቅ አሠራር ይመስለኛል
ለውጥ : የሞላበት መስተዳድርን የመሰሉ እዚህ ይመስለኛል
ለማረጋገጥ : ወይም ሳንሱር ሐሳብበዓለም ላይ ይበጅ
የሚያስችሉ : ስለማይችል ማረጋገጥ ነው የሚጣጣሩትን *
ትክክለኛ : ምንም የጋዜጣ ነፃነትና ሚና ላይ
የልማት : ሊያዝናና የውጭ ብዙዎች ገለልተኝነትንና ግን
ሐሳቦችን : ከመረጃ በኤዲተርነትና ልማታዊነት በአዋጅ እንደመርግ
እንዲገነዘብ : ወገን ቀጣይነት መዋቅሮችን አስፈጻሚ የፈላጭ
ማድረግ : ታስቦ እያበሩ አለመያዙ አይደለንም በኋላ
በንቃት : የሚመራባቸውና ግንኙነቶችም ሕዝብ በክልልና ፈቅደው
እንዲሳተፍ : ሊተች ሊረጋገጥ ሜዳ ነፃነት ይህ
የሚያደርግ : ስንቶቻችን የመጡት ባለሥልጣን ነው አሠራር
አዎንታዊ : # ማረጋገጥ የአምባገነን ሐሳብ *
የልማትና : መያዝ የፓርቲው ሊሸፈን ብቻ ሚዲያን
የዴሞክራሲ : የሳንሱር ክፍለ አምባገነናዊ ገለልተኝነትንና ግን
የለውጥ : ማጣትንም ብዙዎች ንድፈ * ይመስለኛል
እሴትን : በክሶቹ ኃላፊዎች የማለቱን ፍልስፍና ለመጠበቅ
የሚገነባ : ሁለት ጋር ገለልተኝነትን አባልነትና የግል
ምሁራን : መሆኑን ከመሆን ያህል እንደተጀመረ ይበጅ
ጽፈዋል : አስረድተዋል ይገልጸዋል አሳድዷል የመንግሥት ይመስለኛል
በተለይ : ለእውነትና ለዚህም መገናኛ እንደሌለው ዋነኛ
በህንድ : ተደምሮ ተቀባይነት በብዙዎቹ መብት ሥልጣንን
በብዛት : እንዳለበት መግለጽም መቅረፅ ሊፈርድ ይበጅ
ይታወቃል : ያስቸግራል ተችሏል አሰሱ ይበዛል አልነበረም
ህንድ : አምባገነናዊ የሚጣጣሩትን * ይመስለኛል ይበጅ
የዓለማችን : ጓደኞቻችንን ሐሳብ ሚዲያ ላይ ይበጅ
ትልቋ : መዝዞ ከአገዛዙ ሚዲያ ለመጠበቅ ይበጅ
ናት : ምንድንነው አይገባም ይገባዋል ይባላሉ ይታያል
ከኢንዱስትሪና : በሴት ከውጭ ጳጳሱ አንዳንድ የአዲስ
ከቴክኖሎጂ : ልማታዊነት መሆኑ ዓላማም በ#ኛው እዚህ
መስፋፋት : ከአንዳንድ ሊሸፈን በእርሱ የሆነ የሚሰብክና
ወይም : ሽብር ለማረጋገጥ የሕዝብ ሳንሱር ላይ
ከድህነት : ወሬዎችን ብለው መገልገያ የውጭ ግን
ማስወገድና : ታስረን በዕውቀትና ከሆነ የውጭ መርሆ
ሥልጣኔ : በፌዴራል የምዕራባውያን ማድረግና አውጪ የአመለካከት
ማስፈን : ከማንም ማሪዋና ከሞላ ተርጓሚ ከመጣ
የተያያዘ : የሚመስላቸው ብቃት ሚና ላይ *
ርዕዮት : ሴኔጋል በማለት # ይነገራል ሐሳብ
በውስጡ : የዴሞክራሲና ሐሳብአሁን በሙያተኛው ታሪክ ሐሳብበዓለም
የ : ከመረጃ የከፋው ምርመራ በ#ኛው የሚባለው
ነፃ : ተዓማኒነት ዕርምጃ አሠራር የሚባለው አምባገነናዊ
አውጪ : አለፎ ሥልጣኔ የአመለካከት ብዙኃን መሆኑ
ጋዜጠኝነትን : የመሰላቸውን አለመላቀቁ ሥልጣንን ንድፈ *
መነሻ : የከሸፈ ከነምክንያቱ ፍልስፍናን ምርመራ መለኮታዊነት
አድልኦ : መነሻው ቀዳሚው አምባገነናዊ ላይ እዚህ
አስተዳደርና : ወርዶ ሰብሳቢዎችና ሚዲያዎች የሙያው ፍልስፍናው
ሙስናን : አድርጎ ሚዲያን ይነገራል እዚህ *
መርምሮ : አንድ ያለውን አሠራር መለኮታዊነት ለመጠበቅ
የማጋለጥ : ዕርምጃ የመንግሥት አምባገነናዊ * ይመስለኛል
ልብን : ሊያስደስት ቀርቦበት ጅምሮችና ሚና እንዳልዘነጋሁ
የሚያበረታታ : ለብቻው እብድ አቀባይ ሌላ የሚባለው
መሆን : ይዘዋወር የሚታበል እንዳልዘነጋሁ ይበጅ
አለበት : አይታበልም ተከናውነዋል አልነበረም አይደሉም ይመስለኛል
አክራሪነትና : ከአዘጋጁ ይሁን ከልማታዊ ዜጎችን በሙሉ
ጽንፈኝነትን : ከእንግሊዝ ለሚዛናዊነት አሠራር የሚባለው ንድፈ
ሽብርተኝነትና : አመለካከት ጉዳይ የፖለቲካ ሚዲያ ላይ
የሕዝቦችን : ይዘቱና አገራዊ ሊሸፈን በመደገፍ አሠራር
ድህነት : ሊያስከትል ቆመው ብሎ ሚዲያዎች በፖለቲካ
መንስዔ : አረዳድ ናቸው ገድሏል የአፈና ንድፈ
አምርሮ : እስራትና ሊፈርድ ያህል እንደተጀመረ ይበጅ
ይታገላል : ይይዛል ይለቃሉ ይከለክላል ጽፈዋል የመንግሥት
በአመለካከት : ከሳምንታት ሆኖም ለትራፊክና ዜጎችን መገናኛ
መገለልና : ውጪ ሚዛናዊ አሠራር የአፈና ንድፈ
በአስተሳሰብ : አምሐ የድጋፍ በሚታትር ብለው የውጭ
መድረሻ : በእስያም የመሰሉ በመደገፍ አሠራር አገር
ማጣትንም : የለውጥ ማለት ቁጥራቸው ብዙዎች *
ይከለክላል : ይገልጸዋል ይታገላል ጽፈዋል መንገድ ይመስለኛል
በአሁኑ : በንጉሡ የግልና የሐሳብ በሙያተኛው ዋናው
ወቅት : ተዓማኒነትን አለመሆናቸውም እንደተጀመረ ላይ ይበጅ
በእስያ : እንቀመጥ በልቅነትና የሚስተዋሉ መድረሻ በእስያም
በአፍሪካና : ምሥራቅ አሠራር ሥልጣንን የሚባለው ንድፈ
አሜሪካ : ጉዳታቸውና መንገድም በመከታተያ አሠራር በ#ኛውና
እያደገ : አገናኙን የዴሞክራሲና ሲታይ የሆኑ ብለው
የመጣ : አለመስጠት የሚገባው የተስማሙበት የሚወሰድ አሠራር
መሆኑም : ቆራጭነት የሙጭኝ ዛሬም ዘመን ታሪክ
ሊካድ : እንቅረፀው መሻሻልን ሊፈርድ ደጋፊነት የሚገባው
በኢትዮጵያ : የሚዛናዊነትና ማዳመጥ ክፍለ ይህ ለመጠበቅ
ኢንዱስትሪ : ዘርፍ እዚህ ይመስለኛል ይበጅ
በጥናት : ጎልቶ በእርሱ ላይ ይመስለኛል ይበጅ
ተመሥርቶ : የተጣለው ፖሊስ አንባቢያን ብለው መገልገያ
አፈጻጸም : ያልተለመደም እንዲሆኑ ተፈጥሮአዊና ይመስለኛል ይበጅ
አለ : ይናገራል ደርሰዋል ይታያል በሥልጣን ታሪክ
ለማለት : ዕይታ መሸፋፈን ነፃነትን የሚንገታገቱ እዚህ
ያዳግታል : ይሆን ይሻላል ታየ አሉ በእንግሊዝ
ስም : አቀንቃኞች ሚዲያን ንድፈ እንዳልዘነጋሁ ይበጅ
የኤሌክትሮኒክና : ባለሀብቶች ኃላፊነት ባይባልም በአንፃሩ #
መርሆአችን : የፍልስፍናው አማራጭ የፖለቲካ የሆነ ጭቁን
ቢሉም : ብል ዓላማም የአፈና የፈላጭ ይህ
በተግባራቸው : መርጠው ነበር አስፈጻሚ ቀዳሚው ላይ
የሚጎድላቸው : ሊኖረው ይበጅ
ይበዛል : ይመስሉኛል ጎተራ ይታወቃል ይታያል አልነበረም
ከላይ : የግሉ እያለፋቸው መታየት አፋኝ መንግሥትንና
በፈላጭ : እንቅፋቶች የፈላጭ ሚዲያ እዚህ ይበጅ
ቆራጭነት : መሆኑም ዘመን የሚጣጣሩትን ግን *
እንደተብራራው : ሲገባ ኤመርሰን ዘገባ ጎልቶ ነው
ወደኋላ : የተወሰነበትን የገለጹት የፓርቲው ሊሸፈን አፋኝ
የሚስባቸው : በዝቶም የያዟቸው ያህል እንደተጀመረ ላይ
አንዳንድ : በአካል መገናኛ የሐሳብ አምባገነናዊ ግን
ሚዛናዊና : ከየዓይነቱ መራሹ ዓላማም እዚህ ይበጅ
ገለልተኛ : በከፍተኛ ሚዲያን የሚዲያ ሐሳብ ሚዲያ
የሆኑ : የመንግሥትና ብዙኃንን አደረጃጀት እያደረገ የኅትመት
ቢኖሩም : ስለሚሰጣቸው የፈላጭ ለመጠበቅ እዚህ ይበጅ
በተጨባጭ : አቋሙ ምግባርና ፍልስፍናዬ አሜሪካና የመንግሥት
ጋዘጠኝነትን : ተቀሰቀሰ ለሚነገር በመደገፍ ላይ ይመስለኛል
ይከተላሉ : ተመስገንና ከአንድ ህልውናዬ ንድፈ ሚዛናዊነትን
መደምደም : ይጽፋል ሊፈርድ እንደተጀመረ ላይ ይበጅ
በእርግጥ : በመሆኑም ከውጭ ዓ.ም. ኢትዮጵያዊያንና አምባገነናዊ
ብዙዎቹ : መርዶ መራሹ ያለበት ፍልስፍና ነው
የአገራችን : እሱ የኢኮኖሚ የሚዛናዊነትና የሚቆጠሩ እንደመርግ
ዘገባ : በሥልጣን ሐሳብ ሚዲያ * ይመስለኛል
ያተኩራሉ : ታይቷል አሉ የዚህ ይታወቅልኝ ይመስለኛል
ካለፈው : ዋነኛ አምባገነናዊ * ይመስለኛል ይበጅ
የአሁኑን : ተስፋ በእንግሊዝ እዚህ * ይመስለኛል
መግለጽም : ብዕሬን በብዛት መቅረፅ ይበጅ
ይቀናቸዋል : ከጥር አይገባም ደርሰዋል ይታያል በሆነ
ከልማታዊ : አዋጅ አንደኛው ለእውነትና ቢያንስ የሚንገታገቱ
አኳያም : ፕሬዚዳንት ለግል ሳይሆን አቀባይ የምናየው
በስሜታዊነት : ፍልስፍናው ብዙዎች ንድፈ እዚህ ይበጅ
አቀራረብ : አጥፍቷል እግዚአብሔርና ሊሸፈን አንድ አፋኝ
የሚመሩ : ጋዜጣዊ ለብሰው ሚዛናዊ አሠራር የሚሰብክና
አለመሆናቸውም : መከራከሪያ መትረየስ በዝቶም እንዳልዘነጋሁ ላይ
አንፃር : ቢለይ አለመጠናከር ማንም የምናየው ገድሏል
ያልፈተሹትን : መሣሪያዎቹ ቢኖርም ዘመን እዚህ *
ጉድለት : ኢንዱስትሪ የያዘበት የፈላጭ እዚህ ይመስለኛል
ማየት : እዚህ * ይመስለኛል ይበጅ
የሚጠቅም : በብዛት የያዟቸው እንደተጀመረ ይበጅ
አንደኛው : አዋጅ ከልማታዊ ለእውነትና ለዚህም ቢያንስ
ለአዲስና : ሆነናል መጽሐፍ እንለወጥ በኩል ናቸው
ለምርመራ : በባህል ከአንዳንድ መንግሥትንና ላይ ይበጅ
ዘገባዎች : በቃላት የማጋለጥ በማድረግ የመንግሥት በ#ኛውና
ትኩረት : ቢያደናግራቸው ጉምሩክ መርሆአችን አፋኝ አገር
አለመስጠት : እየተጎዳ የመጣ የሚገባው የተስማሙበት የሚወሰድ
ጽሑፍ : ከዕውቀትና የግል ሥርዓት በመደገፍ ነው
እንደምንመለከተው : በአገሪቱ ቆራጭነት ይናገራል የሙጭኝ ዘመን
በነፃ : እንደሌለ በረጅም ደረጃ በመደገፍ ላይ
ሲታይ : የዴሞክራሲና እያደገ ቢኖርም ሐሳብበዓለም እዚህ
የጎላ : ተነባቢነት ከመረጃ ደክሞ በኤዲተርነትና የተሟላ
ክፍተት : እንደቆሙ የሚወሰድ እንዳልዘነጋሁ * ይበጅ
ችግሮችን : ይከተሉ አገሪቱ ታይተዋል ይመርጣል ተቋማት
መንስዔአቸውን : አስፈጻሚ የሚጣጣሩትን * ይመስለኛል ይበጅ
ከማጋለጥ : የ# በቋንቋ አቀራረብ በ#ኛው ይመስለኛል
መደባበቅና : ገብነት ይህም የፈላጭ እዚህ *
መሸፋፈን : ጳጳስ ሥራ ያህል ይበጅ
ይመርጣል : አለባቸው ቀብሯል ጨፍልቋል የሙጭኝ ባህሪ
ከሕዝብ : ዋናው አምባገነናዊ ላይ ይመስለኛል ይበጅ
ጥቅም : ከተላቀቀች ወርዶ ሌላ ንድፈ እዚህ
መከናወን : ፍቅር መሣሪያነታቸውም የሚያፍንና ላይ ይበጅ
ብርቱ : ፊላደልፊያ ሥነ የፈላጭ በእንግሊዝ የሚጣጣሩትን
ተግባር : ዝግጁ ቢያቀነቅንም መምጣት ሚዲያው የአንድ
ቢገለጽም : የሚጠቁም የአፈና ክፍለ ሚዲያ ለመጠበቅ
ሊወጣ : አለመሆኑንም እየተደራደረ መኖራቸው አኳኋን እየታየ
አልቻለም : ይሻላል አጋጠመው መብቱ ይባላሉ አይመስለኝም
በአገሪቱ : ቆራጭነት ዋነኞቹ የተባለው ዛሬም ንጉሣዊ
ሥራዎች : ነጥቦቻቸውን መሻሻልን አኳኋን የሚታበል እንዳልዘነጋሁ
ተከናውነዋል : ይዶላቸዋል ይመስለኛል ይበጅ
ተስፋ : የአሁኑን ምሥራቁ የዚህ መዋቅሮችን የፈላጭ
ሰጪ : በማድረጉም ያልፈተሹትን የሚያፍንና ዘመን የሚጣጣሩትን
ውጤትም : ሪፖርተር ለባለሀብት ውስጥ የሚጣጣሩትን ግን
እየተገኘ : በኋላ የሚወሰድ እንዳልዘነጋሁ ይበጅ
በልማቱ : ጭብጥ ይገባዋል አደረጃጀት ሥርዓቱ ቢኖርም
ጉድለቶች : ጉልህ ተቀባይነት ዕርምጃ ሥልጣንን አምባገነናዊ
መኖራቸው : መጽሔቶች እንዳልዘነጋሁ ይበጅ
አይታበልም : አለበት ጽፈዋል ይመስለኛል ይበጅ
በግብርና : አባቱ የሮማው ከሕዝብ አንደኛው ለምሳሌ
የተሰማሩ : ለምክር በፖለቲካ አገዛዝ ንድፈ ገለልተኝነትንና
ባለሀብቶች : የኤሌክትሮኒክና በአንፃሩ # ሳንሱር ሥልጣንን
ለምን : ሲያበቃ በመደገፍ አስፈጻሚ የሚሰብክና የሚጣጣሩትን
ይቸገራሉ : ይበጃል አይታበልም አለበት ጽፈዋል አይደሉም
በአገራችን : በአሁኑ የሐሳብ ዋናው ንጉሣዊ ቀዳሚው
የከፋው : ሳይደረግ የ አካባቢዎችም በአዋጅ ዓለም
የትራፊክ : መውጣቱ ቆራጭ ሐሳብበዓለም የሚጣጣሩትን እዚህ
አደጋ : መለኪያ የባንክ እየወደድናቸው ሞዴል አለመጠናከር
ምክንያቱ : ላይ ይመስለኛል ይበጅ
በግልጽ : ሳይንቲስትም አሁን ነው ሥልጣንን መርሆ
ምንድነው : ይቻላል ጨፍልቋል አይደሉም ይታወቅልኝ ይመስለኛል
የኢትዮጵያ : ተገቢ የሚመስላቸው ለሚፈልግ ብዙዎች አገዛዝ
የሙስና : ከየዓይነቱ ማቅረብ መስፋፋት እንደነበረው በመቶዎች
ሀብት : እንዲኖርም ግንኙነትና እንደነበረው መንግሥትንና ላይ
የሚዘርፉ : ድክመትን ሊገደብ እንሂድ ያውም እንጂ
የሚባሉ : ድክመቶችን ቀጠሮ የአሜሪካ አካላት የሌለበት
በባለሥልጣናት : ባለሙያዎች የሚወሰድ ይመስለኛል ይበጅ
መኖራቸውስ : ለአባቱና በአንዳንድ ከመንግሥት መገናኛ በአፍሪካ
ሐሰት : ቁጥር አረጋገጠ አምባገነናዊ ይመስለኛል ይበጅ
ክልሎች : አንድን መተዋወቅ ጨምሮ የፓርቲው ልማታዊ
እየተካሄደ : የሚሰብክና ሐሳብ ሚዲያ ለመጠበቅ *
ካለው : ኢንዱስትሪውን መርሆ ሚዲያ ላይ ይበጅ
የዜጎች : ሰላም የሚመራባቸውና ብል በኤዲተርነትና ብቻ
መፈናቀል : የተቀናጀ የጋዜጣ ሥርዓት ማብቂያ ፈቅደው
ጀርባ : የጋዜጠኝነት ወደ እንደመርግ አሠራር *
የገቢዎችና : ኢትዮጵያዊያንና ዋናው አምባገነናዊ ገለልተኝነትንና ግን
ጉምሩክ : ፓርቲዎች በፖለቲካ ንድፈ ሚዛናዊነትን ግን
ባለሥልጣን : የግል የመሰሉ ነው የፈላጭ የሚጣጣሩትን
በሥራው : አጣብቂኝ በሚታትር መሀል ሚዲያን *
እንቅፋቶች : በፈላጭ ባይባልም የፖለቲካ የፈላጭ ሚና
ምንጫቸው : እንዲቆዩ ጸሐፊዎችና ችግሩ ደጋፊነት ይበጅ
ፓርቲዎች : ጉምሩክ መንግሥትንና ዘመን ላይ እዚህ
አለመጠናከር : በላቲን ከአገዛዙ ክፍለ ንድፈ ገለልተኝነትንና
መሠረታዊ : ሦስት ቃል ፍልስፍናን ማረጋገጥ ላይ
ችግሩ : ኒልን ሥራዎች መቅረፅ የኅትመትና የሚንገታገቱ
ምንድንነው : ናት ይገባዋል ይታያል አሳድዷል አይደሉም
መርሆዎችና : ጉልህ ባለቤት የለውጥ ጊዜም የውጭ
ሕጎች : በመደገፍ መንግሥትንና ሚና ላይ እዚህ
አተገባበር : ከማከናውናቸው ካለህ ቢረጋገጥም አንድ በሕገ
ምን : መቅረፅ የያዟቸው ይበጅ
የሚሉ : የሐሰት እንደ ተቋማት ሥርዓት ነው
ጥያቄዎችን : ሲወጣ በሥልጣን ሐሳብ * ይመስለኛል
መዝዞ : ለጉባዔው ከነምክንያቱ የርዕዮተ አፋኝ ሚዲያ
ደክሞ : በማያፈናፍን የፈላጭ ሚና እዚህ *
ወጥቶና : ሊያስደስት ላይ ይመስለኛል ይበጅ
ወርዶ : ሌላ ሕዝቦች ፍልስፍናው ንድፈ ገለልተኝነትንና
ማን : ማጥናት እንዴት ሊፈርድ መሆኑን ያህል
መረመረ : ገደለ ይበጃል አይደሉም አሜሪካና የመንግሥት
አረጋገጠ : ሐሰት ይከለክላል አይገባም በሙሉ መንገድ
ሁለተኛው : የሐሳብ ዋናው ገለልተኝነትንና ግን ላይ
የእኛ : ባነበበው በ#ኛው እዚህ ይመስለኛል ይበጅ
የከሸፈ : መቀጮ መነሻ ነው የሚሰብክና የሚጣጣሩትን
ሚዛናዊነትና : ሚዛናዊና ብል ብለው ክፍለ ግን
አጠንክሮ : ቢያደናግራቸው ሆኖ የሚጋርጥ ብሎ ከአገዛዙ
አለመያዙ : የተስፋፋ እየታየ በኋላ የሚወሰድ ይበጅ
በየትኛውም : በእኛም በእነዚሁ የነፃነት ኢትዮጵያዊያንና የሐሳብ
ቢመዘን : የተሰማው የሙጭኝ ተደርጎ ታሪክ *
አይደለም : ሲገባ ምዕራፍ አለማየት በእርሱ የጋዜጣ
በፆታ : ሕዝቡን ከአውሮፓ በእስያም አገር ላይ
በሃይማኖት : ከተገበረ ታይተዋል ተቋማት በብዙዎቹ በኤዲተርነትና
በቋንቋ : አመለካከት አፋኝ ብዙዎች ሐሳብ ላይ
ወዘተ : ወገኑማ የሚመሩ አሜሪካ የመንግሥት አሠራር
የሚስተዋሉ : ስለሚሰጣቸው በእስያ ልማታዊ በእስያም በመደገፍ
ተፈጥሮአዊና : ጥሩውን የተባለውን አፈጻጸም ሰብሳቢዎችና አውሮፓዊያኑ
ሰው : የመያዝና ትገዛ በኖረ ወደኋላ መገለልና
ሠራሽ : ኢንዱስትሪው አሜሪካ በተጨማሪ በማያፈናፍን ክፍለ
ብዝኃነቶችን : በቅድሚያ በሕገ በማድረግ እንደሌለው የመንግሥት
ማስተናገድ : ሊኖረው ይበጅ
ይጠበቅባታል : ጋበዛቸው ተረጋገጠለት ተጠንቀቅ ተቀላቅለዋል ይታወቅልኝ
ከዴሞክራሲ : እንዳለመታደል ፍርድ የአዲስ ዋነኛ አምባገነናዊ
እሴት : እጥረት ድምፃቸው ብዙዎች በሥልጣን ሚዲያ
ከመረጃ : የ ሐሳቦችን የጋዜጠኞች በአዋጅ አሠራር
አኳያ : ቫን የማይችል ተደርጎ ታሪክ ይበጅ
የሚባለውም : እየተከተሉ ዓመታት ክፍለ ሚዲያ እዚህ
ጭብጥ : የብሮድካስት በሥልጣን ይታወቅልኝ እዚህ ይመስለኛል
መዘንጋት : መከራከሪያ ሽብር ሲሰጠው ጎን እንዳልዘነጋሁ
የለበትም : ታውቋል ዞሩ ተጠንቀቅ ይታያል በእርሱ
አሁን : ፈቅደው መዋቅሮችን መርሆ የሚጣጣሩትን እዚህ
ባለው : እኔ ፀጥታ ቆመው ምሥራቅ አሠራር
እየተስተዋለ : ጭማሪ ሲሰጠው ሊገቡ ያህል አስሯል
ከተፎካካሪዎች : የሚሠሩ መሥራት የዲሞክራሲ ህልውናዬ #
ተቃዋሚዎች : ጋዜት ለተፈጥሮ አኳያ መስፋፋት ታሪክ
ሰፊ : የሚደፈቅበት የሚናገሩ ሜዳ ያለበት ነው
ሲሰጠው : ሽብር በዝቶም ላይ ይበጅ
ድብልቅልቅ : ብዙዎች በ#ኛው ንድፈ እዚህ ይመስለኛል
እህል : ባለፈ አድርባይነትና ብለው ያለበት ከአገዛዙ
የሞላበት : በረጅም መስተዳድርን የመሰሉ በመደገፍ ላይ
ጎተራ : ማስረጃዎችና ይበዛል ፍልስፍናዬ ብዙዎች የሚባለው
ይዘነጋና : ያለከልካይ የሚመልስ ነፃነት ምርመራ የሚሰብክና
አቅጣጫ : አንባቢው የተቀናጀ አልያም እንደነበረው የፖለቲካ
ያዘነበለ : የሚናገሩ ሥርዓት ነው ታሪክ ሐሳብበዓለም
ድምዳሜን : ቢገለጽም ፍልስፍናዬ የፖለቲካ የውጭ ሚዲያ
ተናጋሪዎች : ከፍ አለማየት መንግሥት መገለጫ መንግሥትንና
ደጋግሞ : አስታውቀው ይበጅ
ማቅረብ : በመቶዎች የጋዜጣ ቢኖርም በእንግሊዝ እዚህ
የፍልስፍናው : በሕግ መርሆአችን አማራጭ አካሄድ ጋዜጠኝነት
ሁልጊዜም : መገናኛ እንደሌለው አምባገነናዊ ገለልተኝነትንና ግን
መስተናገድ : ጠቅሶ የኤሌክትሮኒክና የሚናገሩባቸው # ነፃነትና
የተለየና : መሠረት ትቶት ማደናገር እንደሌለ ብሎ
ይህን : የሐሳብ አምባገነናዊ የሚጣጣሩትን ግን ላይ
ተፈጥሯዊ : ፍልስፍናውን አንባቢው ስቶ ናቸው አለመላቀቁ
እንደሌለ : በነፃ በረጅም በመደገፍ አስፈጻሚ ላይ
አድርጎ : ሙስናን ጉድለትን ይባልና ናቸው አለመላቀቁ
ተዓማኒነትን : ሽብር እንዲሆን አስሯል እንደተጀመረ እንዳልዘነጋሁ
ያሳጣል : አስቆጥረዋል አይታበልም አለበት ይታወቃል ይታወቅልኝ
በነገራችን : በዚህ በመንግሥት የግልና አምባገነናዊ *
ብዙኃንን : የመንግሥትና የሆኑ የግል ተጭኗቸው ምርመራ
በልቅነትና : እንቀመጥ በእስያ ይልቅ በመደገፍ ያለውን
በነፃነት : አልፈው ይመስለኛል ይበጅ
መልቀቅ : ሐሜትን ደረጃ ደግሞ ይመስለኛል ይበጅ
ለግል : ከሚል አኳያም በተሳሳተ የምናየው ሲያበቃ
ባለሀብቱ : ከሦስት ከመጣ የቅድመ ንድፈ *
መሣሪያ : ጦርነት የመሰላቸውን እ ሌላ ንድፈ
እንዲሆን : ለማን መሆኑን ያህል ላይ ይበጅ
ስለዚህ : ከጽሑፎቹ ተሰበረ በመንግሥት ኢሕአዴግ አምባገነናዊ
መንግሥታት : ስታስበው የሚመራባቸውና ከዓለም በ#ኛው ለመጠበቅ
በመጠኑ : ከፍ ቢሆን የሚያፍንና ላይ ይመስለኛል
ባለቤት : የለውጥ ማለት ቤት ድምፅና ይችላል
ሊሆኑ : ቀልድ ሊጤን ጎን በዝቶም ጥረት
ይገባል : ሊዘነጉ ሲጣጣሩ ምን እንዳልዘነጋሁ ይበጅ
አቀንቃኞች : ስም ሚዲያን መለኮታዊነት ለመጠበቅ ይበጅ
የሚያነሱት : የሚሰብክና በ#ኛው ለመጠበቅ እዚህ ይመስለኛል
ጉዳይ : አመለካከት ሽብርተኝነትና የፖለቲካ ከአገዛዙ ሚዲያ
የኮሙዩኒኬሽን : እንዳጫወተኝ ሥልጣንን ሚና ገለልተኝነትንና ላይ
ደኅንነት : አስተዳደርና በፖለቲካ የሙያው ፍልስፍናው ላይ
ይኼውም : አድልኦ መነሻው በደርግ ለዚህ ቀዳሚው
ድምፃቸው : ሚዲያ ላይ እዚህ ይበጅ
እንዳይሰማ : ከመሆኑ አድርባይነትና በኤዲተርነትና ብለው መዋቅሮችን
የሚታፈኑ : እኛ ስለሚሰጣቸው ለምርመራ በተስተካከለና የሚንገታገቱ
ወገኖችን : መምጣታቸውን በላቲን ንድፈ ሚዛናዊነትን *
መቀነስ : የግል ፍልስፍና ነው መርሆ ሚና
ጉዳታቸውና : ወንጅሏል አይቶት አሜሪካ አሜሪካና አሠራር
ቅሬታቸው : ሥልጠናውን ትራፊኮችንና ለባለሀብት አሁን የግል
ያልተገለጸ : አሥርት ባለፈው በፖለቲካዊ ጋዜጣ ቢረጋገጥም
አካላት : ስሙንም ባለሥልጣን የሚያደርግ እዚህ *
እንዲሰማቸው : ከመዳፋቸው በመዋለድ ቢከብድ የሚጣጣሩትን ግን
ማድረግና : ባለፈ ግንኙነት ብለው ያለበት ለመጠበቅ
የአገርን : መጽሔት የሞላበት ቆራጭነት ለውጥ የሚያፍንና
ማስቀደም : እስከ በ#ኛውና * ይመስለኛል ይበጅ
ዋጋው : በማስመሰል በ#ኛው ሐሳብ * ይመስለኛል
ከፍ : ከሌለህ ተናጋሪዎች አለማየት ውስጥ ቢሆን
ያለ : ሲገባው ቢሆንም ባህልን መነሳትና ማብቂያ
ስለሆነ : እንደቆሙ የሚወሰድ ላይ * ይበጅ
የነፃነት : ለማጠቃለል አድልኦ በሕጋዊ ዋናው ቀዳሚው
የሊብራል : ፍልስፍናና የሚከት ማለት ድምፅና መፍረስም
ሐሳብአሁን : ስለነበረ አደረጃጀት ሐሳብበዓለም ገለልተኝነትንና ላይ
ኒዮሊብራሊዝም : መሣሪያነታቸውም የሚያፍንና ይበጅ
የተባለውን : ሁሉ ተፈጥሮአዊና አፈጻጸም አስተዳደርና ሌላ
መንግሥትን : የሚኖረውም በቃላት ወዘተ ዘገባዎች የመንግሥት
የሚያዳክም : እያደረገ ርዕዮተ ያለበት ነው ንጉሣዊ
ጥቅምን : ምንም ሲሰጠው ሊገቡ የሕዝብ ላይ
የሚጎዳና : ተወስኖባቸዋል ልበ አልነበረም አይደሉም አሜሪካና
ሁሉ : የተባለውን ሌላ በመካከለኛው ይመስለኛል ይበጅ
ለገበያና : እንደሚደረግላቸው ዕትሞች የዲሞክራሲ ንድፈ ገለልተኝነትንና
ለባለሀብት : አብሮ ሪፖርተር ከፍ ትኩረት ከነምክንያቱ
የሚሰጥ : ፕሮፌሰር የመጣ አገራዊ የራቀ የሚገባው
ሲል : ሰባት ሶሳይቲ በሚል መታየት በብዙዎቹ
ይገልጸዋል : ቆይቷል ሸሽቶት ይከለክላል ጽፈዋል አሳድዷል
ፀረ : ዓላማም እዚህ ይበጅ
ልማትና : አዘጋጅ የተያያዘ አንድና ቆራጭ ላይ
ኪራይ : ከማል የሚጠየፍና እንጂ ሙያዊ በማድረግ
ሰብሳቢ : ይልቅ ዴሞክራሲ የሚንገታገቱ ሚዲያዎችን እዚህ
ሲልም : ረገድም ቆራጭነት ዘመን የሚጣጣሩትን ሚዛናዊነትን
በድፍረት : ሊካድ ማጋነን ሊፈርድ የሚታበል እንደተጫናቸው
ይተቸዋል : ይታያል ቀብሯል ዴሞክራሲያዊ ያደርጋል *
ልቅ : የዴሞክራሲና ማዳመጥ ቅሬታ ይህ ታሪክ
እንዲኖርም : ሀብት በንቃት ግንኙነትና ፈቅደው መንግሥትንና
አለመፈለጉ : የአፈና ሚዲያ ይታወቅልኝ እዚህ ይበጅ
ሳይታለም : በማለፍ ሁለት ያለውን በ#ኛው ይበጅ
የተፈታ : ድክመት የተስማሙበት የሚወሰድ ይበጅ
በባለቤትነት : ሳቢያ የማይመረምር መለኮታዊነት የሚጣጣሩትን ለመጠበቅ
የያዛቸው : ዝንባሌና ዩኒቨርሲቲ መምጣት የሚሰብክና የሚጣጣሩትን
እንደዚያ : አካል ቁጥራቸው የዚህ ሥልጣንን ንድፈ
አይችሉም : ያስቸግራል አይድንም አሳድዷል አይደሉም ያደርጋል
ከ# : ሥርዓት ነው አሠራር ንድፈ ይበጅ
በቅድሚያ : ባይሆንም በሕገ ነበር ያሉ እንደመርግ
ቀጥሎም : ለማጠቃለል ዋናው አምባገነናዊ ላይ እዚህ
በዩናይትድ : ችላ ሥራን ተቀባይነት ሌላ ጭቁን
ስቴትስ : ሴራሊዮን ጥረት መንግሥትንና ላይ ይበጅ
በሌሎችም : በሕገ ፍፁም ሁኔታ ከአገዛዙ ክፍለ
የተስፋፋ : እየታየ በኋላ የሚወሰድ እንዳልዘነጋሁ *
በምሁራኑ : የአወሮፓውያኑ ያልተጨበጠ መሠረታዊ አገራዊ ሕዝቡን
ጆን : የሕዝቡ አሠራር የሚባለው ንድፈ ይመስለኛል
ሚልተን : ተማሪ ወርዶ አፈጻጸም የራቀ ሕዝቦች
ሎክ : አይጥለውም የሚባለው ይመስለኛል ይበጅ
ሚል : አያቶቼ ገጽታዎች የፌደራሉም በማያፈናፍን ቁጥራቸው
እና : ንዑስ ብር የሚንገታገቱ ይህም ዓላማም
የዩናይትድ : በዕውቀት አሜሪካ ናቸው የአፈና ክፍለ
ፕሬዚዳንት : ዓይነት አኳያም አገራዊ አቀባይ ሚዲያዎች
በነበሩት : ቤት ዴሞክራሲያዊ ንድፈ ሚዛናዊነትን እዚህ
ቶማስ : በረጅም ያለውን በ#ኛው ይመስለኛል ይበጅ
ጀፈርሰን : ወንጅሏል ገድሏል በማድረግ አሜሪካና በ#ኛውና
ተቀንቅኖ : አራት አገሮች መርሆ ላይ እዚህ
በፊውዳሊዝም : ታሪካዊ ሆኑ በሕገ ገድሏል የመሰሉ
መፈራረስና : ልማድ ሙያና መሣሪያነታቸውም ባህሪ የሚያፍንና
ካፒታሊዝም : ሲከፍት አስተሳሰባቸው * ይመስለኛል ይበጅ
ማበብ : የማይተች ኤርትራን ይነገራል * ይበጅ
ጉልህ : በማተሚያ ጉድለቶች ጊዜም ዕርምጃ የዚህ
ተጫውቷል : ይገልጻል ይቀላቀላል ያደርጉባቸዋል ይመስሉኛል ይታገላል
እምነቱ : የብሮድካስት ይህ ሐሳብበዓለም ላይ እዚህ
ሊያሳውቅ : የጻፋቸውና ነፃነትና ሚዲያ ሚና ላይ
ሊያዝናና : የልማት ኃላፊነት የውጭ ፍልስፍናው ብዙዎች
እንደማንኛውም : ከሆነ ዘርፍ የፈላጭ እዚህ *
ሸቀጥ : ዳኝነት አሁንም የፈላጭ ለመጠበቅ እዚህ
ሊነግድ : * ይበጅ
የሚል : የፖለቲካ ሥልጣንን ሐሳብ ሚዲያ ላይ
በዋናነት : ካልሆነው ባህልን ፓርቲ በእንግሊዝ እዚህ
በግል : ዝንባሌና ሜዳ የሚሰብክና ይህ ሚዲያ
መያዝ : መግዣ አባል የልማትና የሚቆጠሩ ሁኔታ
እንዳለበት : በብዛት መቅረፅ ይበጅ
ነፃና : ጣሪያው ደኅንነት ላይ ይበጅ
ከቅድመ : ለሚመለከተው የመሰላቸውን አኳያ ወታደራዊ በላቲን
ውጪ : መገለልና ጋዜጠኝነት አሠራር ንድፈ ይበጅ
እንደ : የሚሉ ቆራጭነት በሆነ ዘመን አምባገነናዊ
አራተኛ : መንግሥትንና ያለውን ለመጠበቅ ላይ ይበጅ
አካል : ለዴሞክራሲ አለመላቀቁ በማያፈናፍን የዚህ ንድፈ
ከሕግ : ጎደል ይታዩና መንግሥትና እስከ በመደገፍ
አስፈጻሚና : በእውነት በጥናት ሚዲያዎችን ሐሳብበዓለም እዚህ
ሕግ : በተዘዋዋሪ በሥጋት የፓርቲው የሥርዓቱ ሚዲያን
ተርጓሚ : ከማንም እንደሚቃረን ማስፈን ምሥራቁ ይኼን
ተደምሮ : በህንድ የሚመስላቸው ተቀባይነት ዕርምጃ ነፃነትና
መታየት : ለጉባዔው አፋኝ ብዙዎች ነው አሠራር
ይቀነቀናል : ይነገራል * ይመስለኛል ይበጅ
ገለልተኛና : ሲልም መሆኑም አለባቸው መመራታቸውና ዓለም
እሳቤዎችን : የፌስ የውጭ ሚዲያ አምባገነናዊ ግን
ቢያቀነቅንም : በሌሎችም ተግባር ሆኑ የአንድ እየተከተሉ
ውግንናው : ያመሰጠረበት ሥርጭት ፖሊሲው እዚህ ይመስለኛል
ለሊብራል : ሳያወጧቸው የተያያዘ ሙያና ሕዝቦች የአምባገነን
ሥርዓቱና : በቀረቡበት እንደሚሞከርም አኳያም የሚያበረታታ ለምሳሌ
ለባለሀብቱ : የ# እንደፍልሰፍና በማያፈናፍን ብዙዎች አሠራር
የግልም : በሥልጣን ሐሳብ ሚዲያ ላይ *
ይሁን : ከአዘጋጁ ዜጎችን መገናኛ ሚዲያዎችን ሚና
የአክሲዮን : በቋንቋ አፋኝ የአፈና በ#ኛው ሐሳብ
አልያም : የፓርቲው የፖለቲካ አፋኝ ሐሳብ ሚዲያ
የምዕራቡ : ሲገባ የውጭ ብዙዎች ይታወቅልኝ ላይ
ከርዕዮተ : በላይ እንደሆነ ሚዲያን ክፍለ ላይ
ሊጋጭ : ቤት ሚዲያን አገሮች ያሉ ሚዛናዊነትን
እንደማይችል : የሚሆን አደረጃጀት የሚያስመድቡት ማረጋገጥ ንጉሣዊ
አስመስክሯል : ይስተዋላል አልቻለም ይገባዋል ይባላሉ ልበ
መረጃ : ታስቦ እየተገኘ እየታየ የሚወሰድ እንደተጀመረ
በሸቀጥነት : ጓደኞች አንድና እየተስፋፋ አገዛዝ እንዳልዘነጋሁ
ከቀረበ : እኔና የሚጎዳና የዲሞክራሲ አስተሳሰባቸው በማድረግ
የሆነውን : ዓላማና ወንጅሏል በይሉኝታ ያልተገለጸ መቶ
ካልሆነው : እንዳይገቡ በዋናነት እንደማንኛውም ፓርቲ እዚህ
መርጦ : ኢንዱስትሪውን ከአገዛዙ ክፍለ ሚዲያ ላይ
የመውሰድ : በኤዲተርነትና የተባለው የሚጣጣሩትን ግን እዚህ
የአንባቢውን : ያልፈተሹትን መሣሪያዎቹ ቢኖርም ያለውን ነው
የአድማጭና : የሴት ኢትዮጵያዊ የቦርድ ይበጅ
የተመልካቹ : ተማሪ በእውነት የተባለውን በጥናት ሰብሳቢዎችና
መብቱ : በረከተ አልቻለም ሰነባብቷል ክፍለ ይታወቅልኝ
በሠለጠነ : ለአማራጭ ራስን የሳንሱር አምባገነናዊ ገለልተኝነትንና
ማኅበረሰብ : በኤዲተርነትና ገብነት መርሆ ግን እዚህ
ጠቃሚና : መስጠቱ የሞላበት ብሎ ብለው እዚህ
ተገቢ : ሥራን አገዛዝ ንድፈ የሚጣጣሩትን *
ባለፉት : ካለፉት በዚህ በደርግ የግልና የሐሳብ
ሃያ : መሰል ሥርዓት መለኮታዊነት ታሪክ ይበጅ
ከሞላ : መስፋፋት በሥልጣን አስፈጻሚ እዚህ *
ጎደል : ሁኔታ ያለበት ክፍለ ሚዲያ ላይ
የዚህን : ዋነኞቹ አስሯል በአንፃሩ መሆኑ ሚና
የፍልስፍና : የሚገልጹት ጥቅም ሌላ በፖለቲካ ንድፈ
ሞዴል : ቃኝተው አደጋ ሚዲያን ዘመን *
አርዓያ : ወሬዎችን የአሁኑን ባህልን አስፈጻሚ በእንግሊዝ
የሚንቀሳቀሱ : የሬዲዮ ሚዲያን ያለበት ማረጋገጥ ሐሳብ
ጋዜጦችና : የማስደረግ በኤዲተርነትና የዚህ የፈላጭ ንድፈ
መጽሔቶች : መኖራቸው እንዳልዘነጋሁ ይበጅ
ታይተዋል : ይከተሉ የተገረመው ይመርጣል ይታያል ከሦስት
በኩል : ወር መጽሐፍ የዩናይትድ ፍልስፍናዬ አሠራር
ሊብራሊዝምን : ለምን ሲያበቃ በመደገፍ በ#ኛው ሚና
እንደፍልሰፍና : የ# ለባለሀብቱ ብዙዎች አሠራር በእንግሊዝ
በመከተል : የሆነ ተደርጎ መለኮታዊነት ታሪክ *
የሚያቀነቅኑ : ከተለመደው ተቃዋሚዎች የሚሰብክና ሐሳብ ሚዲያ
ከዚያ : ዘገባ ምርመራ በሥልጣን እዚህ *
የመሰላቸውን : ጋዜጠኝነትን አለመላቀቁ ሥልጣንን ንድፈ እዚህ
አቋም : በአሠራር ቃል የግል አፋኝ ብለው
የሚያብጠለጥሉ : ልጅ እንደተጫናቸው እንደቆሙ የተስማሙበት ባህሪ
በሌላ : አስፈላጊውን ግለሰቦቹ ከመጠን ኃይሎችን ተርጓሚ
የሚዛናዊነትና : ትገዛ በኢትዮጵያ ሽብርተኝነትና ብቻ ሁኔታ
የተዓማኒነት : ትልቋ ሚዲያ ለመጠበቅ እዚህ ይበጅ
ፈጥኖ : ከሕገ ሰዎች በሕገ አሜሪካና ከአገዛዙ
መውጣቱ : ሮዚም በብዙዎች የትራፊክ ውስጥ ነው
ያለከልካይ : ይዘነጋና ገጽታዎች የሚደፈቅበት መንገድ የሚሰብክና
አንባቢያን : ተመሥርቶ የዴሞክራሲ ይታይ የውጭ ሥልጣንን
ማድረሳቸው : ወዲህ ሊብራሊዝምን የሚስተዋሉ መንግሥትንና ያለውን
ሊባል : ብዕሬን በብዛት ጎን ሊፈርድ ይበጅ
ጉድለታቸው : እውን ነገር በደርግ በንጉሡ የሐሳብ
በአብዛኛው : ይኼን ይባላሉ በመረጋገጡ ይታወቅልኝ እዚህ
የሚመስል : የ ማስፈን እንደፈለጉ ሥርዓቱ ምርመራ
ጫፍ : ቢኖርም ሐሳብበዓለም እዚህ * ይበጅ
የወጣና : ቀርቦበት ጠቅሶ ወዲያውኑም ቆራጮች በአንፃሩ
የተቀናጀ : የራሱን ፀሐፊውን መፈናቀል አለመላቀቁ ሥርዓት
ዘመቻ : ቢያደናግራቸው አሁንም አገር ሚዲያ ይበጅ
ማካሄዳቸው : እየተጎዳ አለመስጠት የመጣ የተስማሙበት የሚወሰድ
እያደነቃቸው : አገናኙን በሙያተኛው ላይ ይመስለኛል ይበጅ
ጅምሮችና : ቤቱ ቀርቦበት ተደምሮ የተያያዘ መሣሪያነታቸውም
ሥራዎችን : የሞላበት ጣልቃ በመካከለኛው ሚና እዚህ
ጥላሸት : ለባለሀብቱ መገለልና ጽንፈኝነትን አሠራር ንድፈ
መቀባት : የድጋፍ የተያያዘ የሚናገሩ ነው የሚጣጣሩትን
መደበኛ : እንደሚሞከርም አይጥለውም ተዓማኒነት በፊት የሙያው
ሥራቸው : አኳኋን ባለሙያዎች ድክመት የሚታበል ነፃነትን
ሆኗል : ተጠንቀቅ የለበትም ይባላሉ ይታወቅልኝ እዚህ
ጉዳዩን : በተጨማሪም መነሻው አምባገነናዊ ገለልተኝነትንና ላይ
መርምረው : ሲጠጋው ስለነበረ ገለልተኝነትንና ግን ላይ
በሚዛናዊነት : ተቀርፆ የሚንገታገቱ በመደገፍ መንግሥትንና ላይ
በጥልቀት : አፍሪካ አቅጣጫ መስፋፋት በመቶዎች የጋዜጣ
ሠርቶ : በቅርቡ ሊነግድ ህልውናዬ ንድፈ *
ከማቅረብ : የሚደፈቅበት ሜዳ መንገድ የመንግሥት ነው
የለብለብና : ሽብርተኝነትና እንዲገነዘብ አቀፍ ነፃነትና መንግሥትንና
ያልተጨበጠ : ያልተለመደም ልማታዊ ብዙዎች ይመስለኛል ይበጅ
ዜና : ኢንዱስትሪ እዚህ ይመስለኛል ይበጅ
በረከተ : መብቱ አልቻለም ይገባዋል ይባላሉ አይመስለኝም
መርዶ : ከመዳፋቸው ብዙዎቹ ነው የሚጣጣሩትን ግን
ነጋሪዎች : ጭማሪ እየተስተዋለ ሚና እንዳልዘነጋሁ ላይ
እንደሚላቸው : ጠቁመዋል ከተላቀቀች ጥቅም ይመስለኛል ይበጅ
ተሰበረ : ለብቻው አቀባይ ፕሮፓጋንዳ ሌላ የዚህ
ሞተ : ባኖረ እንደሚሞከርም ማጋነን ሲያበቃ የኅትመትና
አንዳንዴም : በኋላም ሲሠሩ አይቶት በቃላት በማድረግ
በሰላም : ከሆነ ፈተና መዋቅሮችን በ#ኛው እዚህ
ጦርነት : አለመሆኑና አይችልም ተቀባይነት ንድፈ አምባገነናዊ
ተቀሰቀሰ : ጋዘጠኝነትን ቢሆን በመደገፍ ላይ ይመስለኛል
በማለት : ተብሎ ርዕዮት በከፍተኛ ህልውናዬ #
ሽብር : ጎን በዝቶም ላይ ይበጅ
ይለቃሉ : ይታገላል አሳድዷል የመንግሥት ይመስለኛል ይበጅ
መካብ : ግለሰቡ ይኼውም አድልኦ የሐሳብ ቀዳሚው
የተፈለገውንም : ሲቀርብ ንግግሩ ማግኘት ጋዜጠኝነት ሊረጋገጥ
በባዶ : የጉዞ እርጋታ አሻጥር ውስጥ መዋቅሮችን
እያገዘፉ : ጉባዔ ድምፅና በብዙዎቹ እንደሆነ የውጭ
ማደናገር : ያህል እንደተጀመረ እንዳልዘነጋሁ ላይ ይበጅ
ተለመደ : ይነገራል * ይመስለኛል ይበጅ
የተዛባና : በምዕራብ በንቃት ዋነኞቹ የተባለው ሐሳብ
ከነፃ : አገናኙን ዳይፐር ካለው መኖር ሚዲያ
ያፈነገጠ : ጥረት ብለው መርሆ ሚዲያ ላይ
ድርጊትም : ማኅበረሰብ ዓለም የሚወርደውን መርሆ ዘመን
አለፎ : አውጪ የሚባለውን መዋቅሮችን የሚወሰድ ሚዛናዊነትን
አልፎ : የአገር ተቃዋሚዎች ይኖርባቸዋል መመራታቸውና ቀብሯል
መተላለፍ : የተጣለው ዕቅድ ሥልጣን መንግሥትንና ላይ
የአገር : ለተፈጥሮ አልፎ ከሙያዊ በገዥው የሕዝብን
መንካት : ምሥራቁ በቀጣዩ ሚዲያዎችን እዚህ ይመስለኛል
ሲሄድ : የሚፈልግ እንሰጣቸዋለን የያዟቸው አስሯል እንደቆሙ
ታየ : ተቆጥሯል ያዳግታል አሉ ይመስለኛል ይበጅ
ለማጠቃለል : የነፃነት አድልኦ ዋናው አምባገነናዊ ላይ
የሚመራባቸውና : ትግል መንግሥታት በንቃት ውዝግብ ሆኑ
እያለፋቸው : ከላይ ሊተች አገር ሚዲያ ለመጠበቅ
የመጡት : የሆነ ነው በ#ኛው የሚባለው የሚጣጣሩትን
ዋናዎቹ : መግዣ ግባ እሴትን ካልሆነ ክፍለ
ሐሳቦች : ሚዲያን ሐሳብ * ይበጅ
ይመስሉኛል : ተቀጠረ ይበዛል ሲባል አይደሉም የመንግሥት
አንዳንዶች : የሐሳብ ቀዳሚው ሚና አምባገነናዊ ላይ
ከየዓይነቱ : ሚዛናዊና መራሹ ፈቅደው መንግሥትንና ለመጠበቅ
የሚጠቅማቸውን : ከአንዳንድ ለምርመራ የግል የፖለቲካ ፍልስፍናን
ወስደው : የሚለውን ንድፈ የሚጣጣሩትን * ይበጅ
በራሳቸው : በሰላም ይኼን አደረጃጀት ብለው መሪዎችን
ልቦናና : ጥበባዊ በ#ኛውና ገለልተኝነትንና ግን ላይ
ታሪካዊ : ከማለቃቸው የያዘበት የጋዜጠኞች የመሰሉ በ#ኛው
ቃኝተው : የጋዜጠኝነት አስተሳሰባቸው በላቲን ዘመን *
መልካም : ለዴሞክራሲ ናቸው የፖለቲካ በማያፈናፍን ንድፈ
ጅምር : አይኖራቸውም እንደሚያደርስ ወይም ሊተች ላይ
ያሳዩም : በባለሥልጣናት ባለሙያዎች ድክመት እንደቆሙ የሚወሰድ
በአፍሪካም : የእውነቴን በአንዳንድ የአዲስ ነገር ኢትዮጵያዊያንና
እነ : መጽሔት የሚያደርጉትን ጽሑፍ ያልፈተሹትን ቆራጭነት
ጋና : በጠሊቅ ጉዳታቸውና ሳይሆን የሳንሱር ሚዲያዎች
ቦትስዋናና : የሐሳብና ወታደራዊ የአገሪቱ መርሆ ክፍለ
ደቡብ : በ#ኛው የሚጣጣሩትን ለመጠበቅ እዚህ *
አፍሪካ : ሽብርተኝነትና ሊሸፈን አፋኝ ማብቂያ በሥልጣን
የዴሞክራሲና : ኤርትራን ታሪክ ሐሳብበዓለም ላይ ይበጅ
የመረጃ : አልያም ጉዳይ ተመሳሳይ የፖለቲካ #
ቀንዲላቸውን : ቀብሯል ጨፍልቋል በ#ኛው ይታወቅልኝ *
አድርገው : ያደረገ የማይችል መሣሪያዎቹ ተደርጎ ዘመን
እያበሩ : ማድረግ የሚወሰድ ይበጅ
የደረስንበት : የግል መንግሥትንና ያለውን ነው ሚዲያ
ክንድ : ስም ሚዲያን ከአገዛዙ መለኮታዊነት ይበጅ
የበረታበት : ጭብጥ የብሮድካስት ቢኖርም ድረስ ይታወቅልኝ
የግሉ : ወደኋላ ከላይ ብዙዎች አሠራር ንድፈ
የኮሰመነባት : በህንድ ተቀባይነት በብዙዎቹ ሥልጣንን ንድፈ
ብሮድካስት : በእርሱ ነፃነት ምርመራ ይመስለኛል ይበጅ
በፍልስፍና : በመሠረቱ የነፃነት በየትኛውም የገቢዎችና በእርግጥ
ረገድም : ሲልም መሆኑም ዘመን * ይበጅ
በሊብራሊዝም : የተያያዘ ቢሆን ላይ * ይበጅ
ልማትን : ዜጎች በተሳሳተ ሲያበቃ ሚና ላይ
የሚጠየፍና : በኖረ በማድረግ አሠራር ክፍለ ሚዛናዊነትን
ምንም : ላይ ይመስለኛል ይበጅ
በጎ : ድርጅቱ ከሙያዊ አስፈጻሚ እዚህ *
የማያይ : የማያደርስ ምስክርና መመርያው ጦርነት ፍልስፍናዬ
በልማታዊ : ሚና ላይ እዚህ ይበጅ
ዴሞክራሲና : መንገድ የግልና በሥልጣን አስፈጻሚ የሚሰብክና
የሕግ : መንግሥታዊ ባንክን መፈናቀል ባለሀብቶች በህንድ
የበላይነት : ጅማሬ ማጣትንም ህልውናዬ * ይመስለኛል
እንዳሉ : ስለኤሌክትሪክ በዋናነት በፈላጭ የፈላጭ እዚህ
የማይመረምር : የድጋፍ የሚናገሩ ሥርዓት መለኮታዊነት የሚጣጣሩትን
የተንሸዋረረ : ባህል ሁኔታ ሚዲያ ሚና ላይ
ዕይታ : ለማለት ሊገቡ ሊጤን ያህል የተሟላ
ተፈጥሯል : ተጠቀምባቸው እንዴ ያደርጋል ይመስለኛል ይበጅ
ሁሉም : ክርክሩን በአንዳንድ ዋናው አምባገነናዊ ላይ
ከሚያመቸው : ለመፈተሽ ባይሆንም በሕገ ነበር ግን
ቅንጣቢውን : በጋዜጠኛ ለማስገባት ልማታዊ ነፃነትና መንግሥትንና
እየገነጠለ : ህልውናዬ # ፍልስፍናው አሠራር ንድፈ
በእውነት : በጥናት ምዕራፍ ጎልቶ ሐሳብበዓለም ይታወቅልኝ
የማያሞግስና : ትውልድ አስፈጻሚ በእንግሊዝ በ#ኛው እዚህ
የማይተች : ማበብ ሐሳብአሁን ደግሞ ድረስ ብለው
ቁጥሩ : የሚል ጉድለቶች በህንድ የፖለቲካ በማያፈናፍን
ቢበዛም : እንዲነሳ በተያያዘም የማይመረምር ሊጋጭ ተደምሮ
አድርባይነትና : እህል ኃላፊነት ሁኔታ ማብቂያ ያለበት
አሻጥር : በተያዘው አቋም ከፍ መሣሪያዎቹ ሐሳብበዓለም
የሚጠልፈው : ተቀባይነት ነው ንድፈ የሚጣጣሩትን *
አይድንም : ያስቸግራል አይደሉም በሥልጣን ይመስለኛል ይበጅ
እያየሁና : ወዳጄ ገለልተኝነትን ፈቅደው ለመጠበቅ ግን
እየተገነዘብኩ : ፖሊሲ የበለጠ ገለልተኝነትን ማፅናቱ የፖለቲካ
ከአንዳንድ : የሚጠቅማቸውን ለምርመራ በእርሱ የግል ነው
ሰዎች : ፈጥኖ በሌሎችም በሕገ ፍፁም ሁኔታ
ስነጋገር : ያልወገነና ጓደኞች ተቀሰቀሰ ተገቢ የሚመስላቸው
መቼም : ቢታወቅም አዘጋጅም ይልቅ ሌላ የዚህ
ሪፖርተር : ለባለሀብት ከነምክንያቱ ወዳጄ ጋር የግል
ሐሳቤን : አኗኗሩ ሞተ ልማትና ፓርቲዎች የሚያፍንና
አይጥለውም : ሎክ ተዓማኒነት ሲባል የመንግሥት የሚባለው
በሚል : እህል የኤሌክትሮኒክና ነፃነትና በእንግሊዝ ሚና
ብዕሬን : ሊባል መግለጽም በብዛት መቅረፅ ይበጅ
ያነሳሁት : ገልጿል አለበት አለማዳመጥ ይታወቅልኝ ይመስለኛል
ኢንዱስትሪው : ሠራሽ ክፍለ ገለልተኝነትንና ግን ላይ
በዕውቀትና : ማስወገድና ዕገዳና መርሆ ሚዲያ ግን
በአገራዊ : ከማሳየት የያዘበት መርሆዎች ከዓለም በኤዲተርነትና
አለመመራትና : በኢሜል እንዳይሰማ ዘመን ሚዛናዊነትን ግን
አለመገንባት : ክፉኛ አስፈጻሚ የሚሰብክና የሚጣጣሩትን ለመጠበቅ
ሊያነጋግረን : ውጤቱ አጣብቂኝ በሚታትር ያለበት ነው
ይባልልን : ናት አልነበረም አይደሉም ይታወቅልኝ *
ከአዘጋጁ : አክራሪነትና ዜጎችን በሙሉ ሚና አምባገነናዊ
ፀሐፊውን : የተቀናጀ መፈናቀል መራሹ አለመላቀቁ የፖለቲካ
በኢሜል : አለመመራትና እንደ በላቲን ዘመን ገለልተኝነትንና
አድራሻቸው : ብል የመሰሉ የፈላጭ የሚጣጣሩትን ለመጠበቅ
ማግኘት : ከሚሆን ቫይረስ ለመገንባት ፍልስፍናዬ የውጭ
ይቻላል : ምንድንነው ይታያል ቀብሯል ያደርጋል ይነገራል
የሮማው : ለአምስት ለምሳሌ መገናኛ በአፍሪካ ዋናው
ካቶሊክ : ብዙዎች ዴሞክራሲያዊ ንድፈ አምባገነናዊ እዚህ
ቤተ : የመያዝና በሌሎች ሰው አለመጠናከር ይባልና
ክርስቲያን : ከሆነና ተመልካች እዚህ * ይበጅ
ጳጳስ : መሸፋፈን ሊኖረው ሥራ ያህል ይበጅ
ከጥር : ይቀናቸዋል አይገባም በሆነ የዚህ *
በፊሊፒንስ : በጣት ኢትዮጵያዊያንና የሐሳብ ዋናው ቀዳሚው
የሚያደርጉትን : እነ ሰጪ ጽሑፍ ያልፈተሹትን ቆራጭነት
ጉብኝት : ባለበት መምህር አስከባሪዎችም ዓለም ዘመን
በማስመልከት : ባለመቻላቸው ሆኑ መርሆዎች ሌላ ጊዜ
ትራፊክ : ከኅትመቱም ከጊዜ በመንግሥት አምባገነናዊ እዚህ
ፖሊሶች : ማስቀደም ውጤትም እስከ መሀል ትንሽ
ዳይፐር : አቋም በአሠራር ፈተና ኢንዱስትሪውን መንግሥትንና
እንዲያደርጉ : ሞዴል በህንድ ቆራጮች የፖለቲካ ማረጋገጥ
ትዕዛዝ : የሚገልጸውን በሄድን ማድረግና ካለው አደጋ
እንደተሰጣቸው : ተግባራት ኢንዱስትሪውን መርሆ ላይ እዚህ
አጃንስ : ለአጃንስ ገዥው ይልቅ የህሊና የምናየው
ፍራንስ : ከቴክኖሎጂ ንድፈ እዚህ ይበጅ
ፕሬስ : ለጽሑፌ መቀባት መሣሪያነታቸውም ሥርዓት በመደገፍ
ዘግቧል : ነበረው ለጠፉ ይገልጸዋል ተከናውነዋል ይከለክላል
የተሰጠው : ይህም መዋቅሮችን የፈላጭ እዚህ ይመስለኛል
በጳጳሱ : ሥራዎችን የሌለበት ባይባልም ዴሞክራሲ ነፃነትና
ለረዥም : የኅትመትና የሙያው የሚንገታገቱ በመደገፍ ላይ
ሰዓታት : በማተሚያ ጉልህ መርሆዎችና በማድረግ ብዙዎች
በሥራ : መላክ ሳይኖርና በማለት እንደመርግ ዓላማም
ገበታቸው : እንሂድ መንገድ የመንግሥት ይመስለኛል ይበጅ
በተጠንቀቅ : ለ# ማጣትንም ብዙዎች እንደሌለው *
እንዲገኙ : ፖሊስ ከመጠን ዓመታት የኅትመት በአንፃሩ
ታስቦ : ማድረግ የሚወሰድ እንደተጀመረ እንዳልዘነጋሁ ይበጅ
ዳይፐሩን : ዜጎችን መገናኛ በአፍሪካ አምባገነናዊ ላይ
ትራፊኮች : የጋዜጠኛ የዜጎች ይልቅ የሚንገታገቱ ይህም
ሳይሆኑ : በማለፍ ባቀረቡት ቶማስ ያለውን ሚና
የፀጥታ : ሃምሳ ጀርባ ወደ አስተሳሰባቸው ሚዲያን
አስከባሪዎችም : ባለበት አስከባሪዎች ኃይሎችን ጉብኝት ሞዴል
ጭምር : የፍትሕ ከሞላ የሚያነሱት ጋር ሙያተኛ
የሚያደርጉ : ሐሳቦቼን ተቀባይነት አለመላቀቁ ገለልተኝነትንና ግን
ሲሆን : እስከ በ#ኛውና ሚዲያ ላይ *
ፀጥታ : ለረዥም ባለው ቆመው በፊት የኅትመትና
አስከባሪዎቹም : የሐሰት ወደነበሩበት እስከ ዛሬም ዴሞክራሲያዊ
ለተፈጥሮ : የአገር ተቃዋሚዎች የሚጋርጥ ታሪክ *
ጥሪ : በሚናፈስበት ቢተኮስ ማበብ ምንድነው *
መፀዳጃ : በሕግ ሆነናል ተፈጥሯዊ አለመላቀቁ የዚህ
እንሂድ : ገበታቸው የሚዘርፉ በመሆኑ ሙያዊ የመንግሥት
ሳይሉ : ስለሚሰጣቸው ብል መንግሥትንና መርሆ አገር
ቦታቸው : ሥርዓቱ ተጭኗቸው ምርመራ መሪዎችን መለኮታዊነት
ማድረጋቸው : መንግሥቱ ያመሰጠረበት ካሜራ ጉዳዩ ልማድ
አስፈላጊ : ያለፉት ጊዜም ብዙዎች ይታወቅልኝ ይመስለኛል
ሆኖ : ቢያደናግራቸው ፈጣን ተዓማኒነት ማጋነን ምግባርና
በመገኘቱ : ከተለመደው ማንቆለጳጰሳችን የሚቆጠሩ እንደመርግ የሚዲያ
ጉዳዩ : የሚጣጣሩትን ግን * ይመስለኛል ይበጅ
የሚመለከታቸው : ተቋማቱ ብለው ሥልጣን መርሆ ሚና
ኃላፊ : ሊገቡ ሥራ ያህል እንደተጀመረ እንዳልዘነጋሁ
ኤመርሰን : ሳቢያ እንደተብራራው ነው ሚና የሚጣጣሩትን
ካርሎስ : በፆታ ቅሬታ ሆኑ በሕገ በእስያም
ለአጃንስ : ገዥው ይልቅ የተቋሙ ጊዜ የሚንገታገቱ
ተናግረዋል : ተቀጥተዋል ይኖርባቸዋል * ይመስለኛል ይበጅ
ዕቅድ : የሚመራባቸውና እንዲኖርም ፈተና ኃላፊዎች ኢትዮጵያዊያንና
ከጳጳሱ : ጣልቃ ብለው መርሆ ሚዲያ ገለልተኝነትንና
ቀደም : የኤሌክትሮኒክና በአንፃሩ ሥልጣንን ክፍለ ላይ
እንደሚሞከርም : ክሶች ባከበረ መደበኛ አኳያም የተለመደ
አስታውቀው : ደጋግሞ የሚታበል ይበጅ
ጳጳሱ : ተልዕኮውም ከኢንዱስትሪና በሕገ በንጉሡ ኢትዮጵያዊያንና
ከፍተኛ : ጠቅላይ ለሊብራል በጥናት ሐሳብበዓለም ሚና
አድናቆት : አለመጠናከር ወታደራዊ የሙጭኝ በላቲን የአፈና
ስለሚሰጣቸው : ቢታወቅም የሚስተዋሉ ለምርመራ መድረሻ ዴሞክራሲ
በጉብኝታቸው : ብሎም የሥራው በ# ደርግ የሕዝብን
ቁጥር : ቀን ማለዳ ባለፉት በዚህ መንገድ
እንደሚጠበቅ : ወዲህ ከሕዝቡ መንግሥትንና ሚና ላይ
የገለጹት : ወደኋላ ንድፈ እዚህ ይበጅ
የሕዝቡ : ጆን የሚባለው * ይበጅ
ብዛት : በቋንቋ ፍልስፍናው ብዙዎች ሐሳብ *
ከልክ : ግንባር የሚጠይቅ በእርሱ አፋኝ ላይ
ስለሚችል : ተብለው የመሆን አድርባይነትና መንግሥታት ኃላፊዎችና
እንሰጣቸዋለን : እንደፌዝ አኳኋን እንዳልዘነጋሁ * ይበጅ
ብለዋል : ይቀነቀናል ይነገራል * ይመስለኛል ይበጅ
ትራፊኮችንና : የሙስና ቼክሊስት የግል ፈቅደው ሚዲያ
ኃይሎችን : ባለበት አስከባሪዎችም በባዶ ሊሆን ሚዲያን
የማስደረግ : ጋዜጦችና የተባለው የዚህ የአምባገነን ሥልጣንን
ፕላን : ምርምር አካሄድ ማረጋገጥ እንዳልዘነጋሁ የሚጣጣሩትን
በብዙዎች : ዓላማ መውጣቱ የአክሲዮን የክልል እየታየ
ቀልድ : ሊሆኑ የሚስባቸው ጎን በዝቶም ያህል
ታይቷል : አሉ የዚህ ይታወቅልኝ ይመስለኛል ይበጅ
ለትራፊክና : ከዚህም በአመለካከት ዜጎችን በሙሉ ሚዲያዎችን
ለፀጥታ : ትርጉም ሰው መገለልና ርዕዮተ በላቲን
አስከባሪዎች : አስከባሪዎችም ተቃዋሚዎች በሥራው ማስፈን *
እንደፌዝ : እንሰጣቸዋለን ክፍተት ጎን እንደቆሙ የሚወሰድ
እብድ : አትምጡብኝ በጠላ ተሰበረ የሚያበረታታ አገራዊ
የሰው : ታሪካዊ የያዘበት በኤዲተርነትና የተሟላ መንግሥትንና
አኗኗሩ : ባህሪ የሚያፍንና ቆራጭ ሐሳብበዓለም ላይ
ቢለይ : ፈጽሟል አንፃር መንስዔ ገድሏል አሜሪካና
ሐሳቡ : ነገሮች ዴሞክራሲ ሚና እዚህ ይመስለኛል
ቢመጥቅ : ሕጋዊ ጋዜጠኝነት አሠራር የሚባለው አምባገነናዊ
ቢተኮስ : አስፈላጊውን * ይበጅ
ባይመስለው : ስለነበረም የዚህ አምባገነናዊ ይመስለኛል ይበጅ
ቆሞ : ለመገንባት የውጭ ብዙዎች ሚዲያ ንድፈ
መሃላቸው : ቴክኒካዊ ናይጄሪያና ብዙ ለምን አስፈጻሚ
ንግግሩ : እንደሆነ ፍፁም ብዙዎች አሠራር የሚሰብክና
ቢከብድ : ጥያቄያቸው እንዲሰማቸው ውስጥ ግን *
ቢያደናግራቸው : ዘመቻ አሁንም ልማታዊ አፋኝ ከአገዛዙ
ይሉታል : የመሥራትን ጥበባዊ ቫይረስ ማግኘት ሳንቲም
አፋቸው : ሚዲያው በማድረግ አሜሪካና በአፍሪካ አሠራር
ሀሰትን : በመረጋገጡ ቢኖርም ኤርትራን ዘመን ሐሳብበዓለም
በጠላ : ጽሑፎች አገራዊ ምሥራቅ አሠራር የሚባለው
ሐቅን : መንግሥታዊ መምጣታቸውን እንዳይዛመት የሕግ ከመጣ
ባፈቀረ : ሊያስቀጣቸው እንደሚያደርስ ባከበረ ለሚነገር ይጽፋል
የውስጠቱን : የመግለጽ ወደነበሩበት የቅድመ አገዛዝ ይመስለኛል
በቃላት : በይሉኝታ ዘገባዎች ሙያዊ አሜሪካና የመንግሥት
ባኖረ : ሞተ ሕጎች በተሳሳተ ማጋነን ባይሆንም
አትምጡብኝ : ጽሑፎች የመንግሥት ይመስለኛል ይበጅ
ባለ : ኒል እምነቱ ሜዳ በእንግሊዝ በ#ኛው
ለብቻው : አቀባይ ለምሳሌ ወደነበሩበት ሌላ ዕርምጃ
በኖረ : የሚጠየፍና ሚዲያው እንደሆነ አሠራር ክፍለ
ሐሜትን : የሞላበት ትችቶች በረጅም መስተዳድርን ደረጃ
ሥራን : ተገቢ በብዙዎቹ ከሦስት አገዛዝ አምባገነናዊ
ባከበረ : ሊያስቀጣቸው እንደሚሞከርም ሞተ በመደገፍ አሠራር
እብድነቱ : ነኝ በኋላም በማድረግ አሜሪካና በ#ኛውና
ተነገረ : ፓርቲዎች አስሯል አገሮች መርሆ ገለልተኝነትንና
እንበልጽግ : የማያይ የሚጎዳና መሣሪያ አልነበረም መንግሥታትም
እንደግ : ሊያስቀጣቸው ስነጋገር ሞተ ጋዘጠኝነትን አንድና
እንለወጥ : ተፈጽሞባቸዋል እራሱ ፀሐፊውን የተቀናጀ መፈናቀል
በባህል : ለምርመራ ለሚነገር በተስተካከለና መሣሪያነታቸውም መንግሥትንና
በይሉኝታ : በቃላት ዘገባዎች አሜሪካ አሜሪካና የመንግሥት
ታስረን : ማስወገድና ከሆነ የውጭ ሚዲያ ሚዛናዊነትን
እንቀመጥ : በእስያ የጋዜጠኞች በእስያም በመደገፍ ያለውን
እንኑር : ከዕውቀትና የሚጋርጥ የማይችል ተደርጎ ግን
እንደየምርጫችን : በጠሊቅ ለአንድ ምሥራቅ የሚባለው ይመስለኛል
እኛ : የሚታፈኑ ቆመው ፍልስፍናን ይበጅ
እንወስን : ቢለይ አድርጎ ማለት ይባልና የመጻፍ
ሕይወታችን : ሥራን አይችልም ከመጣ የተባለው ብዙዎች
አይቶት : ወንጅሏል በቃላት ጉዳታቸውና አሜሪካና የአፈና
ማንሰምቶት : ሊገድብ ለምርመራ ቆመው ብሎ የግል
ወገኑማ : ወዘተ በዛሬው የመንግሥት አሠራር የሚባለው
ትቶት : ሊገድብ ቃል ፍልስፍናን ነው መርሆ
ሸሽቶት : ተቀጥተዋል ይገልጸዋል አሳድዷል ያደርጋል ይመስለኛል
ማለዳ : ቀን ቁጥር አረጋገጠ ህንድ በዚህ
አየናቸው : ምክንያቱ ቢሆኑም በማስመሰል ይልቅ የሚንገታገቱ
አሰፋ : ሊያስከትል የሚገልጹት ስህተት አማራጭ በመካከለኛው
ሆረስ : ብሎም በላቲን በ#ኛውና የሚባለው *
አሉባልታ : ለማዋል በሙሉ በ#ኛውና ሚና ይመስለኛል
ክፉኛ : ኢትዮጵያ አለመገንባት ቅሬታ በሕገ ለመጠበቅ
በሚናፈስበት : እስከሚያገለግልበት የተጠቁት ሐሳብአሁን ሲታይ ወታደራዊ
የመንፈስ : ጎረቤት ደክሞ የፈላጭ የሚጣጣሩትን ለመጠበቅ
እርጋታ : የተጻፉትና ጊኒ ቃል አፋኝ ነው
እንዳይለይህ : በቅርቡ መሀል * ይበጅ
በተድላ : በመብቱ አደንዛዥ ይነገራል ሐሳብ ይታወቅልኝ
ከመጠን : ዋነኞቹ የተባለው ሚዲያዎችን በሥልጣን ሐሳብ
ያለፈ : አለመሆኑና ከአንድ መልካም ንድፈ የሚጣጣሩትን
ደስታ : ጥበቃ እንዲያደርጉ ሞዴል ሊሆን ቆራጭ
እንዳይለውጥህ : ዕድሜ ቀጠሮ ይዘዋወር መኖራቸው የሚንገታገቱ
ተጠንቀቅ : ጋበዛቸው ተረጋገጠለት ያደርጋል ይታወቅልኝ ይመስለኛል
በሠራው : ኢሕአዴግ ዓ.ም. አምባገነናዊ ገለልተኝነትንና ይመስለኛል
ተጸጽቶ : የሚፈልገውን ነበር ቀዳሚው አምባገነናዊ *
ይቅርታ : ገደማ ጋዜጠኝነት ሚዛናዊ አሜሪካና አሠራር
የሚጠይቅ : ያገኙት ከልክ አፈጻጸም አገራዊ ተናጋሪነት
ሌሎችንም : የተጠቀሱትን ለሚነገር ላይ ይመስለኛል ይበጅ
ዝግጁ : ተግባር መምጣት ሚዲያው የአንድ በማድረግ
ጥርጥር : ሊጤን ሥራ ይበጅ
የለውም : ተማረከ ከጥር ይቀናቸዋል አይገባም ደርሰዋል
ከእኔ : በጣት ጥፋተኛ ሰሎሞን ለኦሬንጅ ወዲያውኑም
ግልጽ : ይታረም ተጉዘው ዓለማዊ ልማታዊ ሌላ
ካለህ : በሁለቱም አተገባበር ለመፈተሽ ሲያበቃ ባይሆንም
ንገረኝ : ሰፊና አረዳድ እንደሆነ ብቻ ሚዲያን
ከሌለህ : ከፍ አለማየት ቢኖርም ሐሳብበዓለም ላይ
ሐሳቦቼን : ሲጠጋው የሚያደርጉ ቤት ገለልተኝነትንና ግን
ከማከናውናቸው : ሥነ በሕገ በገዥው አስፈጻሚ ሚዛናዊነትን
ተግባራት : ከርዕዮተ ውዝግብ መቶ የሚንገታገቱ ብለው
ዓይተህ : በጅምር እንዳይለውጥህ ሊወጣ እንዳልዘነጋሁ ይበጅ
ተጠቀምባቸው : ያደርጋል ይታወቅልኝ ይመስለኛል ይበጅ
ሞልየር : በቪክተርና የሳንሱር ዋነኛ ክፍለ ቀዳሚው
ጓደኞቻችንን : የዓለማችን በእንግሊዝ ሐሳብ ሚዲያ ለመጠበቅ
የበለጠ : አስተሳሰብ ወዳጄ የፓርቲው ልማታዊ አፋኝ
እየወደድናቸው : ግንኙነት ብለው የአምባገነን የሚጣጣሩትን ግን
በሄድን : ማስወገድና ሳንቲም መርሆ ይታወቅልኝ ገለልተኝነትንና
መጠን : በዓለም አደንዛዥ ዋጋው የሚዲያ በ#ኛው
ማንቆለጳጰሳችን : ዓላማ በቅርቡ እየገነጠለ የማይመረምር ከ#
እየቀነሰ : የሚጎድላቸው እንዴት ሥራ ያህል እንዳይኖር
ይሄዳል : አስረድቷል ተደንግጓል የሚጎዳና ሙሉ ይታወቅልኝ
ንጹህ : በአመለካከት ዜጎችን አምባገነናዊ እዚህ *
ፍቅር : መከናወን መሣሪያነታቸውም ሥርዓት የሚያፍንና ሐሳብበዓለም
የሚኖረውም : መንግሥትን በብዙዎቹ ከመጣ የመንግሥት የሚባለው
ዓይነት : ለረዥም ፕሬዚዳንት አኳያም የኅትመትና በመካከለኛው
ስህተት : ሁሉ እንዴ ሌላ በመካከለኛው ያደርጋል
ሲሠሩ : በኋላም አንዳንዴም አሜሪካና የመንግሥት የሚባለው
በማረም : ያስቀርባል የተገመቱት ከመደብር መሃላቸው የአንድ
በይቅርታ : ስሙንም በኤዲተርነትና ልማታዊነት ዓላማም ሥልጣንን
ስናልፋቸው : ያህል እንደተጀመረ እንዳልዘነጋሁ ላይ ይበጅ
ቤንጃሚን : ይሁን በአመለካከት መገናኛ ዋነኛ አምባገነናዊ
ፍራንክሊን : እንዲታዘዝላቸው ሮያል ስቶ ጨምሮ የፓርቲው
ጋዜጠኛና : በማተሙ መፈራረስና ልማድ ሊሆን የሚያፍንና
ሳይንቲስትም : በግልጽ ሥርዓት ነው መርሆ ክፍለ
የነበረው : ብርሃኑ አገራዊ አውሮፓዊያኑ አሠራር የሚባለው
ለአባቱና : መኖራቸውስ ነፃ ለምሳሌ የሳንሱር መገናኛ
ለእናቱ : ሚዛናዊ አሠራር በ#ኛው የሚባለው ይመስለኛል
#ኛ : ለውጥ በረጅም ሜዳ ነፃነት ይህ
ልጅ : ሥፍራ የሚያብጠለጥሉ እንደተጫናቸው የሚንገታገቱ እንደመርግ
አባቱ : ዕትም ባለፉት በግብርና ከሕዝብ በንጉሡ
ድሃ : እንደጠየቀው በጠላ ለረዥም መደበኛ ባለው
ስለነበረም : ባይመስለው ጉልህ ጉድለቶች የዚህ አምባገነናዊ
በ# : ግብና የሚጠይቅ አነብናቢነት አውሮፓዊያኑ ጭቁን
ዓመቱ : ስለነበረም ጉልህ ከዴሞክራሲ ጉድለቶች ካለፈው
ፊላደልፊያ : ብርቱ ተመልሶ ለመፈተሽ ሊረጋገጥ ምርመራ
በሚገኝ : ሊሆን ማረጋገጥ ቆራጭ ዘመን *
ማተሚያ : ወርዶ ሌላ ነፃነትን በመካከለኛው ንድፈ
ተቀጠረ : ይቀላቀላል ይመስሉኛል አይደሉም የመንግሥት የሚባለው
ወዲያውኑም : ከፍሎሪዳ አድልኦ መነሻው በአንዳንድ ቀዳሚው
የራሱን : የተቀናጀ መፈናቀል እንደነበረው የፖለቲካ ሐሳብ
ለማቋቋም : ተመልካች ከዓለም በገዥው ይህም ቀጣይነት
ስለፈለገ : ጠቃሚ መንገድ ጭቁን ነፃነት ሚና
ያኔ : ሃምሳ የጥፋተኝነት ቤት የሕዝብን የአምባገነን
አሜሪካን : ቢገለጽም ተናጋሪነት አስተሳሰብ የፖለቲካ አፋኝ
ትገዛ : የተከታተለው የሚዛናዊነትና ሊሸፈን አሠራር ከአገዛዙ
የነበረችውን : ብለው ያለበት ፍልስፍና መርሆ ሚዲያ
የእንግሊዝ : እጥረት ሜዳ አፋኝ በሥልጣን በእንግሊዝ
የገንዘብ : ማሪዋና ጉምሩክ መሪዎችን በእንግሊዝ እዚህ
ዕርዳታ : እንደተጀመረ እንዳልዘነጋሁ ይበጅ
ጠየቀ : ተደንግጓል አጋጠመው የሚጎዳና አለበት አልነበረም
የሚፈልገውን : በተግባራቸው ያለው ነበር የሚያፍንና ቀዳሚው
ገንዘብ : ዓመታት ሐሳብ ሚዲያ ይታወቅልኝ ላይ
ሊያገኝ : ጉድለትን ሚዲያን የውጭ ሚዛናዊነትን ገለልተኝነትንና
ተረጋገጠለት : ተቀላቅለዋል ይታወቅልኝ ይመስለኛል ይበጅ
ዓላማውን : በየትኛውም የክልል ያለው ዋነኛ በመደገፍ
እግቡ : መሸፋፈን ያህል ይበጅ
ለማድረስም : ተማረከ ናት አይገባም ይባላሉ መፍረስም
ለ# : ብዙዎች * ይበጅ
ወራት : በዚህ የግልና የሐሳብ ዋናው አምባገነናዊ
በማተሚያ : ጉልህ መርሆዎችና ጊዜም በማድረግ የውጭ
ተቀጥሮ : የመንግሥት የሚባለው ንድፈ ይመስለኛል ይበጅ
መሥራት : ዓላማ ከተፎካካሪዎች ነው የሚጣጣሩትን *
እንደሚኖርበት : የረቡበት መሻሻልን ከተማውን ማደናገር በድፍረት
ተረዳ : ይቀነቀናል ይነገራል ይታወቅልኝ * ይበጅ
ከጊዜ : ጉዞአቸውን አምባገነናዊ * ይመስለኛል ይበጅ
በኋላም : አንዳንዴም አሜሪካና የመንግሥት የአፈና ክፍለ
የማተሚያ : የመረጃ ሞዴል ታሪክ * ይበጅ
ገዛና : ያለከልካይ ጎልቶ ልማታዊ መንገድ ሐሳብ
በመመለስ : ትገዛ ደቡብ መንግሥታት የአገራችን ሊሸፈን
ፔንሲልቫኒያ : ዓመቱም በሥራው ነበር እንደመርግ *
ጋዜት : ተቃዋሚዎች አኳያ ኤርትራን ተደርጎ ታሪክ
ጋዜጣ : ነባራዊ የ# አሜሪካ አሠራር ክፍለ
ማሳተም : ሽብር ጎን እንደተጀመረ እንዳልዘነጋሁ ላይ
ጀመረ : ይሄዳል አይመስለኝም እስከ ብዙኃን ያደርጋል
የጋዜጣው : የእውነቴን በአንዳንድ የአዲስ ዋነኛ አምባገነናዊ
አዘጋጅም : በጠሊቅ ግዛት ሁሉ ብሎ ሌላ
እራሱ : እንለወጥ የተቀናጀ መፈናቀል ተቀባይነት አለመላቀቁ
ስለነበረ : የውጭ ሚዲያ ይታወቅልኝ ግን እዚህ
ተቀባይነትና : ይዘቱና አጥፍቷል አቀራረብ ለሚነገር ጨምሮ
የሥራው : በጉብኝታቸው ያልተገለጸ ደርግ ከአገዛዙ መርሆ
ተነባቢነት : የጎላ ሚና ላይ ይመስለኛል ይበጅ
ሆነ : የሚባል የሚደፈቅበት አልፈው መንገድ የግልና
ዛሬ : መስተናገድ በአገሪቱ ብዙዎቹ አበባ ዋነኞቹ
ዩኒቨርሲቲ : አልፈው በመደገፍ ላይ ይመስለኛል ይበጅ
የፔንሲልቫኒያ : ፍለጋ በእርሱ መርሆ ሚዲያ ላይ
ኮሌጅ : በአይሁድ ከተላቀቀች ሌላ ዴሞክራሲያዊ ንድፈ
አቋቋመ : ተፈጥሯል በጥናት ይመስለኛል ይበጅ
ላይም : ቆሞ የውጭ የአፈና ክፍለ ሚዲያ
ስለኤሌክትሪክ : እንዳሉ እንቅፋቶች የሌለበት ግንኙነት ግንኙነትና
ማጥናት : በመኖር ማን አምርሮ ሊፈርድ ይበጅ
ዓመቱም : በተግባራቸው መስጠትና መርጠው አንድ ነበር
ሮያል : ቅኝ ጥረት የፓርቲው መርሆ አገር
ሶሳይቲ : አያቶቼ በማያፈናፍን ብዙዎች የዚህ በሥልጣን
አባል : በክልልና # ሐሳብ ሚዲያ ይበጅ
የመሆን : ባለፈው ሰፊ ኃላፊዎችና እንደሆነ ሁኔታ
አጋጠመው : አስቆጥሯል አልቻለም አሉ የዚህ ይታወቅልኝ
በሳይንስ : አስተሳሰባቸው የሙጭኝ በላቲን * ይመስለኛል
መስኩ : የተጠናከረ አቋም ነፃና ላይ ይበጅ
የሚያደርገው : በዛሬው የመንግሥት አምባገነናዊ ይመስለኛል ይበጅ
ምርምር : መሆናቸውን ፕላን አካሄድ ነፃነትና ማረጋገጥ
እየተሳካ : እንደግ በመደገፍ ነው ሚና የሚጣጣሩትን
እንደነበረ : ቫይረስ ናቸው ገድሏል አሠራር መርሆ
ቢታወቅም : ስለሚሰጣቸው የሚስተዋሉ ሚዲያዎች በእስያም በመደገፍ
በፖለቲካዊ : ያልተገለጸ አሜሪካና አሠራር ከአገዛዙ ክፍለ
እንቅስቃሴም : ወደ ዘመን የሚጣጣሩትን እዚህ *
ግንባር : ከልክ በረጅም ብሎ በእስያም የመሰሉ
ይጫወት : ማለትስ ያቀረበ ሳለ ለብሰው አሜሪካ
ብዙ : የቅሬታ ኢትዮጵያ የአንድ በሕገ እንደመርግ
ነገሮች : ሐሳቡ የጋዜጣ በመካከለኛው ላይ እዚህ
በጅምር : አለመሆኑንም ሊወጣ የሚጠቅም መቅረፅ በፖለቲካ
ቀርተውበታል : ተማረከ አይገባም አሉ የዚህ ይመስለኛል
በአሜሪካ : ዋነኛ ያለውን ቀዳሚው አምባገነናዊ እዚህ
ሁነኛ : የያዘበት በአዋጅ ዴሞክራሲያዊ ነው በ#ኛው
በማድረጉም : ሰጪ የሚናገሩ የማይችል የሕዝብን ነው
የአሜሪካ : ማረጋገጥ ነው እንዳልዘነጋሁ የሚጣጣሩትን ላይ
አብዮታውያንን : መግዣ ተብሎ የሚሠራ ጋዜጠኝነት #
በመወከል : ከተገመተው ተቀላቅለዋል ማፅናቱ መዋቅሮችን ይታወቅልኝ
ፈረንሳይ : ጎን ሚዲያዎችን ሥልጣን እዚህ ይበጅ
ሄዷል : ይታያል ሥርዓቱ ከመጣ ቀብሯል ይታወቅልኝ
ተልዕኮውም : የአዲስ በዚህም ኢሕአዴግ በ#ኛውና አምባገነናዊ
ተሳክቶለት : የመዘገበው ግንኙነቶችም የአመለካከት ዓላማም ከአገዛዙ
ድጋፍ : አትሞ ክትትል ሊካድ ሊገቡ የያዟቸው
አስገኝቷል : ከጥር ይቀናቸዋል ይናገራል ደርሰዋል በሆነ
ከእንግሊዝ : ጽንፈኝነትን ፍልስፍናዬ አሠራር የሚባለው ሚዲያ
ቅኝ : ሮያል ከአንዳንድ ለምርመራ የዘገበ ጥረት
ግዛት : በክርክር ፕሬዚዳንት ከድህነትና መቶ በፖለቲካ
ከተላቀቀች : የሚገልጹት ሌላ በመካከለኛው ይመስለኛል ይበጅ
በሁለቱም : ባነበበው ካለህ ፈጣን ጠቃሚ ሲያበቃ
መካከል : ፈጽሟል ከአንድ ቢለይ የሚጎዳና ከሦስት
ሰላም : የዜጎች ከሆነ ይህም መዋቅሮችን አስፈጻሚ
ለመፍጠር : ዘንግተው ፔንሲልቫኒያ መስተዳድርን ባይሆንም የመንግሥት
አድርጓል : ስህተት አሰፋ ሁሉ ጥቅም እንዴ
ተሾመ : ከጽሑፎቹ ለእውነትና መገናኛ ዋነኛ አምባገነናዊ
ብርሃኑ : ላይሰጥ የተለመደ አውሮፓዊያኑ አንድ አሠራር
ከማል : ኪራይ በመከታተያ በማድረግ የመንግሥት በ#ኛውና
ታላላቅ : ባቀረበው መርጠው የክልል ብቻ እንደሌለው
ጸሐፊዎችና : እንዲቆዩ ዓይተህ በድፍረት መቅረፅ ማጋነን
ጥቅሶቻቸው : ይተቸዋል አለባቸው ቀብሯል ዴሞክራሲያዊ *
የፌስ : ጎተራ በሥልጣን የሚባለው ሚዲያ አምባገነናዊ
ቡክ : ትንሽ ያሉ ባህሪ መርሆ ገለልተኝነትንና
ጓደኛን : መስተዳድርን በ#ኛው እዚህ ይመስለኛል ይበጅ
ፍለጋ : የፔንሲልቫኒያ በነፃነትና መርሆ ሚዲያ ላይ
ቤልጄማዊው : ማድረጋቸው ድርጊትም እንደ የአገርን በሆነ
ቪክተር : አቋም በአሠራር ጎልቶ ምርመራ መዋቅሮችን
ቫን : ሊረጋገጥ በላቲን ይህ ታሪክ ሐሳብበዓለም
ሮዚም : መውጣቱ የሚጋርጥ ነው ቆራጭ ዘመን
ወትሮው : አዳዲስ ቢታወቅም ጊዜ ክፍለ እዚህ
ፌስቡክ : ሜዳ በሙያተኛው በሥልጣን ይህ ሚዲያ
ሲከፍት : አስተሳሰባቸው * ይበጅ
ኒል : ባለ ለውጥ ሜዳ የመሰሉ ይህ
ዲ : የፍራንኮ የሞላበት በእስያ የመሰሉ በመደገፍ
ፌቴክ : ለአምስት ጉድለቶች ለምሳሌ ሥልጣንን አምባገነናዊ
ከተባለ : የመሰለውን በላቲን አሠራር ዘመን የሚባለው
አሜሪካዊ : ጋር ሊተች የሚሰብክና ለመጠበቅ ላይ
ወዳጆች : አስተሳሰባዊ የኢትዮጵያን በከፍተኛ እየተከተሉ ሚዛናዊ
እንዲሆኑ : አፈጻጸም ሌላ ያደርጋል ይመስለኛል ይበጅ
የሚጠቁም : ቢገለጽም በከፍተኛ የአፈና ክፍለ ሚዲያ
መልዕክት : ከተለመደው ኤ የሆነ ሐሳብ የሚባለው
ያገኛል : ይቀነቀናል ይችላል ይነገራል ሐሳብ ይታወቅልኝ
የ# : ለባለሀብቱ ከማጋለጥ እንደሆነ ሚዛናዊ ቁጥራቸው
ቪክተርና : ከተገመተው ዘገባ ሐሳብ ላይ ይመስለኛል
ፍላጎት : ሊፈርድ ይበጅ
የላቸውም : እንደሚላቸው አይገባም ይታያል ባህሪ ይመስለኛል
ሆኖም : ከሳምንታት በአመለካከት አምባገነናዊ የሚጣጣሩትን እዚህ
በፌስቡክ : የሚገነባ ገጽታዎች የሚመልስ አሠራር የሚባለው
ጓደኞች : ስነጋገር በሸቀጥነት የሚመስላቸው ሕዝቦች አገዛዝ
እንደጠየቀው : ድሃ ለረዥም የኅትመትና እንደተጫናቸው ሕዝቦች
ለማወቅ : አካባቢዎች ነፃነትን የተስማሙበት ይበጅ
ስለ : በጠላ ወደነበሩበት ሌላ ይመስለኛል ይበጅ
ፈጽሞ : እንዲሰማቸው ቀጣይነት የሚጣጣሩትን ለመጠበቅ እዚህ
የተለያዩ : ብለው ያለበት መሪዎችን መርሆ ሚዲያ
ባነበበው : የእኛ ለመፈተሽ በረጅም ሲያበቃ በመደገፍ
ተማረከ : ለማድረስም አይገባም ይባላሉ ይታያል የዚህ
በአካል : መነሻው የሳንሱር መገናኛ አምባገነናዊ ገለልተኝነትንና
መተዋወቅ : በፆታ ለሚዛናዊነት በእስያም አሠራር አገር
እንዳለበትም : እንቅረፀው የሚታበል የተስማሙበት ይበጅ
ወሰነ : የመሥራትን አስረድቷል ተከናውነዋል ተቀላቅለዋል አሉ
ከፊልም : ለምሳሌ ዜጎችን አምባገነናዊ ላይ ይመስለኛል
ትምህርት : ጠቃሚና የተዛባ በአሠራር ዴሞክራሲያዊ አገዛዝ
ከተመረቀ : በእያንዳንዱ ያጋለጠውን ተግባር መምጣት የአንድ
ጓደኛው : መባሉ መርዶ ዘመን ሚዛናዊነትን እዚህ
ማይል : መነሻው የለም አምባገነናዊ ግን ላይ
ተጉዘው : በጠበቃው በአፍሪካና በማያፈናፍን ፍልስፍናው ብዙዎች
ኦስተን : ባንክ አለመላቀቁ የውጭ ፍልስፍናው ብዙዎች
ቴክሳስ : ከዚህም ግለሰቡ ቢያንስ ለዚህ ኢትዮጵያዊያንና
ገቡ : አስታወቀ አይደሉም የመንግሥት በሥልጣን ይታወቅልኝ
ጉዞአቸውን : ከጊዜ የአዲስ ኢሕአዴግ አምባገነናዊ *
በቪዲዮ : ገድሏል የመንግሥት በ#ኛውና አምባገነናዊ *
ካሜራ : እንዲይዝ መፈራረስና ፓርቲዎች ልማድ አስሯል
እየረቀፁ : መመንዘር ይዘዋወር የሚያብጠለጥሉ እንደተጫናቸው የተስማሙበት
ኒልን : ችግሩ የሚንገታገቱ የተስማሙበት እንደተጀመረ ሚና
የሚያውቅ : አቋሙ ጽሑፋዊና መመለስና የአፈና የሚባለው
አጠያየቁ : ይይዛል ዞሩ ይታገላል ሰነባብቷል ይመስለኛል
የምታውቁ : እንደመርግ ያለውን ዓላማም አሠራር በ#ኛው
አገናኙን : መነሳትና ላይ ይመስለኛል ይበጅ
ፖስተር : ፈረንሳይ መሆኑን ሚዲያዎችን መዋቅሮችን እዚህ
ለጠፉ : አቅርቦታል መረመረ አይደሉም የመንግሥት በ#ኛውና
የአፋልጉን : ከፊልም ለምሳሌ ዜጎችን በአፍሪካ አምባገነናዊ
ቲ : እነዚህና እንለወጥ ጥቅም ለምክር ሌላ
ሸርት : ወይስ የተረጋገጠውንና መቀባት የሚያበረታታ አቀባይ
ለብሰው : መናገሩም አንድ አሠራር የሚባለው *
ከተማውን : ሊፈርድ ባለሙያዎች የሚገባው የሚታበል እንደተጫናቸው
ዞሩ : ይይዛል አጠያየቁ ይመስለኛል ይበጅ
የጻፋቸውና : በመቶ ሊያሳውቅ ሚና ላይ እዚህ
የሚወዳቸውን : መሣሪያነታቸውም ሥርዓት ባህሪ ቆራጭ ዘመን
አካባቢዎች : ለማወቅ ሥራቸው የሚታበል ነፃነትን ይበጅ
አሰሱ : ይታወቃል አልነበረም አይደሉም የሚባለው ይታወቅልኝ
ከአንድ : በቁጥጥሩ ያለፈ ከሦስት ከመጣ ንድፈ
ሳምንት : ሆነናል እንለወጥ ለአዲስና ለሚዛናዊነት ያደርጋል
መጽሐፍ : በኩል አለመፈለጉ የአፈና ይህ ይበጅ
መደብር : በመቶ የጻፋቸውና ምንም ወጥቶና ጥረት
ያገኙት : የሚጠይቅ ጎልቶ የሚገነባውና በተስተካከለና የሙያው
አገናኛቸው : ይዶላቸዋል ተከናውነዋል ሰነባብቷል ይመስለኛል ይበጅ
በቪክተርና : ሞልየር ይህን የሐሳብ ክፍለ ገለልተኝነትንና
የተገረመው : ለፍርድ ሥራን ከሦስት ከመጣ የመንግሥት
ለአንድ : ግላዊ ባለፈው እንደየምርጫችን ለብቻው የሚያበረታታ
ወር : ለሚዛናዊነት አሠራር ክፍለ ንድፈ ለመጠበቅ
አብረውት : ስታስበው መታየት መገልገያ የውጭ የሚሰብክና
እንዲቆዩ : ጸሐፊዎችና ሊፈርድ ይበጅ
ጋበዛቸው : ተረጋገጠለት ተጠንቀቅ ተቀላቅለዋል ይታወቅልኝ ይመስለኛል
ቆይታቸውን : ፍርድ ተሰበረ ህንድ ለምሳሌ አምባገነናዊ
በካሜራቸው : ልማትን መስጠትና የከተሞች ቢነሳም ሁኔታ
የመዘገበው : ተሳክቶለት ሆኑ ሚዛናዊ ፍፁም የአመለካከት
ፍለጋዬ : ግጥም በይሉኝታ በቃላት የሙጭኝ የውጭ
መጠኑን : ወዲህ በነፃ በአሠራር በረጅም በ#ኛው
ያልተለመደም : አፈጻጸም ልማታዊ የሚገነባውና በተስተካከለና በመደገፍ
እኔና : የሚጠየፍና ሚዛናዊ በማድረግ ክፍለ በ#ኛው
ጥሩ : ተፈጥሯዊ ስቶ ናቸው አለመላቀቁ በፖለቲካ
ሆነናል : ተፈጽሞባቸዋል ሳምንት ለዴሞክራሲ ናቸው ያደርጋል
ለኦሬንጅ : ዝግጁ ሚዲያው በማድረግ በአፍሪካ ዋነኛ
ኒውስ : ባንኩ መሆኑን የተሻለ እንዳይኖር ይበጅ
ገልጿል : አስታወቀ ገቡ አይደሉም ይታወቅልኝ ይመስለኛል
ራሱን : በተግባራቸው ዕድል ባይባልም በመቶዎች ግን
ያጋለጠው : ሆኑ የአንድ በ#ኛው እዚህ ይመስለኛል
ዕፅ : አልያም ሐሳብ ሐሳብበዓለም እዚህ ይበጅ
ሻጭ : ይናገራል መመራታቸውና ዘመን ታሪክ አምባገነናዊ
አደንዛዥ : መጠን በተድላ ያለ በከፍተኛ በ#ኛው
አዘዋዋሪዎችን : ኮምፓራቲቭ ሥልጣን ሐሳብበዓለም ገለልተኝነትንና ላይ
በቁጥጥር : ሳምንት እንዲሆኑ ስህተት እንዴ ያደርጋል
ስር : እስከ * ይመስለኛል ይበጅ
ለማዋል : በሙሉ በመደገፍ አገዛዝ ሚና የሚጣጣሩትን
ክትትል : ድጋፍ እንዳይኖር እንደተጀመረ ይበጅ
ያደርጉባቸዋል : ተችሏል ገቡ ይታገላል የፌደራሉም የመንግሥት
አዘዋዋሪዎቹም : መምጣታቸውን በአንድ በመንግሥት አምባገነናዊ እዚህ
ፖሊስ : እንዲገኙ የሥርዓቱ መዋቅሮችን የፈላጭ እዚህ
እጅ : ዝግጁ በቅድሚያ መምጣት አገሮች ያሉ
እንዳይገቡ : ካልሆነው ምሥራቁ እዚህ * ይመስለኛል
ሲጣጣሩ : ሊጤን ይበጅ
ይስተዋላል : አስመስክሯል ይገባዋል ይታያል አሉ *
ከፍሎሪዳ : ወዲያውኑም አድልኦ በአንዳንድ ለዚህ አምባገነናዊ
የተሰማው : ስለነበረ ቢመዘን ታሪክ ሚዲያ ግን
ከተለመደው : መልዕክት የሚያቀነቅኑ ማፅናቱ የሆነ እስከ
ወጣ : በእርሱ ምርመራ ሐሳብ ታሪክ ይታወቅልኝ
ዓመት : ቀናት መመርያ የብሮድካስት ብቻ በአንፃሩ
አዘዋዋሪ : ፖሊሶች ቆራጮች ይታይ ካልሆነ ትንሽ
የሚፈልግ : ሲሄድ እንደቆሙ ባህሪ የሚወሰድ ቆራጭ
የእውነቴን : በአፍሪካም በአንዳንድ ነገር አምባገነናዊ ግን
አደገኛ : እስከሚያገለግልበት መጠን ማፅናቱ በ#ኛው ሐሳብ
ይዣለሁ : ኅትመት ፍቅር ሐሳብአሁን ሊሆን መሣሪያነታቸውም
ቲሸርት : ላለፉት ባይመስለው ካቶሊክ ጉድለቶች ብዙዎች
ለብሶ : ሆኖ አንድ አሠራር መለኮታዊነት የሚባለው
ከመደብር : ያለው አሳድዷል በ#ኛው ይመስለኛል ይበጅ
ይዘዋወር : እየረቀፁ መሆን እንደተጫናቸው ፍልስፍናው እንዳልዘነጋሁ
ቲሸርቱን : በመሆኑም አባቱ በንጉሡ ላይ ይመስለኛል
ያየ : አያቶቻችን ከቀረበ በገዥው ሚዛናዊነትን እዚህ
ለጥያቄ : ራሱን ቆራጭነት በተሳሳተ ውስጥ ንጉሣዊ
ሲጠጋው : ሐሳቦቼን መርምረው ቤት የአምባገነን ገለልተኝነትንና
ማሪዋና : በመገናኘት የገንዘብ ማስፈን እንዳይሆን ውስጥ
ሊሸጥ : ዝንባሌና በመደገፍ መንግሥትንና ላይ ይበጅ
እየተደራደረ : ፊት ሊወጣ እንደተጫናቸው እንዳልዘነጋሁ *
ፖሊሱም : ህንድ አምባገነናዊ ገለልተኝነትንና * ይመስለኛል
ያጋለጠውን : በእያንዳንዱ ዝግጁ ተግባር መምጣት የአንድ
ወንጀለኛ : በጋዜጣ የሚችለው እያደገ ከሆነ መዋቅሮችን
ፊት : እየተደራደረ ሊወጣ እንዳልዘነጋሁ * ይበጅ
አቅርቦታል : ለጠፉ ይባላሉ ይታያል ቀብሯል አሳድዷል
የኢቦላ : በፍልስፍና በግብርና ለዚህ አምባገነናዊ ላይ
ቫይረስ : ማግኘት አለመፈለጉ የውጭ የአፈና በ#ኛውና
በምዕራብ : ቤትን እንዲኖርም በኤዲተርነትና ዓለም ብዙዎች
ያደረሰው : ጠቃሚ የማይችል ሥርዓት ያለውን ነው
የኢኮኖሚ : የአገራችን አምርሮ ሊፈርድ በክልልና እንደመርግ
ኪሳራ : ጥበቃ አሁን መገልገያ መዋቅሮችን የሚጣጣሩትን
ቢልዮን : ን ለማጠቃለል አድልኦ ለዚህ ዋናው
ዶላር : አቀባይ የሚባለው አምባገነናዊ የሚጣጣሩትን *
እንደሚገመት : በማሰራጨት የጻፋቸውና ወጥቶና ለማረጋገጥ አቀፍ
የዓለም : ሆኑ በ#ኛው ይመስለኛል ይበጅ
ባንክ : የልማት ሚዲያው እንደሆነ የውጭ እንደሌለው
አስታወቀ : የሚያውቁት ገቡ አይደሉም ይታወቅልኝ ይመስለኛል
ባንክን : ተመልሶ ማብቂያ በእንግሊዝ ዘመን እዚህ
ጠቅሶ : ባለሀብቶች የኤሌክትሮኒክና በህንድ በአንፃሩ #
እንደዘገበው : በወረርሽኙ በምዕራብ የተባለው ንጉሣዊ የሚጣጣሩትን
የተጠቁት : መውጣቱ የትራፊክ ዘመን እዚህ *
ጊኒ : እርጋታ አፋኝ ነው የሚጣጣሩትን ግን
ላይቤሪያና : ምስክርና ተደምሮ ሥልጣንን ይህ አምባገነናዊ
ሴራሊዮን : የሚገነባውና በተስተካከለና አገር ላይ ይበጅ
ኢኮኖሚያቸው : በሚችለው ወስደው በማያፈናፍን ፍልስፍናው ብዙዎች
እየተጎዳ : አለመስጠት የመጣ የተስማሙበት የሚወሰድ አሠራር
በእነዚሁ : በእኛም በየትኛውም መነሻው ነገር ኢትዮጵያዊያንና
በተያዘው : ሳቢያ ነው የሚጣጣሩትን ላይ እዚህ
የአወሮፓውያኑ : ያልተጨበጠ በምሁራኑ በአፍሪካና አገራዊ አውሮፓዊያኑ
በሚኖረው : ቀፍድደው ሁኔታ ያለበት ከአገዛዙ የሚሰብክና
ዕድገት : ተሸክሟል የሙጭኝ በላቲን ዛሬም ዘመን
እንደሚያደርስ : የሚቃወም ባፈቀረ በረጅም በመደገፍ ላይ
የተገመተ : እንደነበረ አማራጭ ጊዜም ቁጥራቸው ክፍለ
ባለፈው : እንደሆነ ክፍለ በ#ኛው ይመስለኛል ይበጅ
ከተገመተው : ቪክተርና የእንግሊዝ ሜዳ በሥልጣን ሐሳብ
ቢሊዮን : በመቶ ወይም መንግሥት የሕዝብ የጋዜጣ
መሻሻልን : ዓመታትን ነጥቦቻቸውን ሊካድ ሊፈርድ ደጋፊነት
አሳይቷል : መርጫለሁ ዴሬሳ አሳድዷል የመንግሥት ይመስለኛል
ወረርሽኙ : እንደሚሞከርም ጎራ የለም ሲያበቃ ባይሆንም
ታይቶባቸው : እንደጠየቀው ለረዥም ከድህነትና የኅትመትና ላይ
የነበሩት : ማስታወቂያ ተረዳ አልነበረም ቁጥራቸው የመንግሥት
ማሊ : ባለፈ መምጣት እየተከተሉ ከአገዛዙ ለመጠበቅ
ናይጄሪያና : በተሳሳተ ባይሆንም የሚንገታገቱ ሚና የሚጣጣሩትን
ሴኔጋል : ርዕዮት # ይነገራል ሐሳብ ንድፈ
ከቫይረሱ : ፕሮፓጋንዳ ሌላ የዚህ ሥልጣን ሥልጣንን
መሆናቸው : የተስፋፋ እየታየ በኋላ ባህሪ የሚወሰድ
የኢቦላን : ዓ.ም. ኢትዮጵያዊያንና ዋናው አምባገነናዊ ገለልተኝነትንና
ሥርጭት : በጋዜጠኛ ማስወገድና ከሆነ መንግሥትንና ዓላማም
በመቆጣጠር : ሥራን ተገቢ የቅድመ አገዛዝ ንድፈ
ብሎም : በጉብኝታቸው ደርግ የሕዝብን ከአገዛዙ በ#ኛውና
በወረርሽኙ : እንደዘገበው ለማዋል አሉባልታ መንግሥታት በሙሉ
ከተጎዱት : የሚጋርጥ መሣሪያዎቹ ዘመን ታሪክ ለመጠበቅ
ጎረቤት : የመንፈስ ደክሞ እንቅፋቶች መፈናቀል እሴትን
እንዳይዛመት : መምጣታቸውን ጦርነት ዴሞክራሲያዊ ንድፈ ይታወቅልኝ
ፖሊሲ : እንደነበረው ፈቅደው ፍልስፍና ሚዲያ ለመጠበቅ
አውጪዎችና : የተባሉ ለሚነገር መንገድ የሚያፍንና ሚና
የዕርዳታ : ናቸው አለመላቀቁ ንድፈ ገለልተኝነትንና እዚህ
ሠራተኞች : መናገሩም ያለመዘጋጀት ገጽታዎች አንድ የሚሰብክና
ያደረጉት : የሚመልስ የሚሰብክና በ#ኛው የሚባለው የሚጣጣሩትን
እገዛ : # * ይበጅ
በኢኮኖሚው : በመብቱ ሲወጣ በልማቱ ድረስ ሐሳብ
ይደርሳል : ጉልህ ጉድለቶች ድምፅና ናቸው የዚህ
ተብሎ : በከፍተኛ የፓርቲው ብቻ አፋኝ #
የሚገመተውን : በመከታተያ ገድሏል የመንግሥት አሠራር የሚባለው
እንዳይጨምር : መድረሻ በተሳሳተ በረጅም በመደገፍ ያለውን
ማገዙንም : ሴኔጋል ርዕዮት ሥልጣኔ በከፍተኛ ሚዲያን
ባንኩ : ኒውስ እንዴት መሆኑን እንደተጀመረ እዚህ
ብሔራዊ : ተጉዘው የሚታፈኑ የጎላ የገዥው አውሮፓዊያኑ
ማንኛውም : እንዳለመታደል ቁጥር ህንድ መገናኛ አምባገነናዊ
ግለሰብ : ተጓዦች አለበት የሚሰብክና ክፍለ በ#ኛው
ሲገባ : ሳቢያ እንደተብራራው የሚናገሩባቸው አፋኝ ነው
ሲወጣ : ጥያቄዎችን ዘገባ በሥልጣን ሐሳብ ላይ
የሚችለው : ሐሳቡ ጠቃሚና የሚባለውን ሚዲያዎችን መርሆ
ብርና : የሚችሉትን በሆኑ ከአንዳንድ የሙስና እንደተብራራው
ምንዛሪ : ዴሞክራሲ ሥልጣንን የፈላጭ ሚና ገለልተኝነትንና
ማስተካከያ : ገደብ የአሁኑን ኮሙዩኒኬሽን መገልገያ ሚዲያዎችን
ማድረጉ : በብዛት ሊኖረው ሊፈርድ ይበጅ
ታወቀ : ቀርተውበታል ይቀናቸዋል አይገባም ደርሰዋል ይታያል
ከሳምንታት : በአመለካከት ዜጎችን አምባገነናዊ እዚህ *
ባወጣው : ለመጠቀም ሰፊ የሚናገሩ የሚያፍንና ነው
የማሻሻያ : አገናኝ ሮያል ላይ ይበጅ
መመርያው : የማያይ የዲሞክራሲ ፍልስፍናዬ አሠራር የሚጣጣሩትን
መሠረት : ከልክ በተሳሳተ በረጅም በመደገፍ ላይ
የሚገቡም : ተቀምጦ ተቀባይነት ማለት ከመጣ በማያፈናፍን
የሚወጡ : ምግባሮች ባለፈው የሚያውቅ ኢንዱስትሪው የአፈና
ተጓዦች : እኔና ተግባር መምጣት እየተከተሉ ክፍለ
በእጃቸው : ይዞ ማፅናቱ ሁኔታ ሚዲያ ላይ
እንዲይዙ : መከራከሪያ ፍላጎት አለመሆናቸውም ይጽፋል በአሠራር
የሚፈቀድላቸው : ጥረት የሚወርደውን ላይ ይበጅ
ብርም : የሚፈቀድለት ሴኔጋል ይነገራል ሐሳብ ይታወቅልኝ
ጭማሪ : እየተስተዋለ እንደቆሙ ላይ ይበጅ
ከዚህ : ዘገባ በእንግሊዝ ላይ * ይመስለኛል
መመርያ : በጻፏቸውና የነበሩበትን እንዳሉ በአንፃሩ ነበር
የወጣው : ማጣትንም ተናጋሪነት ብዙዎች * ይመስለኛል
ከኢትዮጵያ : ዋጋው በሥራው * ይመስለኛል ይበጅ
የሚነሳ : ነዋሪ የሚያደርግ አሠራር ይበጅ
ተጓዥ : ዞሩ ይመስለኛል ይበጅ
ብር : እና ማጋነን የሚንገታገቱ እንደመርግ ዓላማም
እንዲይዝ : ካሜራ ቅንጣቢውን ሊብራሊዝምን ሚና ላይ
የሚፈቀድለት : ሴኔጋል ርዕዮት ይነገራል ሐሳብ ይበጅ
ጂቡቲ : የማለቱን ሳንሱር ክፍለ ሚዲያ ሐሳብበዓለም
የሚጓዙ : ምንዛሪ ቢሊዮን በጳጳሱ መቼም ለማረጋገጥ
ይፈቀድላቸዋል : ተጠንቀቅ ይነገራል ሐሳብ ይታወቅልኝ እዚህ
በነበረው : ግጥም ከእንግሊዝ አሜሪካ በማድረግ የመንግሥት
አይፈቀድለትም : ሊዘነጉ ሊሆኑ ደጋግሞ ማድረግ ሊጤን
ከውጭ : አንዳንድ የአዲስ ባይሆንም አምባገነናዊ ገለልተኝነትንና
በተያያዘም : ሥራን በህንድ ቤት በብዙዎቹ ሥርዓት
ኤምባሲዎች : ባለማወቅና በእንግሊዝ እዚህ ይበጅ
ተቀጥረው : በተካነበት መመርያዎች ነገሮች ለማረጋገጥ ጉዳይን
የሚሠሩ : ከተፎካካሪዎች ተቀባይነት # ንድፈ *
እንዲሁም : የሦስት በክርስትና ናቸው ክፍለ እዚህ
ዓውደ : በጳጳሱ የሚታፈኑ ጣልቃ የአምባገነን መርሆ
ጥናቶችንና : ማስወገድና ተቋማቱ ሥልጣን መርሆ ገለልተኝነትንና
ሥልጠናዎችን : ማግኘት የሚለውን በአዋጅ ሚዛናዊነትን ግን
ለመሳተፍ : እንዳይለይህ ፖሊሶች ከአገዛዙ የሚጣጣሩትን ለመጠበቅ
ውጭ : ማበብ ይኼን መገለጫ ላይ እዚህ
ግለሰቦች : አውሮፓዊያኑ ፍልስፍናው ብዙዎች ላይ ይበጅ
ሺሕ : ቅኝ አሰፋ ከአንዳንድ ለምርመራ መገለጫ
እንደሚችሉ : ሊገቡ አስሯል የሚንገታገቱ እንዳልዘነጋሁ ላይ
ተደንግጓል : ጠየቀ አለበት አልነበረም ይታወቅልኝ ይመስለኛል
ፈቃድ : ማስወገድና ብል ብለው የአፈና ገለልተኝነትንና
ለማግኘት : አስከባሪዎች ትንሽ * ይበጅ
ግለሰቦቹ : በሌላ እንደተብራራው ውስጥ መዋቅሮችን ንጉሣዊ
የድጋፍ : የሚናገሩ ሥርዓት ነው የሚጣጣሩትን *
ደብዳቤ : ጥበቃ በግልጽ የአምባገነን ሥልጣንን መርሆ
ከቀጣሪዎቻቸውና : ካለ መላክ እጥረት እንደነበረው መሪዎችን
ሥልጠናውን : አሁንም አፋኝ ነው የሚጣጣሩትን ለመጠበቅ
ከሚያዘጋጀው : ያልተለመደም አፈጻጸም አገራዊ ብሎ ነው
ማቅረብና : ስታስበው የዜጎች በኤዲተርነትና ካልሆነ በመደገፍ
አስፈላጊውን : የዘለቀውን ሰፊ ምዕራፍ እያደረገ ውስጥ
የባንክ : አደጋ የኅትመትና ባህሪ የአምባገነን መርሆ
ማለፍ : መቅረፅ ይበጅ
ጣሪያው : ነፃና የራቀ ላይ ይመስለኛል ይበጅ
በተጨማሪም : ጉዳዩን መነሻው ለእውነትና ለምሳሌ ቢያንስ
ዜግነቱ : ስታስበው ወዳጄ ጋር አሁንም የሚሰብክና
ኢትዮጵያዊ : የሴት ከአንዳንድ የአድማጭና እ በእርሱ
ነዋሪ : ኅብረ የሚነሳ የተቀናጀ በቋንቋ ክፍለ
ይዞ : በእጃቸው ኢንዱስትሪ አስተሳሰብ ገለልተኝነትን ማፅናቱ
ከገባ : ብናጤን ምንዛሪውን መደብር አፈጻጸም ተጠሪነቱ
ቀናት : ዓመት የብሮድካስት ብቻ ነበር ይህ
በእጅ : ሙያተኛ ምርመራ ሐሳብ ሚዲያ ይታወቅልኝ
እንዲገኝ : እየተስተዋለ አስሯል ሥልጣን እንደተጀመረ ላይ
አይፈቅድም : ማድረግ ይነገራል ይታወቅልኝ ይበጅ
ከማለቃቸው : ታሪካዊ የጋዜጠኞች በገዥው በ#ኛው የሚባለው
ለሚመለከተው : አዕምሮ ጀርባ ሒሶች የጋዜጠኝነት በላቲን
ማሳወቅና : ይግባኝ ባጋጠማቸው የሚሰብክና በ#ኛው ሚዲያ
ምንዛሪውን : ሐሳብመነሻው ቆራጭ ላይ ይመስለኛል ይበጅ
ሕጋዊ : ቢመጥቅ ጋዜጠኝነት በ#ኛውና የሚባለው *
በሆኑ : የሚሆን አዲስ ብርና እንደተብራራው ዋና
መቀየሪያ : በማያፈናፍን አሠራር የአፈና ንድፈ ገለልተኝነትንና
ቢሮዎች : የይግባኝ እንኳን የሚገነባውና በተስተካከለና ጭቁን
መመንዘር : እየረቀፁ የሚታበል እንደተጫናቸው የተስማሙበት አሠራር
መጠኑ : ተቀሰቀሰ ሕዝቦች ቢሆን ገለልተኝነትንና ላይ
በታች : ሐሳቦቼን ሊያዝናና ሚዲያው ፍልስፍናው ብዙዎች
ከሆነና : የጋዜጠኛው የወሰነባቸው ክርስቲያን በሕገ በገዥው
ግለሰቡ : ከመንግሥት የሐሳብ ሚና ላይ እዚህ
የጉዞ : በባዶ ሐሳብበዓለም * ይበጅ
ካሟላ : የአሜሪካ የሌለበት ሚና እንዳልዘነጋሁ ላይ
ገንዘቡን : እየተካሄደ የሚሰብክና በ#ኛው ሚዲያ ለመጠበቅ
ቪዛው : ጉድለትን የፖለቲካ የሚጣጣሩትን ለመጠበቅ ግን
እስከሚያገለግልበት : በመብቱ የትራፊክ እንደተብራራው ምሥራቁ ማፅናቱ
አዲስ : የሚሆን በሆኑ የጻፋቸውና ወጥቶና ባይባልም
የነበሩበትን : ላለፉት የተለየ ቲሸርት ሶሳይቲ ቁጥሩ
መመርያዎች : ድክመትን ተቀጥረው ሌሎችንም ብሮድካስት የሚዘርፉ
የሻረ : ያለፉት አስፈላጊ ባህል መቶ መነሳትና
ተፈጻሚነቱም : ባከበረ ባፈቀረ ሕጎች በመደገፍ መንግሥትንና
አገሪቱ : የመግለጽ ችግሮችን ተቋማት ዛሬም ዴሞክራሲያዊ
በቅርቡ : አዕምሮ አለመሆኑንም ህልውናዬ # ንድፈ
ካስተዋወቀችው : ደረጃ ይመስለኛል ይበጅ
በመቶ : የጻፋቸውና ምንም ሚና ላይ ይበጅ
የምንዛሪ : ለብሰው ቢመጥቅ ሲባል አሠራር የሚባለው
ተመን : በመዘገብና በከፍተኛ ሚዲያን መዋቅሮችን ሚዲያ
አብሮ : ለባለሀብት ማቅረብ ለማረጋገጥ ለዚህ ነፃነትና
እንኳን : ለረዥም በተስተካከለና የኅትመትና ሚና ላይ
የሚችሉትን : የሚሆን አዲስ በሆኑ ብርና የሚያስመድቡት
ያደረገ : አድርገው ተቋማት መሣሪያነታቸውም ሥልጣንን ዘመን
ነባራዊ : ጋዜጣ በጠላ በማያፈናፍን አሠራር ክፍለ
ግባ : መግዣ የማለቱን በአንፃሩ ሳንሱር ከአገዛዙ
የሚባል : የሚሆን በሆኑ ሆነ ሰፊ ንጉሣዊ
ከባንኮች : ገለልተኝነትን የሚሰብክና ሚዲያ ለመጠበቅ ግን
እያገኙ : ይዘቱና መተዋወቅ በመደገፍ የሚሰብክና በ#ኛው
እንዳልሆነ : ሮያል ትቶት በእውነት የተመልካቹ ሚልተን
ተችሏል : ያደርጉባቸዋል ይታገላል የፌደራሉም አሳድዷል የመንግሥት
ከዚህም : ለትራፊክና ቢያንስ ዜጎችን ዓ.ም. ኢትዮጵያዊያንና
ባንኮች : እንዲሰማቸው ቀጣይነት የሚጣጣሩትን * ይበጅ
ባጋጠማቸው : ሆነ አልፈው የሚሰብክና በ#ኛው ላይ
እጥረት : የእንግሊዝ የፖለቲካ በሥልጣን በእንግሊዝ እዚህ
ሳቢያ : ሲገባ በተያዘው ነው ሐሳብ ሚዲያ
አዳዲስ : እንደነበረው ልማታዊነት # እዚህ ይበጅ
ፋብሪካዎች : ተብሎ የአክሲዮን በከፍተኛ ሐሳብ እዚህ
እያቋቋሙ : እንደሚላቸው በመጠኑ አልፈው ይመስለኛል ይበጅ
ለጥሬ : ፍፁም ርዕዮተ አሠራር በ#ኛው *
ዕቃ : ውስጥ ድረስ መንገድ የሚጣጣሩትን *
መግዣ : መያዝ የሚሠራ ሁኔታ ከአገዛዙ መለኮታዊነት
የሚሆን : በሆኑ እንደተብራራው ጎልቶ ነፃነትና ሚና
ባለመቻላቸው : መርሆ እንደተጀመረ ግን ይበጅ
የፍራንኮ : ፕሮፌሰር ትችቶች በረጅም የመሰሉ በመደገፍ
ቫሉታ : ዘመን ሚዛናዊነትን እዚህ * ይመስለኛል
ተጠቅመው : መልስ በሕገ ተሳትፎ የመንግሥት የአፈና
ለማስገባት : ቅንጣቢውን ውስጥ ነው የሚጣጣሩትን ላይ
እየጠየቁ : መደበኛ ጆን ተቀባይነት አሠራር ንድፈ
መሆናቸውን : ምርምር ፕላን አካሄድ ነፃነትና ማረጋገጥ
ታውቋል : ዞሩ የለበትም ይመስለኛል ይበጅ
ፍራንኮ : ከቫይረሱ በማተሚያ አለመላቀቁ የመናገር ገለልተኝነትንና
ለመጠቀም : ባወጣው ተጸጽቶ እህል በአስተሳሰብ ኤርትራን
የሚቀርቡ : እንዳይሆን የሚናገሩባቸው የሚናገሩ ማረጋገጥ የሚጣጣሩትን
ጥያቄዎች : ከሆነ አፋኝ መገልገያ መዋቅሮችን ንጉሣዊ
እየጨመሩ : መርሆ ግን ላይ ይበጅ
መምጣታቸውን : ሐቅን ወገኖችን በኤዲተርነትና መፍረስም የፈላጭ
ያነጋገራቸው : የሙጭኝ የሚጣጣሩትን * ይመስለኛል ይበጅ
አረጋግጠዋል : ይመርጣል ይኖርባቸዋል ቀብሯል ጨፍልቋል የሙጭኝ
ስታስበው : መንግሥታት ለምን የሚሰብክና ሚዲያ ለመጠበቅ
ኢትዮጵያ : አስተሳሰባዊ ብዙ በላይ በሕገ ርዕዮተ
ተቀምጦ : የሚገቡም የተገረመው አስፈላጊ የሚጠልፈው ተቀባይነት
እኔ : ባለው ተዓማኒነት ለሚዛናዊነት አሠራር የሚባለው
የትግራይ : እኔ ለአንድ የሚያበረታታ ተዓማኒነት ሊረጋገጥ
ነኝ : እብድነቱ ይሉታል ማግኘት በ#ኛውና የሚባለው
አማራ : የራቀ ምሥራቅ ፍልስፍናው ክፍለ ይመስለኛል
አፍ : በቃላት ጊዜም በማድረግ የመንግሥት አምባገነናዊ
ሞልቶ : ጋዜጠኛ ሀሰትን ዘመን ሐሳብበዓለም ግን
መናገሩም : ለብሰው እንደፍልሰፍና የሚመሩ እንደሆነ አንድ
አለማወቅ : ምን የሚጎድላቸው ይበጅ
በሴት : ከኢንዱስትሪና የምናየው የሳንሱር መገናኛ በአፍሪካ
አያቶቻችን : አመሐ ያየ ለማቋቋም ትውልድ በገዥው
በራፍ : ከልክ ብሎ በእርሱ ነፃነት አገር
እንዳለፈ : እንደሚሞከርም አሠራር የሚባለው ገለልተኝነትንና ግን
ስንቶቻችን : የሚያደርግ የሆነ ቁጥራቸው ዴሞክራሲያዊ ነው
ነን : ሊካድ ሊኖረው ሊፈርድ ደጋፊነት ይበጅ
የምናውቀው : የሚያውቁት ገቡ ተጫውቷል አይደሉም ይህ
የእኔን : ጉድለታቸው የሞላበት ለዚህ በንጉሡ ሚዲያዎችን
ኦሮሞነት : እንዲነሳ በተያዘው መሥራት የሚጣጣሩትን ግን
እግዚአብሔርና : ሊሸፈን አሠራር የሚሰብክና አገር በ#ኛው
የሴት : ኢትዮጵያዊ የአድማጭና ለምርመራ መርሆአችን የግል
አያቶቼ : በማያፈናፍን እንደሌለው የሚሰብክና የሚጣጣሩትን *
የሚያውቁት : አስታወቀ ገልጿል ጋበዛቸው አሳድዷል አይደሉም
የሁሉንም : እንደቀረ በፕላዝማ ማካሄዳቸው እንደቆሙ የተስማሙበት
እንዲሁ : ታየ ከቀረበ የሚጎዳና አሳድዷል የውጭ
ጦር : ዓ.ም. ይህም አምባገነናዊ ሚዛናዊነትን እዚህ
ባለፈ : ማድረግና እህል ግንኙነት ብለው ያለበት
በመዋለድ : እንዲሰማቸው ንጉሣዊ ግን እዚህ *
በንግድ : በጋዜጠኛ ግን ላይ እዚህ ይበጅ
በመገናኘት : ማሪዋና የገንዘብ መሪዎችን መዋቅሮችን ነው
ተቸግሮ : አሳታሚ ከነምክንያቱ ገለልተኝነትን የግል ያለበት
ከአገር : ትቶት እንደተጀመረ የሚጣጣሩትን * ይበጅ
ወጥቶ : እንደሚላቸው ጥቅም ሌላ ይመስለኛል ይበጅ
ቦታ : ከኅትመቱም ካለፈው ዕርምጃ በአፍሪካ ዋነኛ
በመኖር : መውሰድ ሊፈርድ ይበጅ
ይቀላቀላል : ተጫውቷል ይታገላል አይደሉም የመንግሥት የሚባለው
ዕውቁ : በመንግሥቱ ከእኔ አጃንስ ትራፊክ የገቢዎችና
ገጣሚና : ሳይደረግ ባለ የሙስና ከቴክኖሎጂ ከዓለም
ጸሐፊ : የተለያዩ ማኅበረሰብ ግን እዚህ *
መምህር : ቃኝተው ካፒታሊዝም የጋዜጠኝነት ንድፈ *
ሰለሞን : መመርያዎች በድፍረት ጋዘጠኝነትን የተያያዘ በረጅም
ዴሬሳ : አሳይቷል አይጥለውም የፌደራሉም የመንግሥት አሠራር
ከሪፖርተር : ለማጥፋት የዜጎች የአመለካከት የሚንገታገቱ የውጭ
መጽሔት : እነ የሞላበት ለውጥ መስተዳድርን ዘመን
ቆይታ : ዝንባሌና በፆታ ሕዝቡን ነፃነት በመደገፍ
የኢትዮጵያውያን : ይታረም ሰባት በመካከለኛው ፍልስፍናው ብዙዎች
ኅብረ : ነዋሪ የሆነ ሁኔታ ዴሞክራሲያዊ ሚዲያ
ብሔራዊነት : ቀፍድደው የሚሰብክና የሚጣጣሩትን ለመጠበቅ ግን
የኢትዮጵያን : ንግግሩ እንደሆነ በሕገ ፍፁም ሁኔታ
ሞዛይክነት : ትዕዛዝ ያፈነገጠ ብለው ያለበት ከአገዛዙ
ያመሰጠረበት : የሚጠቅማቸውን አቋም ውግንናው ብሎ የግል
አገላለጹ : ነፃነትን እንዳልዘነጋሁ * ይበጅ
በሥነ : የራሳቸው የፈላጭ እዚህ ይበጅ
ጽሑፍና : እኔና የሚጠየፍና ሚዲያው በማድረግ የውጭ
ግጥም : በነበረው አሜሪካ ሙያዊ በማድረግ አሜሪካና
ጥበብና : እንደሚሞከርም ሆኖ አሠራር የሚባለው የሚጣጣሩትን
ቴክኖሎጂ : የሚወስኑ ጊዜም ቢረጋገጥም ፍልስፍናው ገለልተኝነትንና
ክህነቱ : ለምርመራ በእስያም በመደገፍ ለመጠበቅ ይበጅ
ተጠባቢነቱ : የሆኑት ልቦናና መቶ የአመለካከት ጊዜ
ሥፍራ : ልጅ የሚያብጠለጥሉ ደጋፊነት የሚገባው እንደተጫናቸው
ነበረው : ዘግቧል ይቀናቸዋል አይገባም ወደነበሩበት የቅድመ
ሰሎሞን : ሽብር ጎን ማጋነን ሊፈርድ ላይ
ደሬሳ : ይይዛል ይለቃሉ ይታገላል ጽፈዋል ይመስለኛል
ለአምስት : ለምሳሌ ዜጎችን መገናኛ በአፍሪካ አምባገነናዊ
አሠርታት : ድሃ በጠላ መደበኛ በፊት የሙያው
ጥበባዊ : ከማል እብድነቱ ልቦናና ጀፈርሰን የዩናይትድ
ጽሑፋዊና : ሕጋዊ የፌደራሉም ጋዜጠኝነት የሚባለው *
ጋዜጣዊ : የሚመሩ ይኼ አሠራር የሚባለው አምባገነናዊ
አበርክቶው : ገለልተኝነት አንስተን ወጥቶና ብቃት ዋና
ትይዩ : መገለልና በፊት ሚዛናዊ አሠራር የአፈና
በተካነበት : ተቀጥረው ጉዳይን የሕዝብ የጋዜጣ ሚና
የምሥራቅ : የሆኑት ኪራይ አሜሪካ ሆኑ መቶ
ኦሬንታል : የሰው የጎላ የያዘበት በኤዲተርነትና የተሟላ
በጠሊቅ : ጋና ባለው በዛሬው ገድሏል ምሥራቅ
ንባብ : ሥራን የሚጠልፈው የኢትዮጵያ የርዕዮተ ነው
ከቀሰመው : ኢንዱስትሪውን ደርግ ያለበት ከአገዛዙ ክፍለ
የምዕራባውያን : ሥልጣኔ ሆኑ የአመለካከት ጊዜ የሚንገታገቱ
አስተሳስሮ : አገዛዝ ንጉሣዊ የሚጣጣሩትን ገለልተኝነትንና ላይ
ሚኔሶታ : ትገዛ ሳይታለም ያለውን በ#ኛው ለመጠበቅ
በአይሁድ : ኮሌጅ መሣሪያነታቸውም በፖለቲካ ሥርዓት ሕዝቦች
በክርስትና : አንባቢው እንዲሁም ቁጥራቸው ፍልስፍናው ሥልጣንን
በእስልምና : እንዲናወጥ ሊሸጥ ባከበረ ለረዥም በመደገፍ
በቡድሂዝምና : እብድ ፕሬዚዳንት ወዘተ አገራዊ ሚዲያዎች
በሌሎች : ሰዎች የአመለካከት የሚንገታገቱ ከአገዛዙ በ#ኛውና
ሃይማኖቶች : ከተዘረዘሩት ሜዳ መንገድ በሥልጣን የሚሰብክና
የሃይማኖት : ገዥው መርሆዎች የአመለካከት የፈላጭ ሚና
ንፅፅር : እንዲኖርም ልማታዊነት ዓለም ፈቅደው ብዙዎች
ኮምፓራቲቭ : ለሊብራል ሙያና ሐሳብበዓለም ገለልተኝነትንና ግን
ሪሊጂን : ለአጃንስ ገዥው መነሳትና ባህሪ የአምባገነን
ፕሮፌሰር : የሚሰጥ የተባለውን አገራዊ ከድህነትና ይመስለኛል
ሲሠራ : ፈቃድ በቅድሚያ የአፈና ገለልተኝነትንና ግን
ቆይቷል : ይገልጸዋል አሳድዷል የመንግሥት በሥልጣን አምባገነናዊ
ተማሪ : ሚልተን ወርዶ ሰብሳቢዎችና ሌላ የሚወሰድ
ሳለ : ይጫወት አትምጡብኝ ከዴሞክራሲ ገድሏል አሠራር
ደሳለኝ : ኒዮሊብራሊዝም ለምርመራ መድረሻ መሣሪያነታቸውም በእስያም
በጠበቃው : እየተስፋፋ ሌላ ሚዲያዎች የሙያው ጭቁን
በአቶ : ተገቢ የኢትዮጵያ አገራዊ አገዛዝ ንድፈ
አምሐ : የድጋፍ በአስተሳሰብ የሚጣጣሩትን ሚዛናዊነትን *
መኮንን : ቅሬታ በሕገ ከአገዛዙ በ#ኛውና ሚዲያ
አማካይነት : ባነሰ ሰላም ተመልካች በ#ኛው ይህ
በፌዴራል : ሥልጣኔ የአመለካከት ብዙኃን ያለበት እዚህ
ጠቅላይ : ከፍተኛ ለሊብራል በጥናት ሐሳብበዓለም ሚና
ፍርድ : ህንድ ዕርምጃ አምባገነናዊ የሚጣጣሩትን *
ባቀረበው : መርጠው አንድ ያለውን አሠራር ለመጠበቅ
ይግባኝ : ከተዘረዘሩት ነፃነት በ#ኛው ይመስለኛል ይበጅ
ክርክሩን : ወዲያውኑም አድልኦ መገናኛ የሐሳብ ቀዳሚው
አደረገ : ይይዛል ዞሩ ይታገላል ይታወቃል ጽፈዋል
የተከታተለው : ትገዛ እንደፍልሰፍና ሽብርተኝነትና ሊሸፈን በፊት
የተወሰነበትን : የሦስት ሊሸፈን የፖለቲካ ነው ከአገዛዙ
የሦስት : የተወሰነበትን የፖለቲካ ቁጥራቸው ነው ንድፈ
የእስራት : በሌሎችም በሕገ የውጭ መሪዎችን የፈላጭ
ቅጣት : ጠቃሚ ጨምሮ አንድ ለዚህ ጭቁን
እየፈጸመ : ለንግድ በማየት ለገበያና የዲሞክራሲ ማንም
ባለበት : ጉብኝት በባዶ መመራታቸውና ዘመን ሐሳብበዓለም
ማረሚያ : ሒሶች ጋዜጠኝነት ዴሞክራሲያዊ * ይበጅ
ዝዋይ : ላይሰጥ እብድ ፕሬዚዳንት አገራዊ አውሮፓዊያኑ
እስር : መፀዳጃ አማራጭ ሌላ የዚህ ሥልጣንን
በፕላዝማ : እንደቀረ የሚገባው የተስማሙበት የሚወሰድ አሠራር
ጋዜጠኛ : ሞልቶ የሚጋርጥ መሣሪያዎቹ ዘመን ይህ
ተመስገን : ሳይንቲስትም በነፃነትና አለመላቀቁ ሥልጣንን ንድፈ
በከሳሽ : ክስ ሰው የሚቆጠሩ ርዕዮተ አሠራር
ዓቃቤ : ውዝግብ ደግሞ መዋቅሮችን አስፈጻሚ እዚህ
ቀርቦበት : የወጣና የሚመስላቸው መሣሪያነታቸውም በአንፃሩ ነው
ክስ : ትርጉም በከሳሽ ከርዕዮተ ሰው ሙስናን
እሱ : መግዣ የአገራችን ካልሆነ የሚቆጠሩ ከአገዛዙ
የፍትሕ : ከተሰኘው አሜሪካዊ ደግ ምርመራ በሥልጣን
አዘጋጅ : ሊያስደስት ቆራጭ ሐሳብበዓለም ሚና ላይ
በጋዜጣው : ከመጣው በኢሜል ሲታይ በላቲን ያለበት
በቅጽ : ሞተዋል መብቱ አለበት ክፍለ ይመስለኛል
ቅጽ : ታየ ከሕዝብ ኢሕአዴግ ዓ.ም. ዋናው
ዕትም : አባቱ ባለፉት በግብርና ከሕዝብ በዚህ
በራሱና : በሕግ ጥሩ ጋዜጣ ተፈጥሯዊ ፍልስፍናዬ
አመንጭነት : በሥር የፍራንኮ ለውጥ በሙሉ ሚዲያዎችን
የተጻፉ : አምስት ታሪካዊ የሚስተዋሉ ሁለት የያዘበት
ጽሑፎችን : የሙያው በመካከለኛው ሕዝቦች ጭቁን ይመስለኛል
አትሞ : ድጋፍ ሊገቡ ከመሆን እንዳይኖር እንደተጀመረ
አውጥቷል : ይይዛል አጠያየቁ ይታገላል ይመስለኛል ይበጅ
በመሆኑም : በእርግጥ ደግሞ ኢትዮጵያዊያንና የሐሳብ ዋናው
በመንግሥትና : ከሆነ በመሆኑ መገልገያ መዋቅሮችን እዚህ
መንግሥታዊ : ሐቅን የሕግ እንዲሰማቸው በአስተሳሰብ በሚታትር
እንዲያምፅ : በማተሚያ ሰዓታት ኢሕአዴግ በመካከለኛው የዚህ
ቀስቅሷል : የሚታፈኑ የአንዳንድ መንግሥትንና ሚና ላይ
በሐሰት : የሚያዳክም ቢሆን ነው ንጉሣዊ የሚጣጣሩትን
ወንጅሏል : በቃላት ጉዳታቸውና አሜሪካና የመንግሥት በ#ኛውና
ስሙንም : በይቅርታ በኤዲተርነትና ልማታዊነት እዚህ *
አጥፍቷል : ተቀባይነትና አቀራረብ ጎራ ሊሸፈን ያለውን
የሐሰት : ሥርዓት ነው ንድፈ ገለልተኝነትንና *
ወሬዎችን : እርሱን አፋኝ ብዙዎች አስፈጻሚ የሚጣጣሩትን
በመዘገብና : እንደሆነ እየተከተሉ የውጭ የአፈና ክፍለ
ለሕዝቡ : ብርቱ እዚህ * ይበጅ
በማሰራጨት : ለሚነገር ላይ ይመስለኛል ይበጅ
እንዲናወጥ : የሚሰጥ በረጅም የኅትመትና በመደገፍ ላይ
በቀረቡበት : ወዘተ አቀባይ ዕርምጃ የመንግሥት አምባገነናዊ
ሦስት : ሊብራል የላይኛው መሠረታዊ መሣሪያነታቸውም ሥርዓት
ክሶች : እንደሚሞከርም በፊት አንድ ገድሏል በመደገፍ
ከአሳታሚው : ይጫወት አሜሪካ ያለመዘጋጀት በፊት የመንግሥት
ማስተዋል : የተከታተለው በፊት ምሥራቅ አሠራር ክፍለ
ማስታወቂያ : የነበሩት ለዴሞክራሲ ተቀላቅለዋል አልነበረም መንግሥታትም
ድርጅት : እንዲሰጥባቸው ተስፋ በአንድ የኅትመት ደግሞ
ጥፋተኛ : ወዲያውኑም ከእኔ አድልኦ በአንዳንድ ኢትዮጵያዊያንና
ተብለው : በክሶቹ ለመጠበቅ ላይ እዚህ ይበጅ
ተወስኖባቸዋል : ሰጥቷል የሚጎዳና አይመስለኝም ልበ አልነበረም
እስራትና : አምርሮ ሊፈርድ ይበጅ
ድርጅቱ : እንዲፈታና አስፈጻሚ የሚሰብክና የሚጣጣሩትን *
ተቀጥተዋል : ሸሽቶት አሳድዷል አይደሉም የመንግሥት *
የሥር : ለጠቅላይ ቀስቅሷል ቃል የጋዜጣ ፍልስፍናን
የወሰነባቸው : በመሆኑ ሙያዊ በሕገ አሜሪካና መሪዎችን
አግባብ : የተገመቱት የሚደፈቅበት የሚመልስ ሲያበቃ በመደገፍ
አለመሆኑና : ለፍርድ ጦርነት ተቀባይነት ንድፈ ገለልተኝነትንና
እንዳሳደረባቸው : ከተመረቀ ብዙ ፔንሲልቫኒያ እንደመርግ ያለውን
ፍርደኞቹ : ባለፈውና ባህልን በከፍተኛ ዓላማም እዚህ
ለጠቅላይ : የሥር ከፍተኛ የተመልካቹ መፈራረስና ቃል
ባቀረቡት : የሚቃወም ለሚነገር ደረጃ ቢነሳም ያለውን
የይግባኝ : በፊት በተስተካከለና ጭቁን ብዙዎች አገር
አቤቱታ : ተመሳሳይ ብዙዎች ንድፈ እዚህ ይመስለኛል
የቅሬታ : ብዙ አተገባበር መድረሻ መልስ የመሰሉ
ነጥቦቻቸውን : መሻሻልን ሥራዎች አኳኋን እንዳልዘነጋሁ ይበጅ
አስረድተዋል : ጽፈዋል ይመስለኛል ይበጅ
ቀጥተኛ : የሚናገሩ ሥርዓት ንድፈ የሚጣጣሩትን *
ምስክርና : ያለፈ የማያይ መልካም ተቀባይነት እንዳይሆን
በሰነድ : ወዳጆች ብቻ በመደገፍ የሚሰብክና ለመጠበቅ
የተጠናከረ : መስኩ የኅትመትና መገለጫ ላይ እዚህ
ማስረጃ : የሥርዓቱ ትንሽ መዋቅሮችን ዘመን ሚዛናዊነትን
ለሥር : ከፍተኛ በጥናት ምዕራፍ ሚዲያዎችን ሚና
ያቀረበ : ማለትስ ይጫወት እንደሆነ ሚዛናዊ አሠራር
ወንጀል : ቃል ላይ ይበጅ
ተፈጽሞባቸዋል : ያስረዳል እንለወጥ መልካም የመሰላቸውን ለዴሞክራሲ
ያቀረባቸውን : የመሆን ዓመታት ደግሞ መንገድ የሚሰብክና
የተጠቀሱትን : ሌሎችንም የተባለውን ከድህነትና ሚና ላይ
ዕትሞች : ንድፈ ሚዛናዊነትን * ይመስለኛል ይበጅ
እንደወሰንበት : አለመሆኑንም ሊወጣ የሚጎድላቸው እንዳልዘነጋሁ ይበጅ
አስረድቷል : ይሄዳል ይታወቅልኝ ይመስለኛል ይበጅ
አንባቢው : በክርስትና ወር ተፈጥሯዊ አቅጣጫ ስቶ
ዝንባሌና : ሊሸጥ ዩኒቨርሲቲ በግል በፆታ ለምርመራ
አረዳድ : መንስዔ ሚዛናዊ ገድሏል ቁጥራቸው ፍልስፍናው
አቅም : ስሜት አልያም ባህልን እዚህ *
ሊያሳጣ : ሎጎው ሊረጋገጥ ብቻ የአፈና ይህ
ሊያስደስት : ቃል ላይ እዚህ ይመስለኛል ይበጅ
የተለየ : ቲሸርት ስለነበረም እንዳሉ ጋዜጠኝነትን በአንፃሩ
ስሜት : አቅም እንዲገነዘብ የጋዜጣ ላይ እዚህ
ላይሰጥ : ኃላፊነትን ዝዋይ ብርሃኑ እንደሚሞከርም የተለመደ
ከሚችል : አካሄድ መብት ዴሞክራሲያዊ የሕዝብን ንድፈ
በስተቀር : በሥር ሊብራሊዝምን ወጥቶና በመደገፍ ላይ
የታወቀ : የፖለቲካ የብሮድካስት ይህ ሚዲያ ሐሳብበዓለም
መለኪያ : ግንኙነት የውጭ ሚዲያ ገለልተኝነትንና ግን
ሳይኖርና : እዚህ * ይበጅ
እንዲውል : ባለፈውና ባህልን የሥርዓቱ ትንሽ በሙያተኛው
ሳይደረግ : የከፋው ከቴክኖሎጂ ቤቶች አበባ እንደነበረው
የጽሑፍ : ውሳኔ የሚመልስ የሚሰብክና በ#ኛው የሚጣጣሩትን
አሳታሚ : ያለበት ለመጠበቅ ሚዛናዊነትን እዚህ ይበጅ
በሥር : በስተቀር ለውጥ በረጅም ደረጃ የመሰሉ
የተገመቱት : ይዘቱና የሚደፈቅበት አንድ አፋኝ የሚሰብክና
ወንጀሎች : ሳያወጧቸው ኒዮሊብራሊዝም ፍልስፍናን ይበጅ
የመሥራትን : ተፈጽሟል ድምፅና የመስኩ ገድሏል ሙሉ
ከጽሑፎቹ : ለምሳሌ ዜጎችን መገናኛ አምባገነናዊ ይመስለኛል
ባሻገር : አስከባሪዎች አስተሳሰባቸው ሙሉ የሙጭኝ በላቲን
ደጋፊ : ማለትስ እንደሆነ ነበር ዓ.ም. በማድረግ
ሳይረጋገጥ : የአሁኑን በእንግሊዝ የሚጣጣሩትን እዚህ *
እንደማይቻል : እንዳልዘነጋሁ * ይበጅ
በመነሳት : ተግባር ቅሬታ መቶ የሐሳብና ሁኔታ
ተፈጽሟል : ፈጽሟል የመሥራትን ሳንቲም ድምፅና ናቸው
በፍርድ : ማለትስ ዕርምጃ የመንግሥት አሠራር አምባገነናዊ
ቤቱ : ጅምሮችና መሣሪያነታቸውም ነፃነትና ላይ ይበጅ
የተሰየሙት : ሁኔታ ያለበት የሚሰብክና ሐሳብ የሚባለው
ዳኛ : ከዚያ የጋዜጣ አፋኝ ሐሳብ ሚዲያ
ግላዊ : ለአንድ ተጉዘው አዘጋጅም ሥልጣንን ክፍለ
ውሳኔ : የማያሞግስና አስፈጻሚ የሚሰብክና የሚጣጣሩትን እዚህ
ከሚሆን : ማግኘት የዩናይትድ ለመገንባት ገድሏል አሜሪካና
ከፍርድ : መንገድም በማድረግ የመንግሥት አሠራር የሚባለው
ቤቶቹ : ያልፈተሹትን ተደርጎ ዘመን ታሪክ ሐሳብበዓለም
የሚጠበቀውን : ሊገደብ ሁኔታ ያለበት አሠራር ክፍለ
የውሳኔዎች : እየጨመሩ የአመለካከት መርሆ እንዳልዘነጋሁ ግን
ተጨባጭነት : ጫፍና በአገራዊ ሙስናን መዋቅሮችን እዚህ
ሊያረጋግጥ : አለመመራትና ቢመዘን ጀርባ ቤት የሙጭኝ
የጋዜጠኛ : ዓ.ም. ኢትዮጵያዊያንና የሚንገታገቱ በማድረግ ይህም
ጠበቃ : ከሚያዘጋጀው ያልተለመደም አገራዊ ለምክር ሌላ
ለፍርድ : አለመሆኑና የተገረመው ከሦስት የመንግሥት ንድፈ
የተገለጸን : እንደ ችግሮችን በሆነ የቅድመ አምባገነናዊ
በማየት : ወንጅሏል በቃላት በማድረግ በ#ኛውና *
ፈጽሟል : ተፈጽሟል ናቸው አለመላቀቁ የውጭ ንድፈ
የሚወስኑ : ቴክኖሎጂ የዲሞክራሲ ቢረጋገጥም ፍልስፍናው ገለልተኝነትንና
መንግሥቱ : አስሯል እንደቆሙ እንደተጀመረ እንዳልዘነጋሁ የሚጣጣሩትን
አንቀጽ : በኋላ የሚወሰድ ይነገራል * ይመስለኛል
የተረጋገጠውንና : ጉዳዩን ህንድ አምባገነናዊ ገለልተኝነትንና ግን
ሐሳብን : ብዙኃን መሆኑ መዋቅሮችን እዚህ *
የመግለጽ : አገሪቱ ተቋማት ወደነበሩበት ሌላ መሣሪያነታቸውም
አጣብቂኝ : በሚታትር ውስጥ የሚጣጣሩትን እዚህ *
የሚከት : ባልታየ ወስደው የሊብራል ጎተራ ተቀባይነት
የጋዜጠኛው : መስተዳድርን የመሰሉ እዚህ ይመስለኛል ይበጅ
ዜጎች : ልማትን አንደኛው ከልማታዊ ሚና ላይ
የሚገልጹት : ከተላቀቀች ሌላ በመካከለኛው ንድፈ ላይ
መቼ : በተዘዋዋሪ ሳይኖርና ሕግ ሙስናን ሚዲያን
ሊያስቀጣቸው : ባከበረ ለሚነገር ማጋነን ሲያበቃ በመደገፍ
እንደሚችልና : ሙስናን ሚዲያን ብዙዎች * ይበጅ
ጥበቃ : ደብዳቤ አሁን በህንድ ማረጋገጥ መንግሥትንና
እንደሚደረግላቸው : ለገበያና ሚዲያው የዲሞክራሲ እንደሆነ አስተሳሰባቸው
ባለማወቅና : ኤምባሲዎች ከሆነ መንግሥታትም እዚህ ይመስለኛል
ግራ : በመደገፍ መንግሥትንና ነው የፈላጭ የሚጣጣሩትን
በመጋባት : በተያያዘም የማያይ ተደምሮ በህንድ ተቀባይነት
በመብታቸው : ለማስገባት ውስጥ የሚጣጣሩትን ግን *
እንዳይጠቀሙ : እንደሆነ የሚቆጠሩ ሚዛናዊ አሠራር የሚሰብክና
በተዘዋዋሪ : መቼ ሕግ እዚህ ይበጅ
ገደብ : ማስተካከያ የጻፋቸውና ነገሮች ለማረጋገጥ መንግሥት
የሚጥል : ባልታየ ሥራን የሚጠልፈው መልካም በብዙዎቹ
እንደማይቀርም : ዓመታትን እንዲቆዩ ማጋነን የሚንገታገቱ እንደመርግ
አስገንዝበዋል : ተደንግጓል ጠየቀ እንዴ ተጭኗቸው ይታወቅልኝ
ንዑስ : እና የሚንገታገቱ እንደተጀመረ ሚና እንዳልዘነጋሁ
ሊገደብ : የሚጠበቀውን የሚዘርፉ እንደሆነ የሚቆጠሩ አንድ
በሕግ : የፍልስፍናው ጎተራ ፍልስፍናዬ ብዙዎች አሠራር
የሚገልጸውን : ትዕዛዝ ካለው እየተከተሉ ብለው ያለበት
ድንጋጌ : የገንዘብ አካላት የአሁኑን በኤዲተርነትና መዋቅሮችን
እንደሚቃረን : ተርጓሚ የሚናገሩ ሥርዓት ነው ዘመን
ጠበቃው : ነን ማድረጉ አኳኋን ሥራ እንደተጀመረ
ክሱ : አምባገነናዊ * ይመስለኛል ይበጅ
ሲቀርብ : ንግግሩ የሚዛናዊነትና እሳቤዎችን ገጽታዎች የፖለቲካ
በእያንዳንዱ : ያጋለጠውን ዝግጁ ተግባር መምጣት የአንድ
የወንጀል : ቦታቸው መዋቅሮችን በእንግሊዝ ይታወቅልኝ እዚህ
ሥር : ዕቃ የሚናገሩ የኅትመት * ይመስለኛል
የተገለጸውን : ያለው ነበር የሐሳብ አስፈጻሚ የሚሰብክና
ያስረዳል : ተፈጽሞባቸዋል መልካም ለዴሞክራሲ ተቀላቅለዋል ከመጣ
የቀረቡት : ለእውነትና በተሳሳተ እንደሌለው ያለውን አሠራር
ማስረጃዎችና : ብዙዎች አሠራር አገር ንድፈ የሚጣጣሩትን
ለክሱ : ጨምሮ በመደገፍ ነው አሠራር ሚና
የሆኑት : ልቦናና መቶ ገድሏል አሜሪካና በ#ኛውና
አምስት : ባደረጓቸው የተጻፉ በልቅነትና የሚስተዋሉ ይልቅ
ጽሑፎች : አትምጡብኝ በጠላ አገራዊ የመንግሥት የሚባለው
አስረድተው : መምጣት በመሆኑ በሕገ የውጭ አስፈጻሚ
በጋዜጠኛ : ቅንጣቢውን ሕጎች ቃል ዴሞክራሲ በመደገፍ
ተመስገንና : አለመላቀቁ ህልውናዬ ንድፈ አምባገነናዊ ገለልተኝነትንና
የተጻፉትና : ከመዳፋቸው እርጋታ አቋም መስፋፋት ውስጥ
የታተሙት : የተዛባ የሚወርደውን ሚና እዚህ ይበጅ
መመልከት : የሐሰት አስተሳሰቦችና የዲሞክራሲ የመጻፍ የሙጭኝ
ቢቻል : በመሆኑ በሕገ አስፈጻሚ ሚዛናዊነትን ይመስለኛል
ያለማንም : ባለማወቅና ከሆነ እዚህ ይመስለኛል ይበጅ
የመሰለውን : የሚጠልፈው ከተፎካካሪዎች የሚለውን የርዕዮተ ነው
አመለካከት : ጉዳይ በቋንቋ ሽብርተኝነትና አፋኝ ሚዲያ
የመያዝና : ሰው የሚቆጠሩ የኅትመትና ብቻ ያለበት
እንዳለው : በአስተሳሰባዊ መርጠው በመደገፍ ያለውን የሚሰብክና
የተደነገገውን : ሮያል አሰፋ ለምርመራ ጨምሮ መሣሪያነታቸውም
የሚቃረኑ : ጽሑፍና አፋቸው አንፃር ይባልና ሚዲያው
በአንደኛው : የአወሮፓውያኑ ብርሃኑ በምሁራኑ በቋንቋ ከማጋለጥ
ያቀረባቸው : በእያንዳንዱ ሊገደብ እንደሚደረግላቸው አገሮች ያሉ
ድንጋጌዎች : እንዲሰጥባቸው በመሆኑም የሚሆን አብሮ ከሕዝብ
ከሕገ : ፈጥኖ ሥነ ጣልቃ በሕገ ዕገዳና
የሚጋጩና : ለንግድ በተያያዘም ሥራን ምሳሌ ጊዜም
በአስተሳሰባዊ : እንዳለው አጥፍቷል ሊሸፈን አንድ ሁኔታ
ይዘቱና : ተቀባይነትና በፊት አንድ በመደገፍ አሠራር
ሊያስከትል : ይታረም ድህነት ሚዲያዎች በመካከለኛው ንድፈ
በሚችለው : ለመገንባት የፖለቲካ ከአገዛዙ ንድፈ የሚጣጣሩትን
አስተሳሰባዊ : ብዙ እንደሆነ ሊሸፈን ሚዛናዊ በሕገ
ውጤቱ : የተገመቱት ሊያነጋግረን መልስ አስፈጻሚ የሚሰብክና
ሊገድብ : ትቶት ማንሰምቶት ተቀሰቀሰ ቃል ብሎ
ከተዘረዘሩት : ሃይማኖቶች መንገድ ነፃነት የመንግሥት በሥልጣን
ልዩ : መያዝ ጋዜጠኝነት አሠራር ከአገዛዙ ክፍለ
ሁኔታዎች : ምንዛሪውን ወጥቶና ሚና ላይ ይመስለኛል
በመብቱ : በኢኮኖሚው በልማቱ ዓመታት ድረስ የሥርዓቱ
ጠቁመዋል : አውጥቷል እንደሚላቸው ይመስለኛል ይበጅ
የሕገ : በመገናኘት መሪዎችን መርሆ ግን እዚህ
ትርጉም : ሰው መገለልና እንደሆነ ሚዛናዊ ክፍለ
እንዲሰጥባቸው : ድንጋጌዎች ድርጅት ተርጓሚ ይኼን ከሆነ
ለሕገ : መሪዎችን የፈላጭ ለመጠበቅ ሚዛናዊነትን እዚህ
ጉዳዮች : አጣብቂኝ በሚታትር እንዳይሆን ውስጥ ሚዛናዊነትን
አጣሪ : ማመልከቻቸውን ኤመርሰን የሚጠቅማቸውን መፈናቀል ጎልቶ
ጉባዔ : በብዙዎቹ አለመላቀቁ የውጭ ሥልጣንን ገለልተኝነትንና
መላክ : ቁልፍ በሥራ እንዳሉ በከፍተኛ #
ሲገባው : ያለ ቢሆንም ብቻ ማብቂያ ክፍለ
በማለፍ : ያለውን ሚና ለመጠበቅ ይበጅ
የጥፋተኝነት : ያኔ ወደነበሩበት ዛሬም የአምባገነን ዋናው
መስጠቱ : ሐሜትን የሞላበት ትችቶች ብሎ በእስያም
አለመሆኑንም : ሊወጣ አኳኋን እንዳልዘነጋሁ ይበጅ
አብራርተዋል : አይደሉም የሚዲያ በሥልጣን ይነገራል የሚባለው
አቶ : እየፈጸመ የሆነውን መቶ ገድሏል አገዛዝ
አመሐ : የጋዜጠኞች መመለስና እንደመርግ በ#ኛው የሚባለው
ሰፊና : ከተማውን ፔንሲልቫኒያ አንድ ብቻ ነበር
ዘርዘር : ባወጣው አለባቸው ኤርትራን ቢሆን *
ቤትን : ቤት ብዙዎች ማረጋገጥ ነው ሥልጣንን
የሚቃወም : በማሰራጨት እንደሚያደርስ ለምርመራ ለሚነገር በረጅም
ማመልከቻቸውን : ጥሩውን ተቀባይነት ዓለማዊ ሥልጣንን ንድፈ
በክርክር : እንዲናወጥ ግዛት የሚሰጥ ጋዘጠኝነትን አገራዊ
ካሰሙ : በዛሬው መመለስና የመንግሥት የሚባለው ይመስለኛል
ደንበኛቸው : እንደሚሞከርም አኳያም የምናየው ወደነበሩበት በፊት
በማተሙ : ጋዜጠኛና የአገርን ሙያና ባህሪ ቆራጭ
መባሉ : ዓላማ ዘመን ሚዛናዊነትን እዚህ *
እንዲባልላቸው : ኃላፊነት # ሥልጣንን ሐሳብ ሚዲያ
ዳኝነት : መሠረት የሚጠቅማቸውን ሸቀጥ ወጥቶና ጎልቶ
ጠይቀዋል : ይሄዳል ምንድነው አለበት አይደሉም ይታወቅልኝ
የተባሉት : ግን እዚህ ይበጅ
በጋዜጣ : በሙያተኛው ሚዲያ ይታወቅልኝ እዚህ *
በጻፏቸውና : መመርያ የኤሌክትሮኒክና ይታይ ልማታዊ ፍልስፍናው
እንዲታተሙ : በኤዲቶሪያል ርዕዮተ አገሮች ባህሪ ያለበት
ባደረጓቸው : አምስት የሥር ፖሊሲው የተሟላ የተሻለ
የተፈቀደ : ቴክኖሎጂ የሚጠልፈው ምሳሌ የዲሞክራሲ ሥርዓቱ
ከመሆኑ : እንዳይሰማ ዓለም መዋቅሮችን የሚጣጣሩትን *
ከእስር : በፌዴራል የሚጣጣሩትን ግን እዚህ *
እንዲፈታና : ድርጅቱ ብቻ ዓላማም አስፈጻሚ የአፈና
በድርጅቱ : የመንግሥትና መስፋፋት ተጭኗቸው ምርመራ እዚህ
የተጣለው : መተላለፍ ተመሥርቶ ተመሥርተው የሚያስመድቡት እየተከተሉ
መቀጮ : ለጉባዔው የከሸፈ ነው ሥልጣንን የሚጣጣሩትን
እንዲነሳ : ኦሮሞነት ነው የሚጣጣሩትን ግን *
እንዲታዘዝላቸው : ፖለቲካ የሚጠቅማቸውን ለምርመራ አፋኝ መንግሥትንና
በክሶቹ : ተብለው ለመጠበቅ እዚህ ይበጅ
የተጠቀሱት : ያጋለጠውን ከተመረቀ ዝግጁ ተግባር መምጣት
ን : ቢልዮን አድልኦ መነሻው ለዚህ ዋናው
በመሆናቸው : ከሆነ በእንግሊዝ እዚህ ይመስለኛል ይበጅ
ሕገ : ሳያወጧቸው አካላት የሌለበት ሥርዓት ብለው
እንዲሰጥባቸውና : ቢሆንም የሚናገሩባቸው * ይበጅ
ታግዶ : ተብለው ሽብርተኝነትና ጋር ሊሸፈን ለመጠበቅ
ጥያቄያቸው : ቢከብድ መቀባት ያዘነበለ የሚናገሩ እንደነበረው
ለጉባዔው : መታየት መዝዞ ሽብርተኝነትና አፋኝ ማረጋገጥ
እንዲላክላቸው : ከ# ፍልስፍናው ያለበት ፍልስፍና ነው
በመጠየቅ : ባለው ስቶ በፖለቲካ ምሥራቅ አሠራር
አቤቱታቸውን : እንዳልዘነጋሁ ይበጅ
አብቅተዋል : ለእናቱ አይታበልም አለበት ቢሆንም አይደሉም
የቀረበውን : ዓይነት ፕሬዚዳንት የሚሰጥ እንደተጫናቸው ሕዝቦች
ያስቀርባል : በማረም የሚደፈቅበት ያለው መንገድ የመንግሥት
አያስቀርብም : የተፈጠሩ መርሆዎችና የመጻፍ የውጭ የአምባገነን
ለጥር : አትምጡብኝ ይመስለኛል ይበጅ
ቀን : ቁጥር በዚህ በመንግሥት ዕርምጃ አምባገነናዊ
ቀጠሮ : እንዳይለውጥህ የሚንገታገቱ ላይ ይበጅ
ሰጥቷል : ተወስኖባቸዋል አይገባም አይመስለኝም ልበ ከመጣ
በመንግሥቱ : ዕውቁ ጳጳሱ ትራፊክ እና ከኢንዱስትሪና
መስፍንበዚህ : የሚመስል የ ዓለም በ#ኛው ሚዛናዊነትን
ከሚለው : ባለቤት መርሆዎችና ባህልን ይችላል መፍረስም
እያቀያየርን : መላክ እንዳሉ ነበር ዘመን የሚጣጣሩትን
ብንጠቀምም : ሚዲያ ላይ እዚህ * ይበጅ
የሬዲዮ : የሚንቀሳቀሱ መያዝ አቀንቃኞች ሐሳቦችን መሀል
የቴሌቪዥንና : የሚችሉትን እንደማይችል የሚያስመድቡት ሙያተኛ ዓመታት
የተመለከተ : የተስማሙበት የሚወሰድ ይበጅ
በመሠረቱ : በነገራችን በዚህ በደርግ የግልና የሐሳብ
የሚለው : ስለነበረም ባይመስለው አማራጭ የዚህ ንድፈ
ከሚል : ለግል ጋዘጠኝነትን ጠቃሚ ማጋነን የኅትመትና
የላቲን : የጠነከረ በነበረው የፌስ የመንግሥት በሥልጣን
የተገኘ : እየሠራ በማየት ለኦሬንጅ ጀፈርሰን ሚዲያው
ለጽሑፌ : አጥፍቷል ለሚነገር በረጅም ሊሸፈን በፊት
ዓላማ : ነው የሚጣጣሩትን ገለልተኝነትንና ላይ *
እርሱን : ወሬዎችን አርዓያ ተመሳሳይ ባህልን ብዙዎች
መውሰድ : ሊፈርድ ይበጅ
ይሻላል : አልቻለም አለበት አሉ ይታወቅልኝ ይመስለኛል
ቴክኒካዊ : ናይጄሪያና ባነበበው ካለህ መሃላቸው በተሳሳተ
ከማንም : ማስፈን የኅትመት እዚህ * ይመስለኛል
ያልወገነና : ስነጋገር የሚመስላቸው ነው ንጉሣዊ የሚጣጣሩትን
አንድን : ፍራንክሊን ክልሎች ጨምሮ በተስተካከለና አፋኝ
ከላኪ : ከተገመተው አልፈው የሚሰብክና በ#ኛው ሐሳብ
ተቀባይ : የተፈጠሩ አለመላቀቁ ሥልጣንን ንድፈ አምባገነናዊ
በብቃት : የእንግሊዝ አፋኝ በእንግሊዝ እዚህ *
ለማድረስ : ኃላፊዎችና ሊሸፈን አሜሪካና ከአገዛዙ የሚባለው
የሚችል : ስለኤሌክትሪክ የሌለበት የአንድ ብዙዎች እዚህ
አገናኝ : ከልክ ምንም ምክንያቱ ኮሙዩኒኬሽን ላይ
ዘውግ : የሚችሉትን የሚያስመድቡት ጎልቶ ሚና ላይ
ኅትመት : ገለልተኝነት ለማረጋገጥ ብቃት በአንፃሩ ሥልጣን
ከ#ኛው : በ#ኛው እዚህ ይመስለኛል ይበጅ
አጋማ : ለሚዛናዊነት አሠራር የሚባለው ሚዲያ ይበጅ
#ኛው : ከ#ኛው በ#ኛው ይመስለኛል ይበጅ
አጋማሽ : መግዣ መያዝ የሚቆጠሩ ሚዲያን ከአገዛዙ
የዘለቀውን : አስፈላጊውን ማበብ ውስጥ ድረስ መሀል
ጅማሬ : የበላይነት በአንፃሩ ሥልጣንን ንድፈ *
ይይዛል : ይታገላል ይመስለኛል ይበጅ
በእኛም : በየትኛውም መነሻው ኢትዮጵያዊያንና አምባገነናዊ የሚጣጣሩትን
አዕምሮ : በቅርቡ ህልውናዬ # እስከ *
ከተሰኘው : የፍትሕ ጎልቶ በእርሱ ምርመራ በሥልጣን
አንስተን : የጻፋቸውና እንዳጫወተኝ ነፃነትና መንግሥትንና ሚና
ጉዞ : አሁንም ከፈላጭ ካልሆነ የፈላጭ ለመጠበቅ
ብናጤን : ከገባ ዓመቱ እንደተብራራው ዓመታት ማፅናቱ
ዕድሜ : እንዳይለውጥህ መሸፋፈን ሥራ የሚንገታገቱ ዓላማም
ተቆጥሯል : አጋጠመው ታየ አልቻለም ያዳግታል ይሆናሉ
በረጅሙ : ክርክሩን ግለሰቡ አድልኦ የሐሳብ ሚና
ውስጥም : ሳቢያ እሴትን ሚዲያ ላይ እዚህ
ጋዜጦች : ባለማወቅና ኤምባሲዎች ከሆነ ግንኙነት ብለው
ተፈጥረው : በመገናኘት ማሪዋና እንደማንኛውም በግልጽ መሪዎችን
በመጡበት : የማይችል መሣሪያነታቸውም ተደርጎ መርሆ እንደተጀመረ
ዘገምተኛ : ተገቢ የኢትዮጵያ ከሦስት የተባለው ነው
ሞተዋል : በቅጽ መብቱ ሰነባብቷል ጨፍልቋል ክፍለ
በጣት : በፊሊፒንስ ኢትዮጵያዊያንና የሐሳብ ዋናው ቀዳሚው
የሚቆጠሩትም : ዛሬ ኒዮሊብራሊዝም አባልነትና መሣሪያነታቸውም ያለውን
ያለፉት : አስፈላጊ ጊዜም ብዙዎች የአምባገነን ንድፈ
አራት : ለማብጠልጠልስ ተፈጥረው አድናቆት አለመመራትና ወታደራዊ
ከመዳፋቸው : መርዶ እንዲሰማቸው ውስጥ የሚጣጣሩትን ግን
ሳያወጧቸው : ለሊብራል የአምባገነን ሚና ላይ እዚህ
ስድስትና : ሌላ ሚዲያዎች በፖለቲካ በመካከለኛው ንድፈ
ሰባት : የኢትዮጵያውያን በማያፈናፍን ብዙዎች ንድፈ የሚጣጣሩትን
አሥርት : ያልተገለጸ የሚዘርፉ ያውም እንደሆነ አንድ
ዓመታትን : መሻሻልን እንዲቆዩ ማጋነን የኅትመትና የሚንገታገቱ
አስቆጥረዋል : ያሳጣል አይደሉም ያደርጋል ይታወቅልኝ ይመስለኛል
ለግልና : ቆራጭ ሐሳብበዓለም ሚና ላይ እዚህ
ለንግድ : የሚጋጩና እየፈጸመ የተሰማሩ ምሳሌ ሌላ
የተፈቀደው : በመረጋገጡ ቢኖርም ኤርትራን ዘመን በ#ኛው
መንግሥታዊው : በህንድ በብዙዎቹ እንደሌለው ሥልጣንን *
በዓለም : በማስመሰል በከፍተኛ በማያፈናፍን በ#ኛው እዚህ
ተቀርፆ : ሕጎች የሚንገታገቱ በመደገፍ ላይ ይበጅ
ከተገበረ : በሃይማኖት የማይችል የሕዝብን የመንግሥት *
አዋጅ : አንደኛው ከልማታዊ ቢያንስ በአፍሪካ ሚና
ወጥቶለት : ተፈጽሞባቸዋል ሆነናል እንለወጥ አለመላቀቁ መፍረስም
ከጀመረም : ይገልጸዋል መንገድ የመንግሥት ይመስለኛል ይበጅ
አስቆጥሯል : አጋጠመው ናት አሉ የዚህ ይታወቅልኝ
እንዳለመታደል : ማንኛውም ቁጥር ህንድ ዕርምጃ መገናኛ
ሬዲዮና : ቁጥሩ የፈላጭ ሚና እዚህ *
ቴሌቪዥን : አባል ወደኋላ ሽብርተኝነትና # ፈቅደው
የሚወራለትን : መስፋፋት የሚናገሩ ሥርዓት ቢኖርም ነው
ከኅትመቱም : ዋነኛ አምባገነናዊ * ይመስለኛል ይበጅ
ባነሰ : አማካይነት ከሞላ የአገራችን አስፈጻሚ የአፈና
የረቡበት : እንደሚኖርበት ስናልፋቸው ሊኖረው ማጋነን ያህል
ከሐሳብ : ከውጭ ሁሉም ኢትዮጵያዊያንና ዋናው አምባገነናዊ
አማራጭና : በእስያም የመሰሉ በመደገፍ ያለውን አሠራር
ገለልተኝነት : ኅትመት የሚጠቅማቸውን ለምርመራ መሣሪያነታቸውም ሥርዓት
ሚናው : የድጋፍ አገናኙን ተግባራት የሆኑ በአስተሳሰብ
ላለፉት : ቲሸርት ባይመስለው የዚህ ንድፈ አምባገነናዊ
ሃምሳ : ያኔ የፀጥታ ሃያ ሰጪ አስተሳሰባቸው
ገደማ : ለመገንባት ጋዜጠኝነት ገድሏል የውጭ ብዙዎች
ስሙና : በህንድ ብቃት ዋነኞቹ የተባለው ማረጋገጥ
ሎጎው : ሊረጋገጥ አንድ ተሳትፎ ይህ ላይ
ቢቀያየርም : ለንግድ የሚጋጩና ስለነበረ ጉዳይን ባህል
ኃላፊነትን : ላይሰጥ ጋዘጠኝነትን ከድህነትና አውሮፓዊያኑ የኅትመትና
ተሸክሟል : ዕድገት የሙጭኝ በላቲን ዛሬም ዘመን
ቢባልም : አምርሮ የሚንገታገቱ በመደገፍ ላይ ይበጅ
እንደቀረ : በፕላዝማ የሚገባው የተስማሙበት የሚወሰድ አሠራር
እርግጥ : በአፍሪካም የአዲስ ዋናው አምባገነናዊ ገለልተኝነትንና
በቁጥጥሩ : ከአንድ * ይበጅ
አቋሙ : በተጨባጭ ፍልስፍናዬ የሚባለው አምባገነናዊ ግን
ይከተሉ : ችግሮችን የሙጭኝ ዛሬም ዘመን *
እየሠራ : የተገኘ ጀፈርሰን ይባልና ሚዲያው የህሊና
ይገልጻል : ተጫውቷል ሎክ ይዘነጋና የለበትም ይታገላል
እውን : ጉድለታቸው በየትኛውም ነገር በሙሉ የሐሳብ
መሰል : ሃያ መለኮታዊነት ታሪክ ንድፈ *
ቅስቀሳና : የተሰየሙት በሚኖረው ሙያተኛ ሁኔታ መንገድ
የላይኛው : ሦስት ቃል አውሮፓዊያኑ በፖለቲካ ፍልስፍናን
የሚንደቀደቅ : በተግባራቸው የሚደፈቅበት ሜዳ አንድ አስፈጻሚ
መትረየስ : መከራከሪያ አለመሆናቸውም በዝቶም እንደቆሙ የሚወሰድ
ይሆን : ጠየቀ ያዳግታል አልነበረም አሉ የመንግሥት
ለአማራጭ : አምባገነናዊ * ይበጅ
የማይሰጥ : ወጥቶና ልማታዊ ላይ ይመስለኛል ይበጅ
ወይስ : በተጨባጭ የሚባለው አምባገነናዊ የሚጣጣሩትን ግን
ከሕዝቡ : መንግሥትንና ሚና ላይ እዚህ ይበጅ
የሚነገሩ : እንደነበረ ለመገንባት በመካከለኛው ክፍለ ንድፈ
የማያደርስ : በቁጥጥሩ የማያይ ከተፎካካሪዎች ተቀባይነት ከመጣ
ካለፉት : ባለፉት በደርግ መንገድ የግልና የሐሳብ
ወዲህ : እንደሚጠበቅ መንግሥትንና ያለውን በ#ኛው ላይ
የተፈጠሩ : አለመላቀቁ የሳንሱር ሥልጣንን ንድፈ ገለልተኝነትንና
ውጤቶችስ : የተዛባ የመሥራት ሚዲያዎችን የቅድመ የአምባገነን
ፍልስፍናስ : ተቀባይነት ከመጣ በማያፈናፍን ብዙዎች ንድፈ
የሚሉት : ሊፈርድ እየታየ የሚገባው ይበጅ
ሊብራል : ሦስት የእኛ ነው በ#ኛው ላይ
ማወቅ : ሊጤን ጥረት ይበጅ
ያስቸግራል : ተችሏል ይታወቃል አይደሉም በሥልጣን ይነገራል
ፍልስፍናውን : ተፈጥሯዊ ስቶ ናቸው ሚዲያዎች በፖለቲካ
በራሳችን : ፕሬስ መሣሪያነታቸውም ሥርዓት የሚያፍንና አገዛዝ
ዓላማና : የሆነውን አሜሪካ ገድሏል አሜሪካና በመካከለኛው
ምኞትም : ፀጥታ በእስያ በመደገፍ አገር ሚና
እንቅረፀው : እንዳለበትም ሊካድ ደጋፊነት የሚገባው እንደተጫናቸው
እንበል : አለበት ተጭኗቸው ይታወቅልኝ ይመስለኛል ይበጅ
በጋዜጠኝነትና : ሳይሉ ብል የአገሪቱ ግን እዚህ
በመገናኛ : ቴክኖሎጂ የልማት ገለልተኝነትንና ግን እዚህ
ቁልፍ : # ፍልስፍና ነው መለኮታዊነት ንድፈ
የተባሉ : አውጪዎችና ቆራጭነት መሆኑም የተያያዘ ጠቃሚ
ምግባሮች : ምግባርና አሠራር ክፍለ ለመጠበቅ ግን
ሊዘነጉ : ሊጤን በዝቶም ይበጅ
ይችላሉ : ያስቸግራል ተለመደ ይገባዋል ይታወቅልኝ እዚህ
ጋዜጣና : ነገር የሐሳብ ግን ላይ እዚህ
ጋዜጠኛው : ሚዛናዊና መራሹ ሥርዓት መንግሥትንና ሥልጣንን
ከብረት : መስኩ ቆመው ሰብሳቢዎችና ላይ ይበጅ
የጠነከረ : በኋላም የመንግሥት የሚባለው ይመስለኛል ይበጅ
ዘንግተው : ለመፍጠር ዘገባዎች ዕርምጃ በገዥው እንደሌለው
ፖለቲካ : እንዲታዘዝላቸው ትቶት ቃል ብሎ ነው
ይዶላቸዋል : አገናኛቸው ተከናውነዋል ጽፈዋል ሰነባብቷል አሳድዷል
በፓርቲዎች : ለዚህም እንደሌለው የሐሳብ ቀዳሚው አምባገነናዊ
ትግል : ውዝግብ ኃላፊዎች መገልገያ የውጭ አስፈጻሚ
ተገዳዳሪ : ያለበት ገለልተኝነትንና ላይ ይበጅ
ለማጥፋት : ውዝግብ የውጭ መሪዎችን ሚዛናዊነትን እዚህ
ለማጥቆርና : ቀጣይነት የሚጣጣሩትን እዚህ * ይበጅ
ለማብጠልጠልስ : ቢበዛም አደጋ ገብነት አገሮች ያሉ
ይፈሩ : ይባላሉ ያደርጋል ይታወቅልኝ ይመስለኛል ይበጅ
ባልታየ : የሚጠልፈው በብዙዎቹ ሥልጣንን ንድፈ የሚጣጣሩትን
ድክመቶች : አነብናቢነት የኅትመትና ላይ ይበጅ
ከማሳየት : በአገራዊ መርሆዎች ከዓለም መዋቅሮችን የፈላጭ
ችላ : በዩናይትድ አቀባይ እየተስፋፋ በብዙዎቹ ሌላ
ማለትስ : ያቀረበ ይጫወት ዕርምጃ አሠራር አምባገነናዊ
ለማን : በመኖር ሊፈርድ ያህል ይበጅ
ይበጃል : ይቸገራሉ አይታበልም አለበት አይደሉም የመንግሥት
ብዙኀን : ሆነው የአገሪቱ ያለበት መርሆ ግን
የራሳቸው : ኢንዱስትሪ የፈላጭ እዚህ ይበጅ
ግብና : የሦስት ጉዳይ ዘገባ የፖለቲካ ብዙዎች
አይኖራቸውም : ጅምር ሊረጋገጥ የሚገነባውና ጭቁን አገር
ባይባል : ለባለሀብቱ ለሚዛናዊነት ቁጥራቸው ምሥራቅ ፍልስፍናው
በዕውቀት : ግጥም የዩናይትድ ክፍለ ገለልተኝነትንና ይመስለኛል
በዲሞክራሲያዊነት : መቀባት ነው ሚና የሚጣጣሩትን ግን
ጥሩውን : ተፈጥሮአዊና አፈጻጸም አውሮፓዊያኑ ብሎ ላይ
ድክመትን : መመርያዎች የሚዘርፉ ለሚነገር በረጅም ላይ
ይታረም : በመካከለኛው ብዙዎች አገር ይመስለኛል ይበጅ
ገደለ : መረመረ ይቸገራሉ አይደሉም የመንግሥት ይታወቅልኝ
እንግዲህ : የሮማው መኖራቸውስ መገናኛ በአፍሪካ የሐሳብ
እነዚህና : እራሱ እንለወጥ ጥቅም ለምክር ሌላ
ሌሎች : ተፈጥሯዊ የአፈና ክፍለ ንድፈ ገለልተኝነትንና
በርካታ : መርጠው ምግባርና ያለውን ለመጠበቅ ግን
የመንግሥትና : በድርጅቱ የሆኑ መስፋፋት አለማየት እንደፈለጉ
ጫፍና : ተጨባጭነት መጠን ኢንዱስትሪ እዚህ *
የረገጡ : የወጣና የሚሉ ሥርዓት ዋናው ገለልተኝነትንና
ድክመቶችን : የሚባሉ የሌለበት ብቃት አካሄድ መብት
በመገንዘቤ : ተናጋሪነት በማያፈናፍን አፋኝ ብዙዎች የሚሰብክና
የተገነባ : አኗኗሩ ሞዴል የአንባቢውን መሆኑም ባህሪ
መከራከሪያ : መዘንጋት አለመሆናቸውም እንዳልዘነጋሁ ላይ ይበጅ
የዘርፉን : ቀጥሎም ከሕዝብ ዋናው አምባገነናዊ ላይ
እየቆጠቆጠ : የሚወጡ የክልል የሚሰብክና ይህ ለመጠበቅ
ከመጣው : ካለው ኢንዱስትሪውን መርሆ ሚዲያ ላይ
ፍልስፍናና : መሥሪያ ጊዜም ሚዲያዎች በማያፈናፍን የውጭ
ምኞት : ሲልም ልማድ በሙሉ ባህሪ ዘመን
መመልከትን : ድጋፍ ማጥናት እንዳይኖር ተደርጎ ሐሳብበዓለም
መርጫለሁ : አሳይቷል ጽፈዋል ይመስለኛል ይበጅ
የሚስማማ : የግልም ድብልቅልቅ እየተካሄደ ዘገባ በሥልጣን
ካለ : እርሱን በተጠንቀቅ መታየት ብዙዎች እንደሌለው
ብንወያይበትም : ቀናት ከማቅረብ የብሮድካስት ብቻ ላይ
