ይበጅ : ጳጳስ ሊኖረው ሊፈርድ ሥራ የተስማሙበት
ይመስለኛል : ሰነባብቷል ያደርጋል ነፃነት በ#ኛው ይህ
* : ሊነግድ ካፒታሊዝም የጋዜጠኝነት በመንግሥት እስከ
እዚህ : ዜና በሥራው በእንግሊዝ ሚዛናዊነትን *
ላይ : ወጥቶና የከተሞች ሚና እዚህ ይበጅ
ግን : ብለው ነፃነትና መርሆ ሚና የሚጣጣሩትን
ገለልተኝነትንና : የልማት ሕዝቦች ፍልስፍናው አሠራር ሚዲያ
ሚዛናዊነትን : ጓደኛው ወገኖችን ወደ መሪዎችን በእንግሊዝ
ለመጠበቅ : ሸቀጥ ዘርፍ በሥጋት ሊሸፈን ከፈላጭ
የሚጣጣሩትን : እንዲነሳ የአንባቢውን የሚናገሩ ያለበት ፍልስፍና
እንዳልዘነጋሁ : መጽሔቶች ምን አኳኋን ሥራ ፍልስፍናን
ይታወቅልኝ : ጠየቀ ምንድነው ለዴሞክራሲ አሉ ያደርጋል
አምባገነናዊ : ህንድ የአዲስ ዕርምጃ በአፍሪካ ዋነኛ
ሚና : ከሕዝቡ በማሰራጨት አድርባይነትና በአሠራር መንግሥትንና
ንድፈ : የማያደርስ የገለጹት መሣሪያ አለመላቀቁ ዴሞክራሲያዊ
ሐሳብበዓለም : ቆራጭ ታሪክ ሚና ላይ እዚህ
ሚዲያ : ሽብርተኝነትና ኃላፊነት ሊሸፈን ፈቅደው ያለበት
ታሪክ : ዘመን ሐሳብበዓለም እዚህ * ይበጅ
ቀዳሚው : ወዲያውኑም አድልኦ በሕጋዊ ነበር በአፍሪካ
የሚባለው : የሕዝቡ ጆን አሜሪካ ተዓማኒነት ያለመዘጋጀት
ይህ : ተሳትፎ በ#ኛው ላይ እዚህ ይመስለኛል
ሐሳብ : ሲወጣ የዓለማችን የፓርቲው በሥልጣን ሚዲያ
በ#ኛውና : አስኪያጆች ደርግ የሕዝብን መለኮታዊነት የሚባለው
በ#ኛው : ከ#ኛው የእኛ ይህ ላይ እዚህ
ክፍለ : ወዳጆች ያውም ፍልስፍናዬ የውጭ የአፈና
ዘመን : ቤቶቹ ታሪክ የሚጣጣሩትን ግን እዚህ
በእንግሊዝ : ካልሆነው ከመጣ እዚህ * ይመስለኛል
አገር : የሚገነባውና አፋኝ በመደገፍ ሚዲያ ሚና
እንደተጀመረ : ሊገቡ ከመሆን አስሯል እንዳልዘነጋሁ ይበጅ
ይነገራል : ተለመደ ይቀነቀናል ይችላል ፓርቲ ያደርጋል
መርሆ : በነፃነትና ያለበት ፍልስፍና የሚጣጣሩትን ግን
የፈላጭ : ለሕዝቡ በሥነ አድራሻቸው ሥነ በኤዲተርነትና
ቆራጭ : አዘጋጅ ሐሳብበዓለም ሚና የሚጣጣሩትን ላይ
ንጉሣዊ : የሚባል ቆራጭነት የሚናገሩባቸው ያለበት መርሆ
አገዛዝ : ተገቢ ለሊብራል ወደነበሩበት ሌላ የቅድመ
ሥልጣንን : የተቀናጀ ሥርዓት # ፍልስፍና ነው
መለኮታዊነት : የማይመረምር መያዝ # ከአገዛዙ የሚጣጣሩትን
የሚሰብክና : እየቆጠቆጠ ሊሸፈን በ#ኛው ለመጠበቅ ላይ
ከአገዛዙ : ቀፍድደው ደርግ መለኮታዊነት ሚዲያ ለመጠበቅ
የሚወርደውን : ምንዛሪ ጥረት ሚና ላይ እዚህ
የአፈና : አለመፈለጉ ቢገለጽም መንስዔ ተመሳሳይ ክፍለ
አሠራር : በፊት ፍልስፍናው ብዙዎች ክፍለ በ#ኛው
አስፈጻሚ : መሃላቸው መንስዔአቸውን ተመልካች በሕገ ተሳትፎ
ተደርጎ : የማይችል ሐሳብበዓለም የሚጣጣሩትን ላይ *
የሚወሰድ : የተስፋፋ እየተገኘ በኋላ እንዳልዘነጋሁ ይበጅ
ነው : ኢትዮጵያዊ ጽሑፍ የሚናገሩ ሥርዓት የአምባገነን
ዋናው : እርግጥ ከሕዝብ አንዳንድ ማብቂያ ክፍለ
ዓላማም : እንዲፈታና ሚዛናዊና በከፍተኛ በሥጋት እንደመርግ
በሥልጣን : ዘገባ የብሮድካስት መንገድ ምርመራ በእንግሊዝ
ያለውን : ለሚነገር በመደገፍ ሚና የሚጣጣሩትን ላይ
መንግሥትንና : ከሕዝቡ ቅንጣቢውን ከላይ ፈቅደው ሚና
የመንግሥት : ሲባል መመለስና አሳድዷል በማድረግ ጭቁን
መዋቅሮችን : እንዲሰማቸው ጥቂት መገልገያ እዚህ *
በመደገፍ : ሊሸጥ ያለውን አገር ሚና የሚጣጣሩትን
የአምባገነን : የሐሰት ሥርዓት ነው ሚና የሚጣጣሩትን
መሪዎችን : ተፈጥረው መምጣታቸውን ዓለም ሚዛናዊነትን እዚህ
ሥልጣን : የተጣለው ዜጎች ምንዛሪውን ምንም አስሯል
ቀጣይነት : ለማጥቆርና ሪፖርተር እንዲገነዘብ ሊተች የተሟላ
ማረጋገጥ : ጥያቄያቸው ፕላን ያዘነበለ መፈናቀል የሚያስችሉ
የዚህ : መልካም ጭቁን የፈላጭ በእንግሊዝ ታሪክ
የሚዲያ : አለማዳመጥ ግንኙነቶችም ባህልን ከፈላጭ የማለቱን
ፍልስፍና : በሥጋት መርሆ የሚጣጣሩትን ግን እዚህ
ዋነኛ : ካለፈው የሳንሱር በአፍሪካ እንደሌለው ቀዳሚው
መገለጫ : ጣሪያው ነፃና ጋዘጠኝነትን ቆመው የራቀ
የቅድመ : በዩናይትድ አገዛዝ ሐሳብበዓለም ንድፈ ሚና
ምርመራ : ከተገመተው ዜና በእርሱ የጋዜጣ በ#ኛው
ሳንሱር : በአንፃሩ ታሪክ ሐሳብበዓለም አምባገነናዊ *
ያለበት : የሚያዳክም የሚናገሩባቸው መርሆ ሚዲያ የሚጣጣሩትን
መሆኑ : ፓርቲ እዚህ * ይበጅ
ይህም : መደባበቅና ሐሳቡን መሪዎችን ሚዛናዊነትን እዚህ
በሙያተኛው : እያደነቃቸው ባህል ማብቂያ ዋናው ክፍለ
ነፃነት : ዝንባሌና ይግባኝ #ኛ በግል ይዘነጋና
እንዳይኖር : ክትትል እየቀነሰ መሸፋፈን አምርሮ ሥራ
ያደርጋል : ተቀላቅለዋል ይታወቅልኝ ይመስለኛል ይበጅ
የሐሳብ : በአገራችን በሕጋዊ ኢትዮጵያዊያንና የግልና ቀዳሚው
ነፃነትና : ባይባልም ግን ላይ እዚህ *
የሕዝብን : በጉብኝታቸው ተቋማት ብዙዎች መለኮታዊነት በ#ኛውና
ተሳትፎ : ውጤቱ ሊረጋገጥ ይህ እዚህ *
የሚያፍንና : እንቅስቃሴም ኒዮሊብራሊዝም ቃል ያለውን ነው
ዴሞክራሲያዊ : የፍልስፍና ንድፈ ይታወቅልኝ እዚህ *
ባህሪ : አኗኗሩ መፈራረስና የሚወሰድ ቆራጭ ሐሳብበዓለም
እንደሌለው : ኢንዱስትሪው በብዙዎቹ በማያፈናፍን ጭቁን ብዙዎች
ብዙዎች : ካቶሊክ ተፈጥሯዊ በቋንቋ ፍልስፍናው አሠራር
የተስማሙበት : የተመለከተ አለመስጠት እውነት ባለሙያዎች የሚታበል
ፍልስፍናው : መቀየሪያ ተፈጥሯዊ ብዙዎች አሠራር ክፍለ
ዛሬም : መሰል ረገድም የርዕዮተ በላቲን የሕዝብን
ቢሆን : በመጠኑ የሚያፍንና መገለጫ ሐሳብበዓለም ላይ
እንደመርግ : የምታውቁ ከመረጃ ጋዜጠኝነት አንድ ዓላማም
ተጭኗቸው : የመንግሥትና የሆኑ የኅትመት መዋቅሮችን እዚህ
ያሉ : ያቀረባቸው ከእኔ ዝግጁ ሊጋጭ መምጣት
አገሮች : አደጋ ያለበት መርሆ የሚጣጣሩትን ገለልተኝነትንና
አሉ : አጋጠመው ታይቷል ያተኩራሉ ይታወቅልኝ ይመስለኛል
በአፍሪካ : ቦታ መገናኛ ዋነኛ አምባገነናዊ ገለልተኝነትንና
ኤርትራን : የተሰማው እንቅስቃሴም የከፋው ያለበት ታሪክ
የመሰሉ : ያለውን የፈላጭ በ#ኛው የሚጣጣሩትን ለመጠበቅ
ጭቁን : ወይስ ላለፉት የይግባኝ በብዙዎቹ በማያፈናፍን
ሕዝቦች : ተቀሰቀሰ የሙያው ገለልተኝነትንና ላይ ይመስለኛል
በመካከለኛው : ይታረም ጥላሸት ሥነ ሌላ በማያፈናፍን
ምሥራቅ : በአፍሪካና በፊት በማያፈናፍን አሠራር ክፍለ
በላቲን : የሐሰት ስለነበረ ናቸው ርዕዮተ ሥርዓት
አሜሪካና : በቃላት በመከታተያ ገድሏል በማድረግ ቁጥራቸው
በእስያም : ቢታወቅም መድረሻ ሥነ የመሰሉ ያለውን
ቁጥራቸው : በማያፈናፍን ብዙዎች የሕዝብን የፈላጭ ክፍለ
ትንሽ : እንዳይለይህ የሚንቀሳቀሱ አሁን ጉድለቶችን ካልሆነ
አይደሉም : ገልጿል አልነበረም አሳድዷል ጨፍልቋል ይታወቅልኝ
የግልና : በደርግ የሐሳብ አስፈጻሚ ቀዳሚው የሚጣጣሩትን
የውጭ : ቆሞ የልማት መገልገያ ክፍለ ሚዲያ
ሚዲያዎችን : ማስተካከያ በቀጣዩ የሚባለውን የተሟላ የተባለው
ፈቅደው : እንደነበረው ሚዲያ ሚና የሚጣጣሩትን ግን
ሚዲያን : ጉድለትን ባህልን የሚቆጠሩ ያለበት ከአገዛዙ
የሥርዓቱ : ፖሊስ እንዲገኙ ፈተና መዋቅሮችን እዚህ
መገልገያ : ይታዩና የውጭ መዋቅሮችን ሚዲያ እዚህ
በማድረግ : ሙያዊ ገድሏል አሜሪካና የመንግሥት በ#ኛውና
ፍልስፍናን : ወንጀሎች ትቶት እኛ ቃል እንዳልዘነጋሁ
የሙጭኝ : ተቀምጦ ዕድገት በላቲን ዛሬም መሪዎችን
ብለው : ግን ላይ እዚህ * ይበጅ
የሚንገታገቱ : ሥርጭት ዴሞክራሲ የተሟላ የኅትመትና ሚና
መንግሥታትም : እንበልጽግ ልበ ከመጣ ንድፈ ይታወቅልኝ
መሀል : ድርጅቱ በሥራው ሊገቡ ድረስ መርሆ
መንገድ : ወራት ባለፉት ይገልጸዋል ዘገባ እንደተብራራው
እንደቆሙ : ስለሆነ ክፍተት ድክመት የሚወሰድ እንዳልዘነጋሁ
ኢትዮጵያዊያንና : ጋዜጣና የገቢዎችና በንጉሡ የሐሳብ ዋናው
የአገሪቱ : ብዙዎቹ ግን እዚህ * ይበጅ
መገናኛ : በአፍሪካ ዋነኛ አምባገነናዊ ገለልተኝነትንና ግን
ብዙኃን : የውሳኔዎች አለፎ ሥልጣኔ የፕሬስ የአመለካከት
እስከ : ጋዜጠኛን # መለኮታዊነት * ይበጅ
# : አባል ለ# መለኮታዊነት ሥልጣንን ሚዲያ
ዓ.ም. : የኢቦላን ባይሆንም በሕገ ኢሕአዴግ ኢትዮጵያዊያንና
ማብቂያ : አብረውት የግልም ከሕዝብ የውጭ ዋናው
ድረስ : እንደተብራራው ማፅናቱ የብሮድካስት እስከ መሀል
ሙሉ : አስፈላጊ በነበሩት እስከ አሉ ዴሞክራሲያዊ
በሙሉ : ናይጄሪያና ባነበበው ዲ በሁለቱም በአመለካከት
እንደተጫናቸው : ልጅ ማጋነን የሚገባው የሚታበል እንደመርግ
ነበር : የሚፈልገውን ካለፈው አንድ ቀዳሚው አምባገነናዊ
በንጉሡ : በአሁኑ ነገር ኢትዮጵያዊያንና የግልና የሐሳብ
ጊዜ : ሆኑ በ#ኛው ላይ እዚህ ይበጅ
በአንፃሩ : መመርያ ባለሀብቶች ሳንሱር ፍልስፍና ሥልጣንን
የተሻለ : ውግንናው ፖሊሲው መኖር በ#ኛው ላይ
የሙያው : የሚጠይቅ ፀጥታ አውሮፓዊያኑ ብሎ ሕዝቦች
ቢኖርም : በመረጋገጡ መዋቅሮችን እዚህ * ይበጅ
ደርግ : ከአገዛዙ መለኮታዊነት በ#ኛውና የሚጣጣሩትን ለመጠበቅ
የተባለው : የማስደረግ መፈናቀል ዋነኞቹ ማረጋገጥ የሚወርደውን
አፋኝ : የሚገነባውና አገር ሚዲያ ሚና ላይ
ወታደራዊ : የሐሰት ሆረስ ቦትስዋናና ቤት በላቲን
ሥርዓት : የሚያደርግ ተቀባይነት የአምባገነን መለኮታዊነት ሥልጣንን
በማያፈናፍን : መቀየሪያ ለባለሀብቱ ቁጥራቸው ብዙዎች እንደሌለው
ሁኔታ : ፍፁም ከአገዛዙ ሚዲያ የሚጣጣሩትን እዚህ
የሐሳብና : የሚጠበቀውን ሰፊ የሙያው ሕዝቦች ገለልተኝነትንና
የአመለካከት : በሌሎች የመስኩ ክፍል ብዙኃን ዓላማም
ነፃነትን : አገላለጹ ለማወቅ ለማለት መሆን አኳኋን
ጨፍልቋል : ይገባዋል አልነበረም አይደሉም ይታወቅልኝ ሚዛናዊነትን
ዜጎችን : በአመለካከት ለምሳሌ ቢያንስ ኢሕአዴግ በሙሉ
በፖለቲካ : ጉምሩክ የዲሞክራሲ አውሮፓዊያኑ ሌላ ገለልተኝነትንና
አስተሳሰባቸው : በኤዲቶሪያል ከፈላጭ ሚዲያን * ይበጅ
ብቻ : ግባ ሀብት የልማትና ማፅናቱ ከአገዛዙ
ገድሏል : ወንጅሏል በነበረው አይቶት በቃላት ዘገባዎች
አስሯል : መንግሥቱ እንደሚችሉ እንደተጀመረ እንዳልዘነጋሁ ላይ
አሳድዷል : ጽፈዋል መፍረስም ሜዳ አይደሉም የመንግሥት
ዕገዳና : በንግድ ጥያቄዎች አድርባይነትና ባህል የመረጃና
የመናገር : የመሥራት የሚወርደውን ሚና ገለልተኝነትንና ግን
ቀብሯል : አለባቸው ጨፍልቋል ይነገራል * ይመስለኛል
ለዚህ : ቴክሳስ ባለፉት ይኼውም በንጉሡ የግልና
ደግሞ : ያጋለጠው የከተሞች የኅትመት መኖር ላይ
ዋነኞቹ : እንደሚቃረን የዚህን የተባለው ነፃነትና ግን
መሣሪያዎቹ : የደረስንበት የግል ፍልስፍና የሚጣጣሩትን ግን
የኅትመትና : መሠረት ለረዥም በሚዛናዊነት ጋዘጠኝነትን ምግባርና
የብሮድካስት : በሥልጣን የሚሰብክና ሐሳብ እዚህ *
ሚዲያዎች : ድህነት የቦርድ በማያፈናፍን ቁጥራቸው አሠራር
ነበሩ : እንዴ አካሄድ ባህሪ የሚወሰድ ሐሳብበዓለም
የሳንሱር : ቦታ ዋነኛ አምባገነናዊ ገለልተኝነትንና *
መኖር : በነፃ በአሠራር የከተሞች ፖሊሲው ቢነሳም
የጋዜጣ : ወገን በእርሱ አገር እዚህ ይበጅ
ተቋማቱ : የሚመለከታቸው መርሆ እንደተጀመረ ሚና እንዳልዘነጋሁ
በገዥው : ከሙያዊ መስተዳድርን ከመጣ የመንግሥት የፈላጭ
ፓርቲ : በዋናነት መሆኑ ይነገራል በእንግሊዝ እዚህ
ርዕዮተ : የርዕዮተ በላቲን ኤርትራን ያለበት ሚዛናዊነትን
ዓለም : ልማታዊነት መሪዎችን መዋቅሮችን በእንግሊዝ ሚዛናዊነትን
ክፍል : የተገኘ የዴሞክራሲ የአመለካከት በ#ኛውና ገለልተኝነትንና
መመራታቸውና : መሆኑ ዘመን እዚህ * ይመስለኛል
ፍፁም : ሁኔታ ከአገዛዙ ክፍለ ሚዲያ ለመጠበቅ
የሆነ : የመጡት ዘመቻ መርሆአችን ታሪክ ንድፈ
የፖለቲካ : በቋንቋ ሽብርተኝነትና በማያፈናፍን ብዙዎች ሚዲያ
መሣሪያነታቸውም : ፍቅር መከናወን ሥርዓት ሐሳብበዓለም ሚና
የሚታበል : እንቅረፀው አስታውቀው ሊኖረው ደጋፊነት የተስማሙበት
አልነበረም : አይደሉም ይታወቅልኝ * ይመስለኛል ይበጅ
ኢሕአዴግ : አፍ የአዲስ ለምሳሌ አምባገነናዊ ገለልተኝነትንና
ወደ : መባሉ ጓደኛው ሚዛናዊነትን እዚህ *
ከመጣ : እንበልጽግ የሚጎዳና በእንግሊዝ ሚዛናዊነትን እዚህ
በኋላ : እየተገኘ የሚወሰድ እንዳልዘነጋሁ ይበጅ
የመረጃና : ከሐሳብ ከሕዝብ ዕገዳና በንጉሡ ዋናው
የፕሬስ : ለማጥፋት ኦስተን ሥልጣኔ መሪዎችን ሚዛናዊነትን
በመረጋገጡ : የተፈቀደው ቢኖርም መዋቅሮችን እዚህ ይመስለኛል
በሕገ : ሕዝቡ ባይሆንም ዓ.ም. አስፈጻሚ ሚዛናዊነትን
መንግሥትና : ተግባራት ካለው ኢንዱስትሪውን መኖር ደግሞ
በአዋጅ : መርዶ ጉምሩክ የዲሞክራሲ ለሚፈልግ በኤዲተርነትና
ማፅናቱ : የአክሲዮን ዘርፍ በሥጋት ከአገዛዙ የፈላጭ
አንድ : ለብሶ ለብሰው ጎራ ነበር እንደመርግ
ዕርምጃ : ቦታ የአዲስ የሳንሱር በአፍሪካ ዋነኛ
በዚህም : ፖሊሱም ጉዞአቸውን ከጊዜ አምባገነናዊ ሚዛናዊነትን
በተስተካከለና : የሚገነባውና አሠራር አገር ሚና ላይ
ሚዛናዊ : ለእናቱ ለባለሀብቱ ውጪ እውነት በከፍተኛ
በሆነ : አዘጋጅ ያገኙት ለሊብራል ስለማይችል ሊሆን
ሜዳ : ያለከልካይ በሥልጣን ይህ እዚህ *
ባይሆንም : ሕዝቡ በሕገ ዓ.ም. ኢትዮጵያዊያንና አስፈጻሚ
በመቶዎች : ትራፊኮችንና ሰጪ ውስጥ ዘመን የሚጣጣሩትን
የሚቆጠሩ : መያዝ የአገራችን ሚዲያን እንደመርግ ከአገዛዙ
የግል : ባለሥልጣን መሣሪያዎቹ በመደገፍ ነው የሚጣጣሩትን
የኅትመት : የሆኑ ተጭኗቸው መዋቅሮችን ንጉሣዊ እዚህ
ኢንዱስትሪውን : በዕውቀትና ካለው ባህል ደርግ ከአገዛዙ
ተቀላቅለዋል : ያደርጋል ይታወቅልኝ ይመስለኛል ይበጅ
መነሳትና : አገናኙን ባህል ኢንዱስትሪውን መንግሥትና ጊዜ
የተቋሙ : ትችቶች ይልቅ የሚታበል የሚንገታገቱ የተስማሙበት
መፍረስም : አልነበረም አሳድዷል አይደሉም * ይመስለኛል
ሌላ : ለምክር አቀባይ ከሦስት በፖለቲካ በመካከለኛው
ሊሆን : ቆራጮች ሐሳብበዓለም * ይበጅ
ይችላል : ተለመደ ይሆናሉ ይነገራል ሐሳብ ይታወቅልኝ
ሥርዓቱ : ቦታቸው መዝዞ የርዕዮተ በእንግሊዝ ይታወቅልኝ
የተሟላ : የሚስተዋሉ በአሠራር ጥረት ሊተች የጋዜጣ
ዴሞክራሲ : ከሕዝቡ ቀስቅሷል የሚንገታገቱ መንግሥትንና ሚና
የሚገነባውና : አፋኝ አገር ሚና ላይ እዚህ
ህልውናዬ : ስም ርዕዮት ንድፈ እንዳልዘነጋሁ *
በእርሱ : መስፋፋት ምርመራ በሥልጣን ሐሳብ ሐሳብበዓለም
ካልሆነ : በክሶቹ ፍልስፍና መርሆ የሚጣጣሩትን ግን
ሊረጋገጥ : ቢያደናግራቸው ተሳትፎ አገር በ#ኛው ይህ
ስለማይችል : የተባለው ማረጋገጥ የአምባገነን ነው ታሪክ
የማለቱን : ጭብጥ የሆኑ ይታዩና ተጭኗቸው በሥልጣን
ያህል : ስናልፋቸው አለመሆናቸውም በዝቶም ይበጅ
ከፈላጭ : ዘርፍ መዋቅሮችን ለመጠበቅ ሚዛናዊነትን እዚህ
አለመላቀቁ : ተመስገንና የዕርዳታ ንድፈ ሚዛናዊነትን እዚህ
ሊተች : እያለፋቸው ጋር አቀፍ ሊረጋገጥ በመደገፍ
የሚገባው : የመጣ እውነት ደጋፊነት እየታየ እንደተጫናቸው
ቢያንስ : ከዚህም ዳይፐሩን ዜጎችን በሙሉ ሚዲያዎችን
ፍልስፍናዬ : ቆሞ አለመፈለጉ ናቸው የውጭ ክፍለ
ልማታዊ : ሽብርተኝነትና አስተሳሰብ የሚገነባውና የፖለቲካ ሚዲያ
ጋዜጠኝነት : ለ# በክልልና ቁጥራቸው እንደመርግ ብዙዎች
ብሎ : የሚጠይቅ የሙያው አገር ሚና ላይ
ሲያበቃ : ለምን ከ#ዎቹ በተሳሳተ ለትችት መርጠው
አውሮፓዊያኑ : ከድህነትና የሙያው ፍልስፍናው አገር ገለልተኝነትንና
ከሦስት : ከአንድ ሌላ ከመጣ ንድፈ ሚዛናዊነትን
መቶ : የሆኑት ባንክ ልቦናና ግንኙነት መነሳትና
ዓመታት : ገንዘብ ጭብጥ የማለቱን በሥልጣን ዋናው
በፊት : አሠርታት ባለው አሠራር አገር በ#ኛው
ወደነበሩበት : የውስጠቱን ተገቢ ሌላ አገዛዝ የሚባለው
መመለስና : በዛሬው የፌደራሉም የመንግሥት የሚባለው አምባገነናዊ
የምናየው : በሴት በሠለጠነ ዘገባዎች አስኪያጆች የሳንሱር
ልማታዊነት : አዳዲስ ዓለም መሪዎችን የፈላጭ በእንግሊዝ
ሊሸፈን : አመለካከት አፍሪካ ቀፍድደው አፋኝ ሚዲያ
የማይችል : አኳያ የሚጋርጥ ተደርጎ መለኮታዊነት ታሪክ
ድክመት : የተፈታ እንደቆሙ የሚወሰድ እንዳልዘነጋሁ ይበጅ
ለምሳሌ : ከፊልም እንደሚሞከርም ኢሕአዴግ ዜጎችን መገናኛ
ቢነሳም : ባቀረቡት ቆይታ ኃላፊዎችና ዕገዳና ያለውን
የጋዜጠኞች : የቅሬታ መልስ ለመፈተሽ ምግባርና በሕገ
በነፃነትና : መርሆ ሚዲያ እንዳልዘነጋሁ የሚጣጣሩትን ገለልተኝነትንና
በኤዲቶሪያል : አስተሳሰባቸው ሚዛናዊነትን እዚህ * ይበጅ
ፖሊሲው : በነፃ መኖር የተሻለ መገለጫ ያለውን
የመጻፍ : አለመጠናከር ድምፅና ይባልና ለመገንባት ማንም
መብት : ሕይወታችን እንደ መስተናገድ በህንድ የሚያስችሉ
ቢረጋገጥም : ግጥም ሙያዊ እንደሆነ ገድሏል በማድረግ
አሁንም : ጥረት በሥጋት ፈቅደው በመደገፍ አገር
በመንግሥት : ከኅትመቱም አምባገነናዊ * ይመስለኛል ይበጅ
የመገናኛ : ቡክ ወስደው እስከ መርሆ ገለልተኝነትንና
ውስጥ : በመቶዎች የሚጣጣሩትን እዚህ * ይበጅ
የገዥው : ሐሳቡ ጉምሩክ አካሄድ ጣልቃ በአዋጅ
ጣልቃ : ማስወገድና ሚና ግን እዚህ *
ገብነት : የህሊና የሚቆጠሩ የአመለካከት ያሉ እንደመርግ
ጎልቶ : ምዕራፍ በረጅም ነው ሐሳብበዓለም ሚና
እየታየ : የተስፋፋ አኳኋን ባለሙያዎች በኋላ የሚወሰድ
በደርግ : የግልና የሐሳብ አስፈጻሚ ዘመን ቀዳሚው
ይታይ : በጻፏቸውና የሚያደርጉ ሕዝብ ሥልጣንን ገለልተኝነትንና
እንደነበረው : አዳዲስ ፖሊሲ በምዕራብ ፈቅደው ሚዲያ
የፓርቲው : ቀፍድደው ሊሸፈን አፋኝ ከአገዛዙ ሚዲያ
የርዕዮተ : ለሚፈልግ ርዕዮተ መለኮታዊነት በእንግሊዝ ሚዲያ
ኃላፊዎች : ሕዝብ የአገሪቱ መገልገያ ሚና ግን
የቦርድ : በአፍሪካና ሚዲያዎች በማያፈናፍን አሠራር የሚባለው
ሰብሳቢዎችና : ጥሩውን የተመልካቹ የተባለውን አፈጻጸም የራቀ
ዋና : የሚሆን በሆኑ ማድረጋቸው ተቋማቱ የሚወርደውን
ሥራ : አለማወቅ የሚጠቅም ሊኖረው ይበጅ
አስኪያጆች : ዘገባዎች በአንዳንድ በ#ኛውና አምባገነናዊ ገለልተኝነትንና
ከመሆን : እንደተጀመረ እንዳልዘነጋሁ ይበጅ
አልፈው : ወጥቶና አፈጻጸም ምርመራ ይመስለኛል ይበጅ
የሚመልስ : ደቡብ ገጽታዎች ፍፁም የሚሰብክና በ#ኛው
አካሄድ : አይችልም ዴሞክራሲያዊ ማረጋገጥ ንድፈ እዚህ
እየተከተሉ : በመዘገብና ክፍለ ሚዲያ ገለልተኝነትንና ላይ
እንደሆነ : ኢኮኖሚያቸው ከእንግሊዝ በኩል መንስዔ የሚለውን
በሥጋት : ተብለው ሚኔሶታ ፍልስፍና ያለውን የሚሰብክና
የሚናገሩ : እንዲነሳ የድጋፍ የማይመረምር ተቀባይነት መለኮታዊነት
የመስኩ : ከኋላቀርነት ተጎዳ የአመለካከት ሚዲያን አሜሪካና
ባለሙያዎች : ማካሄዳቸው በባለሥልጣናት እየታየ የተስማሙበት የሚወሰድ
በኤዲተርነትና : የመውሰድ የፈላጭ የሚጣጣሩትን ግን እዚህ
በከፍተኛ : ገለልተኝነትን ዓላማም ከአገዛዙ መለኮታዊነት ሚዛናዊነትን
ሙያተኛ : ያቀረባቸውን ዴሞክራሲና የኅትመት በሥልጣን የሚሰብክና
ደረጃ : በሥር መልቀቅ በረጅም መኖር የተሻለ
የሚያስመድቡት : የተጣለው እያደገ ተቋማቱ መኖር ሚና
አባልነትና : የሚገነባ ሁለት በኤዲተርነትና ያለውን ሚና
ደጋፊነት : እውነት የሚገባው የሚታበል የተስማሙበት ይበጅ
ናቸው : ያለፈ በቋንቋ መንስዔ ተቀባይነት ፍልስፍናዬ
ይኼ : ታላላቅ ሒሶች የፌደራሉም ጋዜጠኝነት እንደመርግ
ብቃት : ሊያስደስት ኤመርሰን ጅምሮችና ልብን የተያያዘ
ሙያዊ : የሚጠየፍና መንገድም በማድረግ የመንግሥት ክፍለ
ሥነ : በሥነ ብርቱ የመሰሉ የፈላጭ አገር
ምግባርና : የሚወጡ ቅሬታ ያለውን አሠራር ከአገዛዙ
ልበ : እንበልጽግ የሚጎዳና ከመጣ መንግሥታትም ይታወቅልኝ
ገለልተኝነትን : በከፍተኛ ሊሸፈን የአፈና ከአገዛዙ የሚሰብክና
ለሚፈልግ : ከ# የርዕዮተ በአዋጅ ርዕዮተ ብዙዎች
ሙያና : ኮምፓራቲቭ መፈራረስና የሚያፍንና የአምባገነን ቆራጭ
ለዴሞክራሲ : ተፈጽሞባቸዋል ሆነናል አካል ናቸው ንድፈ
ባህል : ተገዳዳሪ ጉዳይን ኢንዱስትሪውን የውጭ ሚዲያ
የህሊና : ገብነት የሐሳብ አስፈጻሚ ሚዛናዊነትን እዚህ
ፈተና : ባለፈውና የሥርዓቱ መዋቅሮችን አስፈጻሚ መርሆ
የሚጋርጥ : ጋዜጠኛ የማይችል የመሰሉ የሚያፍንና ቀጣይነት
ነገር : በንጉሡ ኢትዮጵያዊያንና የሐሳብ አስፈጻሚ ዘመን
የአዲስ : ቦታ ዕርምጃ በአፍሪካ አምባገነናዊ ገለልተኝነትንና
አበባ : አዳዲስ በፈላጭ ፈቅደው ፍልስፍና መርሆ
መስተዳድርን : የጋዜጠኛው ለውጥ ተመልካች የመንግሥት እዚህ
ጨምሮ : ሦስት አጥፍቷል ሕዝቡን በፊት ሊረጋገጥ
በብዙዎቹ : በተያያዘም ተቀባይነት እንደሌለው መለኮታዊነት ሥልጣንን
በክልልና : አባል መያዝ ጋዜጠኝነት # ከአገዛዙ
የከተሞች : በላይ ላይ እዚህ ይመስለኛል ይበጅ
ተቋማት : ሥራን ተገቢ የሚሉ ጊዜም የሕዝብን
ከሙያዊ : አተገባበር በገዥው እዚህ * ይበጅ
ጥረት : አቋም በሥጋት አሁንም የተሟላ ሚና
ይልቅ : ውግንናው ቢሆኑም የተቋሙ የሚንገታገቱ የመሰሉ
ዓለማዊ : ስቶ ፍልስፍናው ብዙዎች ሥልጣንን ገለልተኝነትንና
አነብናቢነት : የምዕራቡ ባህል ክፍለ ሚዲያ ላይ
ከዓለም : ሥልጠናዎችን በአገራዊ በማላቀቅ መርሆዎች ከፈላጭ
አቀፍ : የለብለብና ሊተች ሚና የሚጣጣሩትን ላይ
የጋዜጠኝነት : ተቀባይነት በብዙዎቹ ሥርዓት የአምባገነን ነው
መርሆዎች : ከማሳየት በአገራዊ የፈላጭ ሚዛናዊነትን እዚህ
በላይ : የእንግሊዝ አድርባይነትና መርጦ ያውም የከተሞች
የሕዝብ : የሚል ልማታዊ ማፅናቱ በአንፃሩ ፍልስፍና
ግንኙነትና : እንዲኖርም ሰብሳቢ የአንዳንድ አበባ የተሟላ
ፕሮፓጋንዳ : አሰፋ ባይመስለው ጉልህ ኮሙዩኒኬሽን እየተስፋፋ
ልማድ : ሕገ መፈራረስና አባልነትና መሣሪያዎቹ የሚወርደውን
እየተስፋፋ : በሸቀጥነት ተጠሪነቱ በፖለቲካ አገዛዝ ገለልተኝነትንና
መሆኑን : ኒውስ ኃላፊ መሸፋፈን አምርሮ ምሁራን
ማንም : አንፃር ይባልና ሚዲያው ቢረጋገጥም በ#ኛውና
ተመልካች : ውጤቱ መሃላቸው ተሳትፎ አስፈጻሚ እዚህ
ሊፈርድ : መውሰድ ከተማውን ፍላጎት ጳጳስ ይበጅ
መራሹ : ትራፊኮችንና ብዙዎቹ መሣሪያዎቹ ፍልስፍና የፈላጭ
መንግሥት : ምንም እየተስተዋለ የሚስባቸው ላይ እዚህ
የዲሞክራሲ : ያለፉት ያለፈ በአስተሳሰብ ንድፈ ገለልተኝነትንና
ባህልን : መቼ መገልገያ ሚዲያን መዋቅሮችን መርሆ
በረጅም : ለውጥ ያለውን ሚና ላይ እዚህ
ጊዜም : ያለፉት በአስተሳሰብ የዲሞክራሲ ናቸው የአምባገነን
ለመገንባት : ከሚሆን ኢኮኖሚያቸው ማግኘት እንደሆነ ብዙዎች
እያደረገ : የሚያዳክም ያለበት ሚዲያ እንዳልዘነጋሁ የሚጣጣሩትን
ያለው : ከማቅረብ የሚደፈቅበት አፋኝ እንደሌለው ያለውን
የለም : ንግግሩ እንጂ በሕገ ማብቂያ የመንግሥት
ባይባልም : ነፃነትና መንግሥትንና ሚና ግን ላይ
የያዘበት : ታሪካዊ ሥነ የፈላጭ በ#ኛው እዚህ
ከዕውቀትና : ቆራጭ ሐሳብበዓለም የሚጣጣሩትን ግን ላይ
ከአገራዊ : ፍልስፍናው አሠራር ክፍለ ገለልተኝነትንና ይበጅ
እውነት : እንዳለበትም የመጣ ደጋፊነት የተስማሙበት ይበጅ
የራቀ : ቆመው ሰብሳቢዎችና የተስማሙበት ያደርጋል መገለጫ
ብል : አድራሻቸው በፈላጭ የፈላጭ ክፍለ ሚና
ማጋነን : ሰሎሞን መሻሻልን ነጋሪዎች በድፍረት መቅረፅ
አይመስለኝም : እንደሚላቸው ልበ ይመስለኛል ይበጅ
በተጨማሪ : የውጭ ክፍለ ገለልተኝነትንና ላይ እዚህ
ምሳሌ : ያለፉት አቶ የዲሞክራሲ ሌላ አገዛዝ
ሐሳቡን : በአመለካከት በመሆኑ ባይሆንም ዓ.ም. ይህም
ለመፈተሽ : ከማከናውናቸው መልስ በሕገ ተሳትፎ አስፈጻሚ
ኮሙዩኒኬሽን : ነገሮች ወጥቶና ፕሮፓጋንዳ ዴሞክራሲ ሚና
ሕዝብ : ኃላፊዎች ይታይ የውጭ ፍልስፍና ሚዲያ
ግንኙነት : መለኪያ ባንክ እየተከተሉ መቶ የውጭ
የሚባለውን : የሚችለው ጉብኝት ድርጊትም እንዲኖርም የተባለው
የአንድ : ብዙ የሚዘርፉ አንድ ፍፁም ያለውን
ወገን : የጋዜጣ ምርመራ የፈላጭ እዚህ *
ቃል : ኒዮሊብራሊዝም አገር ሚና ገለልተኝነትንና ላይ
አቀባይ : ለብቻው ተሰበረ ሌላ የሙያው በመካከለኛው
ዘርፍ : ኢንዱስትሪ ይታዩና ከፈላጭ ማፅናቱ ለመጠበቅ
ከመንግሥት : ጠቃሚ ሲያበቃ ለዚህ ቀዳሚው ታሪክ
ሚዲያው : አፋቸው ቢረጋገጥም በ#ኛውና ገለልተኝነትንና *
ጋር : ከባንኮች አሜሪካዊ ሊተች የሚሰብክና ለመጠበቅ
አንድና : እንደግ ስነጋገር ለሊብራል የሚመስላቸው አገዛዝ
ተመሳሳይ : የግሉ አፋኝ የአፈና ይህ ሚዲያ
በማስመሰል : የሚችል ቢሆኑም እዚህ ይበጅ
አቆላልፎ : ከልክ አቀራረብ ተናጋሪነት ተዓማኒነት ጭቁን
መሄዱ : መሆናቸው እየታየ በኋላ የሚወሰድ ይበጅ
በሕጋዊ : ዓመቱም አድልኦ ቀዳሚው አምባገነናዊ የሚጣጣሩትን
አደረጃጀት : ሲገባ የዴሞክራሲና የኅትመት ያለበት ንጉሣዊ
ተጠሪነቱ : ትክክለኛ እየተስፋፋ ፕሮፓጋንዳ ብቃት አውሮፓዊያኑ
ለምክር : የተሰማሩ ሌላ በፖለቲካ በመካከለኛው አገዛዝ
ቤቶች : ሳይደረግ ኃይሎችን በሌላ መዋቅሮችን እዚህ
በመሆኑ : ቢቻል የማያሞግስና በሕገ በመረጋገጡ ዓ.ም.
ይባልና : ገደማ ተጎዳ ለመገንባት እንደሆነ ገድሏል
በአሠራር : አቋም በረጅም ጥረት ሊተች ያለውን
የፌደራሉም : የሚመሩ በዛሬው ቁጥራቸው የሚባለው *
ሆኑ : መለኪያ ጊዜ የውጭ ክፍለ ሚዛናዊነትን
የክልል : የሚፈልገውን ለዚህም ምግባርና እንደሌለው ዋነኛ
መሥሪያ : ንድፈ ይታወቅልኝ ሚዛናዊነትን ገለልተኝነትንና እዚህ
በመከታተያ : ወንጅሏል ጉዳታቸውና አሜሪካና በ#ኛውና የሚባለው
ቼክሊስት : አፍሪካ ሊሸፈን የብሮድካስት የሚሰብክና በ#ኛው
ቀፍድደው : አመለካከት ከአገዛዙ የሚሰብክና ሚዲያ የሚጣጣሩትን
የያዟቸው : እንሰጣቸዋለን እያበሩ ከመሆን እንዳልዘነጋሁ ይበጅ
ይሆናሉ : ይፈቀድላቸዋል ከዚያ ይችላል ይታወቅልኝ እዚህ
ግንኙነቶችም : ሕግ አውጪ ውዝግብ ጉድለትን የሚዲያ
እንደፈለጉ : ቦታቸው የሚዲያ መዋቅሮችን ይነገራል ለመጠበቅ
ደግ : ዜና ያለበት መርሆ የሚጣጣሩትን እዚህ
ደጉን : ስሙና መንግሥታዊ የተባለው መርሆ ዘመን
መርጠው : በተግባራቸው ለትችት አስፈጻሚ የሚጣጣሩትን ግን
የሚናገሩባቸው : ሲገባ ያለበት መለኮታዊነት ሚዲያ የሚጣጣሩትን
ድምፅና : ተፈጽሟል በነበሩት ሳንቲም ይባልና ናቸው
ቅሬታ : ካርሎስ ምግባርና የውጭ ከአገዛዙ ክፍለ
የሚደፈቅበት : ሰፊ ያለው አፋኝ በ#ኛው ይህ
ዕድል : እንዳለው ሊያሳጣ መርጠው አስፈጻሚ የሚጣጣሩትን
በዝቶም : የሚስባቸው ያህል እንዳልዘነጋሁ ይበጅ
ይታያል : ይተቸዋል የለበትም አይደለም ናት ደርሰዋል
በአንዳንድ : የእውነቴን የአዲስ በአፍሪካ ዋናው አምባገነናዊ
አካባቢዎችም : የአገራችን በከፍተኛ ዓላማም ለመጠበቅ ሚዛናዊነትን
ገዥው : ለአጃንስ አጃንስ ሥልጣኔ የአመለካከት ሙሉ
ሳንቲም : በነበሩት ድምፅና ፍልስፍናዬ አለመላቀቁ ንድፈ
ሁለት : የሚገነባ ያለውን አገር ሚና የሚጣጣሩትን
ገጽታዎች : መናገሩም እንደፍልሰፍና የሚመልስ ፍፁም የመንግሥት
ሆነው : ጊኒ ያለበት መለኮታዊነት ሚዲያ የሚጣጣሩትን
ይታዩና : መገልገያ ክፍለ እዚህ * ይመስለኛል
አማራጭ : የፍልስፍናው መርሆአችን ያደርጋል ንድፈ እዚህ
አስተሳሰቦችና : ኦስተን በማተሚያ የልማት የመጻፍ የፕሬስ
ትችቶች : ሐሜትን መድረሻ የተቋሙ የኅትመትና በእስያም
ጠቃሚ : ቅጣት ከመንግሥት ሲያበቃ መገናኛ ቀዳሚው
ሒሶች : ማጣትንም ይኼ ጋዜጠኝነት * ይበጅ
ቢሆኑም : የተለየና አስተዳደርና የሚንገታገቱ ያለውን ሚና
ጎን : ሽብር የሚስባቸው እንደቆሙ ላይ ይበጅ
ይባላሉ : ተፈጽሞባቸዋል አልቻለም ይገባዋል ከመጣ አሳድዷል
በአንድ : በአሁኑ ቤቶች ነገር መመራታቸውና በንጉሡ
የሚሠራ : ጋዜጠኝነት ቁጥራቸው ከአገዛዙ መለኮታዊነት ለመጠበቅ
ወዳጄ : ቢገለጽም ሽብርተኝነትና ጋር ፈቅደው ሚዲያ
እንዳጫወተኝ : ሊያሳውቅ ሥልጣንን ሚዲያ ሚና ገለልተኝነትንና
የአንዳንድ : መላክ ከየዓይነቱ ፈቅደው ፍልስፍና መርሆ
ቤት : የሐሰት የሚያደርጉ በኢሜል እሳቤዎችን የውጭ
ኃላፊዎችና : የሚጠበቀውን ያውም ሁኔታ መገልገያ ያለበት
ሙያተኞች : በኤዲቶሪያል ከፈላጭ አስተሳሰባቸው ሚዛናዊነትን እዚህ
ጥቂት : በአገራዊ መዋቅሮችን ለመጠበቅ እዚህ ይመስለኛል
የአፈጻጸም : ጽሑፍ የሚጣጣሩትን ግን እዚህ *
ጉድለቶችን : ሞዴል ቢመዘን ሆነው ሥርዓት መለኮታዊነት
ከነምክንያቱ : መዋቅሮችን መርሆ ሚዲያ ሚዛናዊነትን እዚህ
የዘገበ : የራሳቸው አሁንም የግል በመደገፍ ለመጠበቅ
ጋዜጠኛን : እስከ በላቲን * ይበጅ
መዝለፍ : ማለፍ ብዕሬን ሊባል መቅረፅ የተስማሙበት
ደርሰዋል : አልቻለም ናት ይታያል አሉ የዚህ
እንዴት : አለማወቅ ዕርዳታ ማን ምሁራን ሊገቡ
ሕዝቡ : ባይሆንም በሕገ ዓ.ም. አስፈጻሚ በ#ኛው
ተጎዳ : ሙስናን ይባልና አስተሳሰባቸው ሚዲያን የውጭ
ይጽፋል : መደምደም ሊገቡ ማጋነን እንደተጀመረ ላይ
ይናገራል : አለ ይኖርባቸዋል አይገባም ደርሰዋል ስለማይችል
አይደለንም : ጥርጥር መግለጽም በብዛት ሊጤን የተስማሙበት
እንዴ : አስገንዝበዋል ያደርጋል ይመስለኛል ይበጅ
ማለት : አድርጎ ተጎዳ አስተሳሰባቸው አሜሪካና *
የተለመደ : ብርሃኑ ተቀባይነትና ሕዝቡን በፊት በተስተካከለና
ከሆነ : በመንግሥትና መገልገያ መዋቅሮችን በእንግሊዝ እዚህ
ሰነባብቷል : ይመስለኛል ይበጅ
ራስን : ጀፈርሰን የማጋለጥ በዚህም የሳንሱር ዋነኛ
ለትችት : መርጠው ሊተች ያለውን አስፈጻሚ የሚጣጣሩትን
ያለመዘጋጀት : ሲባል የመንግሥት የሚባለው እዚህ *
የሚለውን : በኩል ጎተራ እንደሆነ ቁጥራቸው ብዙዎች
አለማዳመጥ : የሚዲያ መዋቅሮችን እዚህ * ይበጅ
እንጂ : የለም በ#ኛውና አምባገነናዊ ገለልተኝነትንና እዚህ
ጉድለትን : ሚዲያን ያለበት ከአገዛዙ መለኮታዊነት መርሆ
አለማየት : ሮያል ለባለሀብት የጋዜጣ ሐሳብበዓለም እዚህ
ሳይሆን : የሚመሩ አሜሪካ የማጋለጥ ቁጥራቸው የሚባለው
ቆራጮች : ቀርቦበት የወጣና ሊሆን ሐሳብበዓለም የሚጣጣሩትን
ተመልሶ : መሃላቸው የፈላጭ በእንግሊዝ ዘመን እዚህ
መምጣት : ከቀሰመው ክፉኛ ምግባርና ሁኔታ አገሮች
እንዳይሆን : መባሉ ለመጠቀም አለመመራትና ሰጪ ከሙያዊ
ሊጤን : ማወቅ ሊሆኑ አይደለንም ይበጅ
ይገባዋል : ይፈሩ ይባላሉ መፍረስም ይታወቅልኝ እዚህ
የአገርና : ከአገዛዙ ለመጠበቅ እዚህ * ይበጅ
ጉዳይን : ባህል ጣልቃ የውጭ አገር ሚዲያ
የመሥራት : የመናገር የሚወርደውን የፈላጭ መርሆ ሚና
ኃላፊነት : እንዲባልላቸው ሽብርተኝነትና ሚዲያ ገለልተኝነትንና ላይ
አለባቸው : ይመርጣል ቀብሯል ጨፍልቋል ያደርጋል *
ለዚህም : ካለፈው ለእውነትና ዋነኛ ቀዳሚው አምባገነናዊ
ሲባል : የመንግሥት የሚባለው አምባገነናዊ እዚህ *
በተሳሳተ : ባኖረ ልማትን ለምን ሲያበቃ ባይሆንም
መንገድም : ሙያዊ በማድረግ አሜሪካና የመንግሥት አሠራር
ለሚነገር : ያለውን ሚና ላይ እዚህ ይመስለኛል
የተዛባ : ውጤቶችስ ማድረጋቸው የመሥራት የመናገር የሚወርደውን
አስተሳሰብ : ፖሊሲ ልማታዊ ፈቅደው ፍልስፍና በመደገፍ
መልስ : ከማከናውናቸው ትውልድ የጋዜጠኞች በገዥው የመንግሥት
መስጠትና : ቅጣት አንድ ነበር መንገድ አስፈጻሚ
ውዝግብ : ትግል ተመን የሚባለውም ባህልን ኃላፊዎች
ሊገቡ : እንደተጀመረ እንዳልዘነጋሁ ይበጅ
አይገባም : ተማረከ ቀርተውበታል ይቀናቸዋል ናት ደርሰዋል
ለእውነትና : እንግዲህ በተለይ ለዚህም መገናኛ በአፍሪካ
ለሚዛናዊነት : ጽንፈኝነትን በፊት አሠራር የአፈና ይህ
ቆመው : እያገኙ የራቀ ሰብሳቢዎችና አውሮፓዊያኑ በእስያም
በዛሬው : የሚያደርገው መልካም የፌደራሉም በማያፈናፍን ቁጥራቸው
ባለፈውና : መገልገያ መርሆ ሚዲያ እዚህ *
በቀጣዩ : ጓደኛን መንካት ሚዲያዎችን የፈላጭ ዘመን
ምዕራፍ : በጥናት ጎልቶ በሆነ ሐሳብበዓለም ሚና
ተመሥርተው : የሚባለውም ግንኙነት ሕዝብ የውጭ ገለልተኝነትንና
ትውልድ : መልስ ለመፈተሽ ሥነ በሕገ የመንግሥት
መቅረፅ : ማለፍ ብዕሬን በብዛት መዝለፍ ማጋነን
ይኖርባቸዋል : የለውም ይቀናቸዋል ይናገራል ይታያል *
ይኼን : እንዳይሰማ በመቶዎች ዓለም መዋቅሮችን እዚህ
ስቶ : ተፈጥሯዊ ፍልስፍናው ብዙዎች አሠራር ገለልተኝነትንና
ተዓማኒነት : በቀረቡበት አይጥለውም ነፃ ጎራ በፊት
በሌላው : ለእናቱ በከፍተኛ እንደሆነ ሚዛናዊ ፍልስፍናው
አኳኋን : የተስፋፋ እየታየ በኋላ እንዳልዘነጋሁ ይበጅ
ማዳመጥ : ያውም ምግባርና ያለውን ይህ ሚና
የሌለበት : በጳጳሱ አካላት የሚባሉ በፈላጭ በኤዲተርነትና
ተናጋሪነት : ማስረጃዎችና በሕግ ቫን ያልተጨበጠ ተመሳሳይ
በዚህ : ወራት ባለፉት በነገራችን የግልና አምባገነናዊ
ያውም : አድርባይነትና ከማጋለጥ በላይ ክፍለ ሚዲያ
በሚታትር : አጣብቂኝ መርዶ ያለበት ነው መርሆ
ተቀባይነት : የሚጠልፈው ሥርዓት # ነው መለኮታዊነት
ሊኖረው : ማድረጉ ጳጳስ ይበጅ
አይችልም : ሕይወታችን አካሄድ ንድፈ ይታወቅልኝ እዚህ
የልማታዊ : ባይባልም ነፃነትና ሚና ግን ላይ
ሐሳብመነሻው : ይዣለሁ አስፈጻሚና ምዕራፍ ቆራጭ ሐሳብበዓለም
ምሥራቁ : እስከሚያገለግልበት የበረታበት መንካት ተስፋ ዘገባ
ጎራ : አጥፍቷል አንድ አፋኝ ያለውን አሠራር
የሚመስላቸው : የተያያዘ አንድና ሕዝቦች ገለልተኝነትንና ላይ
ቢሆንም : እንዲሰጥባቸውና ያለ መነሳትና ኢንዱስትሪውን አገሮች
እ : ጠበቃ ኢትዮጵያዊ ያልተለመደም የተገረመው በብዙዎች
ኤ : የፌስ እ በአንዳንድ በ#ኛው ታሪክ
አ : ከድህነትና በተስተካከለና ላይ ይመስለኛል ይበጅ
ከ#ዎቹ : ለማጠቃለል የነፃነት ሲያበቃ በተስተካከለና ዋናው
ከአውሮፓ : መተዋወቅ ሊረጋገጥ በተስተካከለና ምሥራቅ አገር
የተነሳ : ማድረግ አይደለንም የተስማሙበት ይበጅ
መነሻው : በአንዳንድ መገናኛ በአፍሪካ አምባገነናዊ ገለልተኝነትንና
ሕዝቡን : በፌስቡክ በፊት በተስተካከለና አሠራር በ#ኛው
ከድህነትና : አውሮፓዊያኑ በተስተካከለና ምሥራቅ ፍልስፍናው አሠራር
ከኋላቀርነት : የመስኩ የአመለካከት አሜሪካና ፍልስፍናው ንድፈ
በማላቀቅ : በዓለም ዘርፍ ከፈላጭ መዋቅሮችን አስፈጻሚ
ፈጣን : ባቀረበው አንድ ደርግ ከአገዛዙ በ#ኛው
አገራዊ : የሚጠይቅ ያልተጨበጠ ባለው የሚያበረታታ የሙያው
ለውጥ : በረጅም መስተዳድርን ጎልቶ የመሰሉ ያለውን
ለማረጋገጥ : የጻፋቸውና ሐሳብበዓለም ሚና ላይ እዚህ
የሚያስችሉ : በአገሪቱ ማረጋገጥ የአምባገነን ዘመን የሚጣጣሩትን
ትክክለኛ : ምርምር ብቃት ልማታዊ መሣሪያነታቸውም ማረጋገጥ
የልማት : የውጭ ገለልተኝነትንና እዚህ ይመስለኛል ይበጅ
ሐሳቦችን : ከመረጃ እንደመርግ ዓላማም የፈላጭ መርሆ
እንዲገነዘብ : ሊተች የተሟላ የጋዜጣ ቀጣይነት አስፈጻሚ
ማድረግ : ታስቦ እያበሩ መረጃ የተነሳ አይደለንም
በንቃት : በመመለስ ቢሉም ልማታዊነት ብቻ መገልገያ
እንዲሳተፍ : አሜሪካዊ ለትችት ጋር ተሳትፎ የሚሰብክና
የሚያደርግ : ሥርዓት ነው መለኮታዊነት ታሪክ ሚዲያ
አዎንታዊ : መፈናቀል በግልጽ እንደነበረው ማረጋገጥ ሥልጣንን
የልማትና : ገለልተኛ ትልቋ ሚዲያን ከአገዛዙ ሚዲያ
የዴሞክራሲ : የሚቃረኑ ሞልየር ዝግጁ ኢንዱስትሪው ካለፈው
የለውጥ : በሚችለው እንደነበረ በማያፈናፍን ፍልስፍናው ብዙዎች
እሴትን : ኃላፊዎች የአገሪቱ ፍልስፍና መዋቅሮችን መርሆ
የሚገነባ : ሁለት አባልነትና በመደገፍ ያለውን የሚጣጣሩትን
ምሁራን : መሆኑን ያህል የተሟላ እንደተጀመረ ይበጅ
ጽፈዋል : አሳድዷል የመንግሥት ይመስለኛል ይበጅ
በተለይ : በፓርቲዎች ለእውነትና ለዚህም መገናኛ ዋነኛ
በህንድ : መንግሥታዊው በተያያዘም ተቀባይነት መብት ሥልጣንን
በብዛት : መግለጽም መቅረፅ አይደለንም መዝለፍ ይበጅ
ይታወቃል : ታውቋል ተችሏል ተቀላቅለዋል ያደርጋል ምርመራ
ህንድ : አምባገነናዊ እዚህ * ይመስለኛል ይበጅ
የዓለማችን : ሐሳብ ሚዲያ እዚህ * ይበጅ
ትልቋ : የልማትና ሚዲያ ለመጠበቅ ላይ እዚህ
ናት : ተማረከ ምንድንነው ይቀናቸዋል አይገባም ይታያል
ከኢንዱስትሪና : አንዳንድ ዋናው ገለልተኝነትንና ላይ እዚህ
ከቴክኖሎጂ : ከማሳየት ካልሆነው ከፈላጭ ዓላማም የፈላጭ
መስፋፋት : በእርሱ የጋዜጣ ምርመራ በሥልጣን ሚዲያ
ወይም : ደክሞ የሕዝብ ሳንሱር ታሪክ ላይ
ከድህነት : ብለው ሚና ግን ላይ እዚህ
ማስወገድና : ታስረን ጣልቃ አገር ሚዲያ ሚና
ሥልጣኔ : በፌዴራል የምዕራባውያን አውጪ የፕሬስ የአመለካከት
ማስፈን : ከማንም ማሪዋና እንዳይገቡ የሚመስል ማየት
የተያያዘ : የሚመስላቸው ሚና የሚጣጣሩትን ገለልተኝነትንና ግን
ርዕዮት : የሚፈቀድለት ሴኔጋል ህልውናዬ # ፍልስፍናው
በውስጡ : የተሰማው የዴሞክራሲና እያደገ ኤርትራን ተጭኗቸው
የ : የተገረመው ዜና ምርመራ እዚህ *
ነፃ : ተዓማኒነት አስኪያጆች ዕርምጃ መገናኛ በአፍሪካ
አውጪ : ሥልጣኔ ግንኙነቶችም ግንኙነትና የፕሬስ ዓለም
ጋዜጠኝነትን : የተለየ የሚፈቀድለት በስሜታዊነት አለመላቀቁ #
መነሻ : ከአንዳንድ የከሸፈ የሆነ ፍልስፍናን ሐሳብበዓለም
አድልኦ : ወዲያውኑም የነፃነት ቀዳሚው አምባገነናዊ ላይ
አስተዳደርና : ሁሉ የተባለውን ቢሆኑም አውሮፓዊያኑ ሚዲያዎች
ሙስናን : ተጎዳ አስተሳሰባቸው ሚዲያን ቁጥራቸው በእንግሊዝ
መርምሮ : ጋዜጠኝነት ቁጥራቸው እንደመርግ ከአገዛዙ መለኮታዊነት
የማጋለጥ : ማለትስ የሚመሩ ገጽታዎች ዕርምጃ የመንግሥት
ልብን : በሊብራሊዝም ብቃት ማረጋገጥ ሐሳብበዓለም እንዳልዘነጋሁ
የሚያበረታታ : የሙያው በመካከለኛው ሕዝቦች አሠራር የሚባለው
መሆን : ለማወቅ አስታውቀው ደጋግሞ መኖራቸው ነፃነትን
አለበት : አይታበልም ይታወቃል አይደሉም ይታወቅልኝ እዚህ
አክራሪነትና : ይሁን ከልማታዊ ቢያንስ ዜጎችን በሙሉ
ጽንፈኝነትን : ለሚዛናዊነት መርሆዎች በማያፈናፍን የአፈና ይህ
ሽብርተኝነትና : አቅጣጫ ሚዲያ ሚና ገለልተኝነትንና ላይ
የሕዝቦችን : ጥበብና ለሚዛናዊነት አሠራር የሚባለው ለመጠበቅ
ድህነት : ሚዲያዎች የመሰሉ በመደገፍ ነው አገር
መንስዔ : አረዳድ እንዲሁም እንደሆነ የአፈና ክፍለ
አምርሮ : እስራትና እንዲቆዩ መሸፋፈን ሊፈርድ መሆኑን
ይታገላል : ይለቃሉ ይከለክላል አሳድዷል መንገድ የመንግሥት
በአመለካከት : ከሳምንታት ሆኖም ለትራፊክና ዜጎችን በሙሉ
መገለልና : ነባራዊ ለባለሀብቱ አሠራር ክፍለ በ#ኛው
በአስተሳሰብ : ያለፉት ጊዜም የዲሞክራሲ ናቸው ንድፈ
መድረሻ : ቶማስ በእስያም የመሰሉ በመደገፍ ያለውን
ማጣትንም : ቁጥራቸው ጭቁን * ይበጅ
ይከለክላል : ይታገላል መንገድ የመንግሥት ይመስለኛል ይበጅ
በአሁኑ : በንጉሡ የግልና የሐሳብ በሙያተኛው ዋናው
ወቅት : አለመሆናቸውም በዝቶም ያህል እንደተጀመረ እንዳልዘነጋሁ
በእስያ : ባከበረ ባኖረ የሚስተዋሉ ሕጎች ያለውን
በአፍሪካና : መቀየሪያ ምሥራቅ ብዙዎች አሠራር የሚባለው
አሜሪካ : ከፍርድ በነበረው በኋላም የዩናይትድ የሚመሩ
እያደገ : የተለያዩ የኅትመት ተጭኗቸው መርሆ ሚና
የመጣ : በፕላዝማ እንዳለበትም እውነት የሚገባው የተስማሙበት
መሆኑም : ረገድም መውጣቱ የአንባቢውን ቢመዘን ሰጪ
ሊካድ : የሚሉት በድፍረት ችግሩ የመጣ በብዛት
በኢትዮጵያ : የኢትዮጵያን እግዚአብሔርና የሚዛናዊነትና አቅጣጫ ያውም
ኢንዱስትሪ : ዘርፍ ከፈላጭ መዋቅሮችን ለመጠበቅ እዚህ
በጥናት : ምዕራፍ ጎልቶ ነው አገዛዝ ሚና
ተመሥርቶ : ኃላፊዎች ብቻ ያሉ ያለበት ላይ
አፈጻጸም : ተፈጥሮአዊና ይመስለኛል ይበጅ
አለ : ይናገራል ደርሰዋል ስለማይችል ከመጣ የተባለው
ለማለት : ዕይታ ነፃነትን ይበጅ
ያዳግታል : ይሆን ጠየቀ ያነሳሁት አለበት አሉ
ስም : አቀንቃኞች ሚዲያን መለኮታዊነት እንዳልዘነጋሁ *
የኤሌክትሮኒክና : ቀደም እሳቤዎችን አድልኦ መገናኛ ቀዳሚው
መርሆአችን : በክርስትና ትኩረት ልማታዊ የሆነ የጋዜጣ
ቢሉም : በክሶቹ አድራሻቸው በንቃት ብል አበባ
በተግባራቸው : ዓመቱም መርጠው በሕጋዊ አስፈጻሚ የሚጣጣሩትን
የሚጎድላቸው : አለማወቅ ሥራ እንዳልዘነጋሁ ይበጅ
ይበዛል : ተረጋገጠለት ይታወቃል ተቀላቅለዋል ይታወቅልኝ እዚህ
ከላይ : የሚገነባ በመደገፍ ያለውን አገር ሚና
በፈላጭ : እንቅፋቶች አበባ መንግሥትንና የፈላጭ መርሆ
ቆራጭነት : ንጉሣዊ ዘመን ሐሳብበዓለም ግን እዚህ
እንደተብራራው : ጎልቶ ድረስ መንገድ ምርመራ ነው
ወደኋላ : በቋንቋ ገለልተኝነትን መለኮታዊነት ሚዲያ የሚጣጣሩትን
የሚስባቸው : ጎን በዝቶም ያህል እንደቆሙ እንደተጀመረ
አንዳንድ : ከውጭ በአፍሪካም ዋናው ገለልተኝነትንና ግን
ሚዛናዊና : ከየዓይነቱ የአንዳንድ አበባ በሥጋት ዓላማም
ገለልተኛ : የልማትና በከፍተኛ ሚዲያን ከአገዛዙ ለመጠበቅ
የሆኑ : የኅትመት ተጭኗቸው መዋቅሮችን እዚህ *
ቢኖሩም : ሕጎች ሥነ የመሰሉ የፈላጭ አገር
በተጨባጭ : አቋሙ የሚገመተውን የሚያውቅ በኩል እንደሆነ
ጋዘጠኝነትን : የተለየና ብሎ የኅትመትና ያለውን ሚና
ይከተላሉ : በቁጥጥሩ ከአንድ ንድፈ ይታወቅልኝ ሚዛናዊነትን
መደምደም : ይጽፋል ማጋነን እንደተጀመረ ላይ ይበጅ
በእርግጥ : በመሆኑም በንጉሡ መንገድ ዋናው አስፈጻሚ
ብዙዎቹ : የአገሪቱ ግን እዚህ * ይበጅ
የአገራችን : እሱ ያጋለጠውን አካባቢዎችም የሚቆጠሩ ከአገዛዙ
ዘገባ : በሥልጣን እዚህ * ይመስለኛል ይበጅ
ያተኩራሉ : አስቆጥሯል ታይቷል አሉ ይታወቅልኝ *
ካለፈው : ዋነኛ አምባገነናዊ ገለልተኝነትንና * ይመስለኛል
የአሁኑን : እንዳይገቡ ጓደኛን ተስፋ ተመልሶ አስፈጻሚ
መግለጽም : በብዛት አይደለንም መዝለፍ ይበጅ
ይቀናቸዋል : የለውም ከጥር አይገባም ይታያል ስለማይችል
ከልማታዊ : ዜጎች መካብ አክራሪነትና የሚንገታገቱ ሚና
አኳያም : ለብቻው ፀጥታ አቀባይ የሙያው እንደሌለው
በስሜታዊነት : የተለየ በተጠንቀቅ ፍልስፍናው ብዙዎች ዓላማም
አቀራረብ : ይዘቱና አጥፍቷል የእኛ ከማጋለጥ ሊረጋገጥ
የሚመሩ : አሥርት የፌደራሉም ቁጥራቸው እንደሌለው የመንግሥት
አለመሆናቸውም : የሚስባቸው ያህል እንደተጀመረ ላይ ይበጅ
አንፃር : ጋና ማንም ሕዝቦች አሠራር ገለልተኝነትንና
ያልፈተሹትን : እንቅስቃሴም መሣሪያዎቹ እዚህ * ይበጅ
ጉድለት : በሥነ ዘርፍ መርሆዎች የመሰሉ የፈላጭ
ማየት : ስሙና ኃይሎችን ዜና መዋቅሮችን እዚህ
የሚጠቅም : በብዛት ሥራ እንዳልዘነጋሁ ይበጅ
አንደኛው : ከሚል ለዚህም ማጋነን ላይ እዚህ
ለአዲስና : ሆነናል ሳንቲም ናቸው ፍልስፍናዬ በእንግሊዝ
ለምርመራ : በመደገፍ ያለውን አገር ሚና የሚጣጣሩትን
ዘገባዎች : ገድሏል በ#ኛውና አምባገነናዊ * ይመስለኛል
ትኩረት : ሮያል መርሆአችን የጋዜጣ ነው መርሆ
አለመስጠት : እየተጎዳ የተስማሙበት ይበጅ
ጽሑፍ : ነው የሚጣጣሩትን ግን እዚህ *
እንደምንመለከተው : ሐቅን የሕግ ዓለም መሪዎችን ዘመን
በነፃ : መጠኑን እንደሌለ ፖሊሲው መኖር ያለውን
ሲታይ : የሆኑ የኅትመት ተጭኗቸው ምርመራ መዋቅሮችን
የጎላ : አድራሻቸው የለብለብና የሚስተዋሉ ለምርመራ ከላይ
ክፍተት : እንሰጣቸዋለን እንደቆሙ የሚወሰድ እንዳልዘነጋሁ *
ችግሮችን : ይከተሉ አገሪቱ ታይተዋል ይመርጣል ተቋማት
መንስዔአቸውን : አስፈጻሚ የሚጣጣሩትን እዚህ * ይበጅ
ከማጋለጥ : እግዚአብሔርና መጽሐፍ የእንግሊዝ ያውም ይህ
መደባበቅና : ይህም ሚዛናዊነትን እዚህ * ይበጅ
መሸፋፈን : ማወቅ አምርሮ ይበጅ
ይመርጣል : አለባቸው ይታያል ቀብሯል አሳድዷል ቢኖርም
ከሕዝብ : ዋናው ሚና ላይ እዚህ *
ጥቅም : የፍልስፍና ወርዶ ፍልስፍናን ዴሞክራሲያዊ ንድፈ
መከናወን : ፍቅር መሣሪያነታቸውም ሥርዓት የአምባገነን ያለውን
ብርቱ : ሥነ የመሰሉ የፈላጭ የሚባለው እዚህ
ተግባር : ዝግጁ ሰዎች መምጣት ሚዲያው ምግባርና
ቢገለጽም : ወዳጄ መገልገያ ሚዲያ ለመጠበቅ እዚህ
ሊወጣ : አለመሆኑንም በጅምር እየተገኘ እየታየ የሚታበል
አልቻለም : ደርሰዋል ይባላሉ አሉ ይታወቅልኝ እዚህ
በአገሪቱ : ቆራጭነት የሚያስችሉ ዋነኞቹ ንጉሣዊ ግን
ሥራዎች : ነጋሪዎች ስለሆነ ችግሩ ማጋነን በተስተካከለና
ተከናውነዋል : ይመስለኛል ይበጅ
ተስፋ : በመንግሥትና ዘገባ ተመልሶ ይታዩና የፈላጭ
ሰጪ : መባሉ የሚቀርቡ በመቶዎች ሥርዓት ዘመን
ውጤትም : ካሟላ ዛሬ የወጣና ነፃነትና ግን
እየተገኘ : የተስፋፋ በኋላ የሚወሰድ እንዳልዘነጋሁ ይበጅ
በልማቱ : የሆኑ ተጭኗቸው መዋቅሮችን በእንግሊዝ እዚህ
ጉድለቶች : ሲል የፖለቲካ በማያፈናፍን እንደሌለው ሥልጣንን
መኖራቸው : መጽሔቶች ደጋግሞ ሥራ እንዳልዘነጋሁ ይበጅ
አይታበልም : አለበት ተቀላቅለዋል አይደሉም ይታወቅልኝ ይመስለኛል
በግብርና : ዕትም አባቱ የሮማው ከሕዝብ አንደኛው
የተሰማሩ : ለምክር ሌላ በፖለቲካ በመካከለኛው ንድፈ
ባለሀብቶች : ጠቅሶ በአንፃሩ ሳንሱር ዘመን ታሪክ
ለምን : ሲያበቃ ሊተች ያለውን ሚና ላይ
ይቸገራሉ : ጽፈዋል አሳድዷል የመንግሥት ይመስለኛል ይበጅ
በአገራችን : በአሁኑ የሐሳብ ዋናው አስፈጻሚ ንጉሣዊ
የከፋው : ተቸግሮ መዋቅሮችን መርሆ እዚህ ይበጅ
የትራፊክ : የተጠቁት የመንፈስ መውጣቱ መሣሪያዎቹ የሚወርደውን
አደጋ : እየወደድናቸው ያለበት መርሆ ሚዲያ ገለልተኝነትንና
ምክንያቱ : ሌሎችንም በሚዛናዊነት ላይ እዚህ ይመስለኛል
በግልጽ : ሳይንቲስትም በነፃነትና መርሆ ንድፈ የሚጣጣሩትን
ምንድነው : ይገባዋል ይታወቅልኝ * ይመስለኛል ይበጅ
የኢትዮጵያ : ተገቢ ተናጋሪነት ጨምሮ የሙያው ብዙዎች
የሙስና : ብርና በራሳቸው አለማየት ተጭኗቸው ሐሳብበዓለም
ሀብት : በጥልቀት አበባ እንደነበረው ብቻ ፈቅደው
የሚዘርፉ : ድክመትን ከማቅረብ በላይ ያለውን ይህ
የሚባሉ : የሌለበት የተሟላ የሚንገታገቱ የፈላጭ መርሆ
በባለሥልጣናት : ባለሙያዎች እየታየ በኋላ የሚወሰድ *
መኖራቸውስ : ለአባቱና እንደሚሞከርም መገናኛ በአፍሪካ ዋነኛ
ሐሰት : ቁጥር አረጋገጠ በዚህ አምባገነናዊ እዚህ
ክልሎች : ከየዓይነቱ የፓርቲው ሊሸፈን ከአገዛዙ መለኮታዊነት
እየተካሄደ : አያቶቼ ዘገባ ማፅናቱ የብሮድካስት በሥልጣን
ካለው : ዳይፐር ማድረግና ኢንዱስትሪውን መንግሥትና መኖር
የዜጎች : ስለኤሌክትሪክ በመመለስ ቢሉም ብል ልማታዊነት
መፈናቀል : ጥያቄያቸው ማቅረብ ማረጋገጥ ታሪክ ሐሳብበዓለም
ጀርባ : ማንቆለጳጰሳችን መለኮታዊነት የሚጣጣሩትን * ይበጅ
የገቢዎችና : ኢትዮጵያዊያንና የሐሳብ ዋናው ሚና ግን
ጉምሩክ : በፖለቲካ ንድፈ ገለልተኝነትንና እዚህ ይበጅ
ባለሥልጣን : የግል መሣሪያዎቹ የሚጣጣሩትን ግን እዚህ
በሥራው : አጣብቂኝ እዚህ * ይበጅ
እንቅፋቶች : በጳጳሱ በፈላጭ ባይባልም መንግሥትንና የፈላጭ
ምንጫቸው : ሊኖረው ሥራ ይበጅ
ፓርቲዎች : መሣሪያነታቸውም መንግሥትንና ሚና ላይ እዚህ
አለመጠናከር : በአስተሳሰብ መንስዔ ማንም ገድሏል አሜሪካና
መሠረታዊ : ፖለቲካ ኒዮሊብራሊዝም ማረጋገጥ ነው ሐሳብበዓለም
ችግሩ : ነጥቦቻቸውን መሻሻልን ነጋሪዎች እንዳለበት ሊካድ
ምንድንነው : ናት ይገባዋል ይባላሉ መፍረስም ከመጣ
መርሆዎችና : በሄድን ጉልህ ሳንቲም ድምፅና የውጭ
ሕጎች : በጋዜጠኛ እንደሚያደርስ የሚስተዋሉ ቢኖሩም ሁለት
አተገባበር : የቅሬታ ከሙያዊ በገዥው የመሰሉ የሕዝብን
ምን : የሚጠቅም እንዳልዘነጋሁ ይበጅ
የሚሉ : ሥርዓት ነው ሥልጣንን ዘመን ታሪክ
ጥያቄዎችን : ሲወጣ በሥልጣን ሐሳብ ታሪክ አምባገነናዊ
መዝዞ : ስለነበረ ሥርዓቱ ሚዲያ ይታወቅልኝ እዚህ
ደክሞ : ልማታዊ ፍልስፍና የፈላጭ ሚና ላይ
ወጥቶና : በማሰራጨት እንደሚገመት የሚገነባውና ላይ እዚህ
ወርዶ : ተማሪ እንዲሆኑ የተባለውን ተፈጥሮአዊና ጥቅም
ማን : ለማን ማጥናት እንዴት መሆኑን ያህል
መረመረ : አብራርተዋል አይደሉም ይታወቅልኝ ሚዛናዊነትን እዚህ
አረጋገጠ : ይገልጸዋል ይከለክላል መንገድ የመንግሥት አምባገነናዊ
ሁለተኛው : የሐሳብ ዋናው ቀዳሚው አምባገነናዊ የሚጣጣሩትን
የእኛ : በ#ኛው ይህ ላይ እዚህ ይበጅ
የከሸፈ : የመጡት ነው ሥልጣንን ሚዲያ ሐሳብበዓለም
ሚዛናዊነትና : በፈላጭ ብል ፍልስፍና የፈላጭ ዘመን
አጠንክሮ : የአድማጭና አኳያ የሚጋርጥ የፓርቲው የመሰሉ
አለመያዙ : ታስቦ ማድረግ አኳኋን የተስማሙበት ይበጅ
በየትኛውም : በእነዚሁ ይኼውም ሁልጊዜም በሕጋዊ ሲያበቃ
ቢመዘን : ሞዴል ጉድለቶችን ሆነው መለኮታዊነት ታሪክ
አይደለም : ሥርዓቱ ድረስ ሐሳብ ሐሳብበዓለም ይታወቅልኝ
በፆታ : እያገኙ በተስተካከለና አሠራር ላይ ይበጅ
በሃይማኖት : ከተገበረ የተገረመው ተቋማት የሚጋርጥ በገዥው
በቋንቋ : መቀየሪያ ናቸው የፖለቲካ ብዙዎች ሚዲያ
ወዘተ : ሲሠሩ ወገኑማ አይጥለውም መንግሥትን የሚባለው
የሚስተዋሉ : ሊብራሊዝምን ሕጎች በመደገፍ ያለውን በ#ኛው
ተፈጥሮአዊና : አፈጻጸም አውሮፓዊያኑ ይመስለኛል ይበጅ
ሰው : የመያዝና ቢያቀነቅንም ማድረግና አካባቢዎችም ኢንዱስትሪውን
ሠራሽ : ትይዩ ኢንዱስትሪው የለውጥ በተጨማሪ በማያፈናፍን
ብዝኃነቶችን : በሕገ አስፈጻሚ ክፍለ ሚዛናዊነትን ግን
ማስተናገድ : ሊኖረው ይበጅ
ይጠበቅባታል : ጋበዛቸው ለማድረስም የለበትም ናት ይታያል
ከዴሞክራሲ : ባለፈው የአዲስ እንደሌለው ዋነኛ የመንግሥት
እሴት : እጥረት የመረጃ ወደኋላ መገልገያ የውጭ
ከመረጃ : እንደመርግ አሠራር መለኮታዊነት የሚባለው እዚህ
አኳያ : የማይችል ተደርጎ መለኮታዊነት ታሪክ ሐሳብበዓለም
የሚባለውም : እየወደድናቸው ተመሥርተው ውዝግብ ግንኙነት ዓመታት
ጭብጥ : የማለቱን በሥልጣን ይታወቅልኝ እዚህ *
መዘንጋት : ሽብር ጎን እንደቆሙ የሚንገታገቱ እንደተጀመረ
የለበትም : ይታያል ያደርጋል ምርመራ ይታወቅልኝ እዚህ
አሁን : መርሆ ግን እዚህ * ይበጅ
ባለው : እኔ በፊት አሠራር ይህ የሚባለው
እየተስተዋለ : ሲሰጠው የሚስባቸው ጎን አስሯል ላይ
ከተፎካካሪዎች : ተቀባይነት የርዕዮተ መለኮታዊነት ንድፈ የሚጣጣሩትን
ተቃዋሚዎች : ጋዜት ማበብ አቀንቃኞች ሚዲያን ኤርትራን
ሰፊ : የሚደፈቅበት ያለው አፋኝ ያለበት ምርመራ
ሲሰጠው : ሽብር እየተስተዋለ ጎን አስሯል እንደቆሙ
ድብልቅልቅ : ግብና በቋንቋ የፖለቲካ ክፍለ ይህ
እህል : አሳታሚ ካርሎስ የውጭ ያለበት ከአገዛዙ
የሞላበት : በረጅም የተሟላ ያለውን ሚና እዚህ
ጎተራ : ብዙዎች የሕዝብን የሚባለው ንድፈ ሚዛናዊነትን
ይዘነጋና : ከተገመተው ቪክተርና ምርመራ በ#ኛው ይህ
አቅጣጫ : ሽብርተኝነትና የፖለቲካ ሚዲያ የሚጣጣሩትን ገለልተኝነትንና
ያዘነበለ : ጥያቄያቸው ጊኒ ኤመርሰን የሚናገሩ ማረጋገጥ
ድምዳሜን : የሚጠቁም እሴት የውጭ በላቲን ከአገዛዙ
ተናጋሪዎች : ቪክተር ከሌለህ አስፈጻሚና ከፍ የሚወርደውን
ደጋግሞ : ማድረጉ መግለጽም በብዛት የሚታበል የተስማሙበት
ማቅረብ : መፈናቀል ለማረጋገጥ ጎልቶ የጋዜጣ ሐሳብበዓለም
የፍልስፍናው : የኢትዮጵያውያን አማራጭ በማያፈናፍን ጭቁን የዚህ
ሁልጊዜም : ለዚህም በሕጋዊ ሲያበቃ መገናኛ በአፍሪካ
መስተናገድ : ጠቅሶ ዛሬ ባለሀብቶች የኤሌክትሮኒክና ዘመን
የተለየና : ጋዘጠኝነትን ቢሆኑም ብሎ የኅትመትና የሙያው
ይህን : አብረውት አንዳንዶች የነፃነት ከሕዝብ የሐሳብ
ተፈጥሯዊ : ፍልስፍናውን ብዙዎች አሠራር ክፍለ ገለልተኝነትንና
እንደሌለ : በነፃ ያለውን ይህ ላይ እዚህ
አድርጎ : ተጎዳ ይባልና ለመገንባት አስተሳሰባቸው ዓላማም
ተዓማኒነትን : እንደተጀመረ እንዳልዘነጋሁ ላይ እዚህ ይበጅ
ያሳጣል : አስረድተዋል ተደንግጓል አይታበልም ተቀላቅለዋል ያደርጋል
በነገራችን : በመሠረቱ በዚህ በአንፃሩ ነበር የግልና
ብዙኃንን : የሙስና ደግ ተጭኗቸው ምርመራ ነው
በልቅነትና : ብሔራዊ ቢሆኑም ይልቅ በመደገፍ ያለውን
በነፃነት : እንሂድ የሚደፈቅበት አልፈው ሜዳ አፋኝ
መልቀቅ : ሐሜትን ደረጃ ፖሊሲው ይመስለኛል ይበጅ
ለግል : ከሚል ለእውነትና በተስተካከለና እንደሌለው ሚና
ባለሀብቱ : ሕይወታችን ለገበያና ከመጣ ንድፈ አምባገነናዊ
መሣሪያ : ንድፈ ይታወቅልኝ እዚህ * ይበጅ
እንዲሆን : መሆኑን እንደተጀመረ ላይ ይበጅ
ስለዚህ : የአፋልጉን ተሰበረ አንድና አቀባይ ኢሕአዴግ
መንግሥታት : የሚመራባቸውና አስፈጻሚ የሚሰብክና የሚጣጣሩትን እዚህ
በመጠኑ : በሐሰት ቢሆን የሚያፍንና ያለውን ነው
ባለቤት : እንዲባልላቸው እያገዘፉ የሊብራል ባህልን አለመላቀቁ
ሊሆኑ : አይደለንም መዝለፍ ድክመት የተስማሙበት ይበጅ
ይገባል : ዕርዳታ ታስቦ ማድረግ እንዳልዘነጋሁ ይበጅ
አቀንቃኞች : ሚዲያን መለኮታዊነት መርሆ እንዳልዘነጋሁ *
የሚያነሱት : ከሞላ እምነቱ የሚሰብክና ለመጠበቅ እዚህ
ጉዳይ : ሽብርተኝነትና ሚዲያ ሚና የሚጣጣሩትን ገለልተኝነትንና
የኮሙዩኒኬሽን : ደብዳቤ ምርምር ሊያሳውቅ እየተስፋፋ የመናገር
ደኅንነት : ደጋግሞ አስተዳደርና ፍልስፍናን ፍልስፍናው የተስማሙበት
ይኼውም : በእነዚሁ በየትኛውም ኢትዮጵያዊያንና የሐሳብ ዘመን
ድምፃቸው : ኃላፊነት የውጭ ሚዲያ ገለልተኝነትንና ላይ
እንዳይሰማ : የአገሪቱ ፍልስፍና ዘመን ግን እዚህ
የሚታፈኑ : በባህል ስቴትስ ለምርመራ ቃል በመደገፍ
ወገኖችን : የማያይ ናቸው መሪዎችን ሚዛናዊነትን እዚህ
መቀነስ : የግል መሣሪያዎቹ ነው የሚወርደውን መርሆ
ጉዳታቸውና : አይቶት በመከታተያ ገድሏል አሜሪካና በ#ኛውና
ቅሬታቸው : ትራፊኮችንና የግል በመደገፍ አገር የሚጣጣሩትን
ያልተገለጸ : በፖለቲካዊ አሠራር ክፍለ የሚባለው ገለልተኝነትንና
አካላት : ለማጥቆርና የፈላጭ መርሆ ሚና እዚህ
እንዲሰማቸው : አጣብቂኝ መዋቅሮችን የሚጣጣሩትን እዚህ *
ማድረግና : ባለፈ ካለው ሆኑ ግንኙነት ኢንዱስትሪውን
የአገርን : በማተሙ ትምህርት ሀሰትን ጠቃሚና የቅድመ
ማስቀደም : ቅስቀሳና የተሰየሙት ሰፊ ሲታይ ከአገዛዙ
ዋጋው : በሥራው በማስመሰል እዚህ * ይበጅ
ከፍ : አቋም በአሠራር ቢሆን ሐሳብበዓለም ላይ
ያለ : ሲገባው ፍርደኞቹ ቢሆንም ባህልን መነሳትና
ስለሆነ : እንደቆሙ የሚወሰድ ላይ * ይበጅ
የነፃነት : ለማጠቃለል ቀጥሎም አድልኦ ከ#ዎቹ በሕጋዊ
የሊብራል : እያገዘፉ የለውጥ በብዙዎቹ እስከ የዚህ
ሐሳብአሁን : ሊያስደስት ሲገባ ሐሳብበዓለም ሚና ላይ
ኒዮሊብራሊዝም : ቃል ነው አገር ሐሳብበዓለም ሚና
የተባለውን : ሁሉ ተፈጥሮአዊና አስተዳደርና አውሮፓዊያኑ ብሎ
መንግሥትን : ለፍርድ ሲሠሩ በቃላት ወዘተ አሜሪካና
የሚያዳክም : ብዙኀን ያለበት ሚዲያ የሚጣጣሩትን ለመጠበቅ
ጥቅምን : ሲሰጠው እየተስተዋለ በዝቶም ያህል እንደተጀመረ
የሚጎዳና : ተወስኖባቸዋል ልበ ከመጣ አልነበረም ይታወቅልኝ
ሁሉ : የተባለውን አስተዳደርና ሌላ በመካከለኛው ይመስለኛል
ለገበያና : የሚከት የማያይ ባለሀብቱ አለመላቀቁ ከመጣ
ለባለሀብት : አለማየት ሐሳብበዓለም እንዳልዘነጋሁ እዚህ ይበጅ
የሚሰጥ : ፕሮፌሰር አፈጻጸም የራቀ እየታየ የሚገባው
ሲል : ጉድለቶች የፖለቲካ በማያፈናፍን እንደሌለው የፈላጭ
ይገልጸዋል : ከጀመረም አረጋገጠ ይከለክላል ይታገላል መንገድ
ፀረ : በሰነድ በሥጋት ያለውን ዓላማም የአፈና
ልማትና : እንደግ ስነጋገር የተያያዘ ሕዝቦች ንጉሣዊ
ኪራይ : ከማል ሙያዊ በማድረግ አሜሪካና በ#ኛውና
ሰብሳቢ : አምስት አየናቸው የተዛባ የሚንገታገቱ ሚዲያዎችን
ሲልም : ቆራጭነት በመቶዎች በመረጋገጡ ዘመን ሚዛናዊነትን
በድፍረት : ሊካድ ማጋነን ያህል የሚያፍንና እንዳልዘነጋሁ
ይተቸዋል : ይታያል ከመጣ ዴሞክራሲያዊ መሆኑ *
ልቅ : ማዳመጥ ኤርትራን ከአገዛዙ በ#ኛው ይህ
እንዲኖርም : ግንኙነትና ልማታዊነት ዓለም ፈቅደው የፈላጭ
አለመፈለጉ : እንዲሁም ፍልስፍናዬ የአፈና ክፍለ ሚዲያ
ሳይታለም : በማለፍ ሳይሆኑ ሁለት ሊተች ያለውን
የተፈታ : የተስማሙበት ይበጅ
በባለቤትነት : መለኮታዊነት የሚጣጣሩትን እዚህ * ይበጅ
የያዛቸው : የረቡበት ይዘቱና አጠንክሮ የሚያፍንና በመደገፍ
እንደዚያ : አካል መርሆአችን አማራጭ ማፅናቱ በማያፈናፍን
አይችሉም : አይድንም መፍረስም አልነበረም አይደሉም ያደርጋል
ከ# : ለሚፈልግ የርዕዮተ በፖለቲካ ነው መለኮታዊነት
በቅድሚያ : የጋዜጠኛ ሕዝቡ ባይሆንም በሕገ ዓ.ም.
ቀጥሎም : ለማጠቃለል የነፃነት ዋናው ክፍለ አምባገነናዊ
በዩናይትድ : ጦርነት ተቋማት የቅድመ አገዛዝ ንድፈ
ስቴትስ : የሚታፈኑ መንግሥትንና አገር ሚና ላይ
በሌሎችም : አስተሳሰባዊ ቢያቀነቅንም ይታዩና ክፍለ ለመጠበቅ
የተስፋፋ : እየተገኘ አኳኋን የሚወሰድ እንዳልዘነጋሁ *
በምሁራኑ : በረጅም ነፃነት ያለውን በ#ኛው ሚና
ጆን : ይጫወት የሕዝቡ የሚባለው አምባገነናዊ ገለልተኝነትንና
ሚልተን : ተማሪ ትቶት ሰብሳቢዎችና እየታየ ያደርጋል
ሎክ : አይጥለውም አገራዊ ተዓማኒነት የመንግሥት የሚባለው
ሚል : አያቶቼ በማያፈናፍን ቁጥራቸው ክፍለ አምባገነናዊ
እና : ብር የሚንገታገቱ አስፈጻሚ እንደተጀመረ እዚህ
የዩናይትድ : በኩል አሜሪካ የሚለውን ቁጥራቸው ብዙዎች
ፕሬዚዳንት : ዓይነት ለረዥም የሚያበረታታ አቀባይ ሚዲያዎች
በነበሩት : የመሥራትን ሳንቲም ናቸው ንድፈ ሚዛናዊነትን
ቶማስ : መስጠቱ መድረሻ ሁለት በረጅም የመሰሉ
ጀፈርሰን : ራስን በመከታተያ ገድሏል በ#ኛውና የሚባለው
ተቀንቅኖ : ባለመቻላቸው ንጉሣዊ መርሆ ሚና ግን
በፊውዳሊዝም : ብዙ መርሆዎች የጋዜጠኞች አሜሪካና የመሰሉ
መፈራረስና : ሕገ መከናወን ልማድ ባህሪ የአምባገነን
ካፒታሊዝም : ከአንድ ከቅድመ ከሦስት አስተሳሰባቸው *
ማበብ : መቼ ጋዜት ተቃዋሚዎች ቢሆንም ባህልን
ጉልህ : ሶሳይቲ መርሆዎችና ጉድለቶች ጉዳይን ሳንቲም
ተጫውቷል : ይገልጻል ይቀላቀላል ያደርጉባቸዋል ይታገላል ሜዳ
እምነቱ : በጥልቀት ቼክሊስት ሜዳ ተሳትፎ ይህ
ሊያሳውቅ : የጻፋቸውና የሚል ጉዳይ ሽብርተኝነትና እንዳጫወተኝ
ሊያዝናና : መለኪያ ሚዲያ ገለልተኝነትንና ላይ እዚህ
እንደማንኛውም : ያለማንም የፈላጭ በእንግሊዝ ሚዛናዊነትን እዚህ
ሸቀጥ : ዜግነቱ ሊሸፈን ለመጠበቅ እዚህ ይበጅ
ሊነግድ : * ይበጅ
የሚል : ቁጥሩ ጉዳይ ሽብርተኝነትና የሕዝብ ልማታዊ
በዋናነት : ፓርቲ የጋዜጣ እዚህ * ይበጅ
በግል : ዝንባሌና ሊሸፈን አፋኝ ይህ ሚዲያ
መያዝ : መግዣ አባል በክልልና መለኮታዊነት በ#ኛውና
እንዳለበት : በብዛት ሊኖረው መቅረፅ ይበጅ
ነፃና : ጣሪያው ቆመው የራቀ ሰብሳቢዎችና ፍልስፍናን
ከቅድመ : ካፒታሊዝም አስተሳሰባቸው * ይበጅ
ውጪ : ጋዜጠኝነት ሚዛናዊ እንደመርግ ብዙዎች አሠራር
እንደ : ያደረገ መብት መሣሪያነታቸውም ዘመን ታሪክ
አራተኛ : እያለፋቸው አቀፍ ሊተች መንግሥትንና አገር
አካል : እንደዚያ ለዴሞክራሲ አለመላቀቁ ንድፈ ይታወቅልኝ
ከሕግ : ይታዩና የማለቱን መንግሥትና መገልገያ ክፍለ
አስፈጻሚና : ተናጋሪዎች ሐሳብመነሻው ጎልቶ ሚዲያዎችን የሚወርደውን
ሕግ : መቼ የሚንቀሳቀሱ ግንኙነቶችም ባህልን በሥጋት
ተርጓሚ : ስሙና ማየት የተባለው ንጉሣዊ ሐሳብበዓለም
ተደምሮ : የሚመስላቸው አንድና ሚና የሚጣጣሩትን ግን
መታየት : በሚል የፖለቲካ ብዙዎች ሚዲያ ሚና
ይቀነቀናል : ያገኛል ብለዋል ይነገራል * ይበጅ
ገለልተኛና : መሆኑም የጋዜጠኝነት ከመጣ ዘመን እዚህ
እሳቤዎችን : በተያያዘም በሚል መታየት የኤሌክትሮኒክና ኃላፊነት
ቢያቀነቅንም : በሰነድ ሰው ኢንዱስትሪውን የአፈና ክፍለ
ውግንናው : የተጠናከረ ሥርጭት ትችቶች ይልቅ ፖሊሲው
ለሊብራል : አስተሳስሮ ፍቅር የተያያዘ የሚመስላቸው ብቃት
ሥርዓቱና : አቀባይ የሙያው አገዛዝ የሚባለው አምባገነናዊ
ለባለሀብቱ : የ# በማያፈናፍን ቁጥራቸው ብዙዎች አሠራር
የግልም : አብረውት አቅጣጫ ማብቂያ በሥልጣን ክፍለ
ይሁን : አክራሪነትና የልማታዊ ዜጎችን በሙሉ ነፃነትና
የአክሲዮን : እጥረት እሴት ማፅናቱ የብሮድካስት አፋኝ
አልያም : የራሱን የመረጃ ሚዲያ ንድፈ እዚህ
የምዕራቡ : የውጭ ክፍለ ሚዲያ ይታወቅልኝ ገለልተኝነትንና
ከርዕዮተ : በመዘገብና ተጓዦች ተግባራት ሰው በላይ
ሊጋጭ : ሃምሳ ጥፋተኛ ቢበዛም ያሉ የሐሳብ
እንደማይችል : ድንጋጌዎች አደረጃጀት ተቋማቱ ንጉሣዊ ግን
አስመስክሯል : ይባልልን ይገባዋል ይታወቅልኝ * ይመስለኛል
መረጃ : እያበሩ ማድረግ የሚወሰድ እንዳልዘነጋሁ ይበጅ
በሸቀጥነት : ግለሰቦች ጓደኞች እየተስፋፋ አገዛዝ ገለልተኝነትንና
ከቀረበ : ያየ የሚጎዳና በማድረግ ሚዛናዊነትን ይመስለኛል
የሆነውን : ፍልስፍናና ፍለጋዬ እየተስፋፋ መቶ አውሮፓዊያኑ
ካልሆነው : በእንግሊዝ እዚህ * ይበጅ
መርጦ : በላይ ባህል ኢንዱስትሪውን ክፍለ ሚዲያ
የመውሰድ : በኤዲተርነትና ዘመን ግን እዚህ *
የአንባቢውን : መውጣቱ የሚጣጣሩትን እዚህ * ይበጅ
የአድማጭና : ቢያደናግራቸው ዘመቻ አጠንክሮ የፓርቲው ብሎ
የተመልካቹ : እንዳልሆነ ሰብሳቢዎችና ፍልስፍናን ባህሪ የሚወርደውን
መብቱ : ይሻላል አስታወቀ አይታበልም ተከናውነዋል አለበት
በሠለጠነ : ቦታ የሳንሱር በአፍሪካ ዋነኛ አምባገነናዊ
ማኅበረሰብ : በኤዲተርነትና የፈላጭ መርሆ ግን እዚህ
ጠቃሚና : ደሳለኝ ዓይተህ ትኩረት በሚታትር ቃል
ተገቢ : ሥራን መቀባት ተቋማት ወደነበሩበት አገዛዝ
ባለፉት : ካለፉት ወራት በዚህ መንገድ የግልና
ሃያ : ጀርባ መለኮታዊነት ታሪክ * ይበጅ
ከሞላ : ዜና ቼክሊስት እዚህ * ይበጅ
ጎደል : መኮንን ከቀሰመው ሁኔታ ማብቂያ ከአገዛዙ
የዚህን : ግንኙነትና ዋነኞቹ ብለው ግን ላይ
የፍልስፍና : ጥቅም ዴሞክራሲያዊ ንድፈ ይታወቅልኝ ይመስለኛል
ሞዴል : ቢመዘን ጉድለቶችን ሆነው ያለበት መዋቅሮችን
አርዓያ : እርሱን አሜሪካን እንቅፋቶች የአሁኑን መገልገያ
የሚንቀሳቀሱ : እሱ ሕግ ግንኙነቶችም ትንሽ መርሆ
ጋዜጦችና : የሚጓዙ የሕግ የመውሰድ መፈናቀል በኤዲተርነትና
መጽሔቶች : መኖራቸው እንዳልዘነጋሁ ይበጅ
ታይተዋል : ይመርጣል አለባቸው ከመጣ ጨፍልቋል የመንግሥት
በኩል : የሚለውን እንደሆነ ፍልስፍናዬ ቁጥራቸው ብዙዎች
ሊብራሊዝምን : የሚስተዋሉ የተሟላ የሚንገታገቱ ሚና ላይ
እንደፍልሰፍና : ከአሳታሚው ወር ገጽታዎች ብዙዎች አሠራር
በመከተል : ተደርጎ መለኮታዊነት ታሪክ ሐሳብበዓለም የሚጣጣሩትን
የሚያቀነቅኑ : የተሰየሙት ማስቀደም የዓለማችን የልማትና ቀፍድደው
ከዚያ : ተረጋገጠለት መስፋፋት ተቀላቅለዋል ያደርጋል ምርመራ
የመሰላቸውን : እንለወጥ ለዴሞክራሲ ናቸው ንድፈ ይታወቅልኝ
አቋም : በአሠራር ጥረት አሁንም ያለበት አገር
የሚያብጠለጥሉ : እየረቀፁ ልጅ ማካሄዳቸው ባለሙያዎች እንደተጫናቸው
በሌላ : እንዲሰጥባቸው ኃይሎችን ቤቶች ንጉሣዊ እዚህ
የሚዛናዊነትና : ወዳጆች ጎደል ሁኔታ ክፍለ ሚዲያ
የተዓማኒነት : ፍርደኞቹ ሞዛይክነት ዳይፐር ካለው አካባቢዎችም
ፈጥኖ : ውሳኔ የወሰነባቸው በሕገ አስፈጻሚ ከአገዛዙ
መውጣቱ : የአንባቢውን የሚጣጣሩትን እዚህ * ይበጅ
ያለከልካይ : ሜዳ በሥልጣን የሚሰብክና በ#ኛው ይህ
አንባቢያን : የተፈጠሩ ሕዝብ ይታይ የውጭ ክፍለ
ማድረሳቸው : በጋዜጠኛ ባፈቀረ የሚስተዋሉ ጊዜ ያለውን
ሊባል : ብዕሬን መዝለፍ ሊፈርድ ይበጅ
ጉድለታቸው : በእነዚሁ ለዚህ የግልና ዘመን አምባገነናዊ
በአብዛኛው : ይኼን በመረጋገጡ ከመጣ በገዥው የፈላጭ
የሚመስል : የወንጀል ማስፈን መዋቅሮችን በእንግሊዝ እዚህ
ጫፍ : ቢኖርም ቀጣይነት የሚጣጣሩትን እዚህ *
የወጣና : ቆራጮች ዘመን ሐሳብበዓለም የሚጣጣሩትን ግን
የተቀናጀ : ሥልጣንን ንድፈ ይታወቅልኝ ገለልተኝነትንና እዚህ
ዘመቻ : ቢያደናግራቸው ከአንዳንድ የፓርቲው ምርመራ ነው
ማካሄዳቸው : ባለሙያዎች እየታየ የተስማሙበት የሚወሰድ *
እያደነቃቸው : በላይ በሙያተኛው ላይ እዚህ ይመስለኛል
ጅምሮችና : ፍቅር የተያያዘ መሣሪያነታቸውም የአምባገነን ንጉሣዊ
ሥራዎችን : ግራ ሐሳቡ የሞላበት ጣልቃ ብሎ
ጥላሸት : ወገኑማ ለባለሀብቱ አሜሪካ በአፍሪካና በመካከለኛው
መቀባት : እየጠየቁ ተገቢ ነው የሚጣጣሩትን ገለልተኝነትንና
መደበኛ : የነበረው ተዓማኒነት የሙያው የሚባለው ሚና
ሥራቸው : ባለሙያዎች እየታየ የተስማሙበት ይበጅ
ሆኗል : ተጠንቀቅ ፀሐፊውን አልቻለም ይታያል ይታወቅልኝ
ጉዳዩን : መነሻው ለምሳሌ አምባገነናዊ ላይ እዚህ
መርምረው : ሲጠጋው ሊያዝናና ይታይ ገለልተኝነትንና ግን
በሚዛናዊነት : የፍራንኮ ለረዥም ቢሆኑም ትችቶች የኅትመትና
በጥልቀት : እጥረት ሀብት ቢገለጽም ሊሸፈን ሚዲያ
ሠርቶ : በጉብኝታቸው ቁጥራቸው መለኮታዊነት ንድፈ *
ከማቅረብ : የሚንደቀደቅ የተገመቱት ያለው ምግባርና አንድ
የለብለብና : ተብለው እያለፋቸው በሥጋት ሊተች ፍልስፍና
ያልተጨበጠ : ያልተለመደም የሚገነባውና አፋኝ አገር በ#ኛው
ዜና : ምርመራ እዚህ * ይበጅ
በረከተ : መብቱ ሰነባብቷል ይባላሉ ተቀላቅለዋል ያደርጋል
መርዶ : ከመዳፋቸው አጣብቂኝ ኒዮሊብራሊዝም በሚታትር በአዋጅ
ነጋሪዎች : መከራከሪያ ነጥቦቻቸውን መቅረፅ ማጋነን የኅትመትና
እንደሚላቸው : ወጥቶ ከተላቀቀች ጥቅም አይመስለኝም ሌላ
ተሰበረ : ከጽሑፎቹ ለብቻው አቀባይ ይመስለኛል ይበጅ
ሞተ : ባከበረ ባኖረ ለግል ሲያበቃ ያለውን
አንዳንዴም : በኋላም ሙያዊ እንደሆነ የመንግሥት በ#ኛውና
በሰላም : ኤምባሲዎች አለመፈለጉ ካለው ከሆነ በላይ
ጦርነት : ከሚችል በዩናይትድ ተቋማት የሕዝብን ንድፈ
ተቀሰቀሰ : ሕዝቦች ያለውን አሠራር ገለልተኝነትንና ላይ
በማለት : የፌደራሉም ጋዜጠኝነት ማፅናቱ ዓላማም *
ሽብር : ጎን እንደቆሙ ላይ ይበጅ
ይለቃሉ : ይይዛል ይታገላል አሳድዷል የመንግሥት የሚባለው
መካብ : ግለሰቡ ሲያበቃ ኢትዮጵያዊያንና የሐሳብ ሚና
የተፈለገውንም : ከእንግሊዝ ከአገዛዙ ክፍለ በ#ኛውና ሚዲያ
በባዶ : የጉዞ ለባለሀብት ሐሳብበዓለም የሚጣጣሩትን እዚህ
እያገዘፉ : የሊብራል ባለቤት ድምፅና ባህልን ናቸው
ማደናገር : ያህል የተስማሙበት ይበጅ
ተለመደ : ይነገራል ሐሳብ * ይበጅ
የተዛባና : በንቃት በሕጋዊ ዋነኞቹ በአንፃሩ የሐሳብ
ከነፃ : አገናኙን ካለው ኢንዱስትሪውን መንግሥትና ተጭኗቸው
ያፈነገጠ : ጥረት በሥጋት አሁንም ፈቅደው መርሆ
ድርጊትም : ድንጋጌ የተባለው መሆኑ መሪዎችን መርሆ
አለፎ : ሐሳብን አውጪ ብዙኃን ትንሽ መሪዎችን
አልፎ : ከኢትዮጵያ ይኖርባቸዋል * ይበጅ
መተላለፍ : ዕቅድ ፈተና ኃላፊዎች የሥርዓቱ ሥልጣን
የአገር : ለተፈጥሮ ከሙያዊ እዚህ * ይበጅ
መንካት : ምሥራቁ በቀጣዩ ሚዲያዎችን መሆኑ እዚህ
ሲሄድ : መሆናቸው እንሰጣቸዋለን የሚወሰድ እንዳልዘነጋሁ *
ታየ : ተቆጥሯል አልቻለም አይመስለኝም ይመስለኛል ይበጅ
ለማጠቃለል : ቀጥሎም የነፃነት በአንዳንድ የአዲስ ዋናው
የሚመራባቸውና : ትግል መንግሥታት አስፈጻሚ እዚህ *
እያለፋቸው : ሊተች ሊረጋገጥ በመደገፍ አገር ሚና
የመጡት : የሆነ ነው ታሪክ ሐሳብበዓለም ንድፈ
ዋናዎቹ : ይዞ በሥጋት የአገሪቱ ፍልስፍና ከአገዛዙ
ሐሳቦች : ተጭኗቸው እዚህ * ይበጅ
ይመስሉኛል : ተቀጠረ ተጫውቷል ሲባል አሳድዷል የመንግሥት
አንዳንዶች : ይህን ለዚህም ቀዳሚው ሚና ላይ
ከየዓይነቱ : ፍለጋ ሚዛናዊና ከላይ የአንዳንድ ፈቅደው
የሚጠቅማቸውን : መስፋፋት ልማታዊ የጋዜጣ አገር ሚዲያ
ወስደው : የመሥራትን በነበሩት ንድፈ ይታወቅልኝ ሚዛናዊነትን
በራሳቸው : የሙስና አደረጃጀት ተጭኗቸው መርሆ ሚዲያ
ልቦናና : ቅሬታ መቶ ገድሏል የውጭ በ#ኛውና
ታሪካዊ : የተጻፉ ከማለቃቸው የያዘበት የመሰሉ ያለውን
ቃኝተው : የጋዜጠኝነት በላቲን ዛሬም መለኮታዊነት *
መልካም : ሰባት በሕግ በዛሬው በማያፈናፍን የዚህ
ጅምር : ሊረጋገጥ ላይ እዚህ ይበጅ
ያሳዩም : ባለሙያዎች እየታየ የሚወሰድ * ይበጅ
በአፍሪካም : የእውነቴን ዋናው ክፍለ በ#ኛውና አምባገነናዊ
እነ : መጽሔት ከሌለህ ጽሑፍ መሣሪያዎቹ ነው
ጋና : ጋዜጣዊ አንፃር እንደሌለው አሠራር ገለልተኝነትንና
ቦትስዋናና : ጉባዔ ሲገባ ፍለጋ እስከ የውጭ
ደቡብ : የሚመልስ ተሳትፎ የሚሰብክና በ#ኛው ይህ
አፍሪካ : ሊሸፈን ሊረጋገጥ ሁኔታ ሚዲያ የሚጣጣሩትን
የዴሞክራሲና : አደረጃጀት ኤርትራን ያለበት የአምባገነን ሚና
የመረጃ : እሴት ወደኋላ ሚዲያ እዚህ ይበጅ
ቀንዲላቸውን : የ ቢኖርም መዋቅሮችን ሚዛናዊነትን እዚህ
አድርገው : የማይችል ቆራጭ ታሪክ ሐሳብበዓለም የሚጣጣሩትን
እያበሩ : ማድረግ የሚወሰድ እንዳልዘነጋሁ ይበጅ
የደረስንበት : የግል መሣሪያዎቹ ነው ሚና ግን
ክንድ : አቀንቃኞች ሚዲያን መለኮታዊነት መርሆ ሚዛናዊነትን
የበረታበት : ጭብጥ ምሥራቁ የብሮድካስት በሥልጣን ይታወቅልኝ
የግሉ : ተመሳሳይ አሠራር አገር ሚዲያ ገለልተኝነትንና
የኮሰመነባት : መንግሥታዊው በህንድ ነው መርሆ የሚጣጣሩትን
ብሮድካስት : መመርያዎች #ኛ በምሁራኑ ለውጥ ጎልቶ
በፍልስፍና : የኢቦላ በየትኛውም ለዚህ ኢትዮጵያዊያንና አስፈጻሚ
ረገድም : ሰጪ መሆኑም ዛሬም ዘመን ታሪክ
በሊብራሊዝም : ልብን የተያያዘ ብቃት ተቋማቱ እንዳልዘነጋሁ
ልማትን : ለምን ሲያበቃ ሚና ላይ እዚህ
የሚጠየፍና : በኖረ ሙያዊ እንደሆነ በማድረግ የውጭ
ምንም : የማይሰጥ ላይ እዚህ ይበጅ
በጎ : የ ከሙያዊ አስፈጻሚ እዚህ *
የማያይ : ወገኖችን ናቸው ወታደራዊ የሕዝብን ንድፈ
በልማታዊ : የሚመለከታቸው ዴሞክራሲ ተቋማቱ ሥልጣን መንግሥትንና
ዴሞክራሲና : ሙያተኛ የግልና በሥልጣን አስፈጻሚ የሚሰብክና
የሕግ : መንግሥታዊ ማሪዋና ጋዜጦችና በመቶዎች መሪዎችን
የበላይነት : ጅማሬ ተመስገንና ህልውናዬ * ይበጅ
እንዳሉ : የተለየ እንዳይገቡ እንዲኖርም የፈላጭ በእንግሊዝ
የማይመረምር : መለኮታዊነት የሚጣጣሩትን እዚህ * ይበጅ
የተንሸዋረረ : ባህል መነሳትና ኢንዱስትሪውን የውጭ ሚዲያ
ዕይታ : ለማለት ሊኖረው የተቋሙ ይበጅ
ተፈጥሯል : ተጠቀምባቸው እንዴ ያደርጋል ይመስለኛል ይበጅ
ሁሉም : አድልኦ ለዚህም በአንዳንድ ሲያበቃ ዋናው
ከሚያመቸው : በሕገ ነበር ኢትዮጵያዊያንና አስፈጻሚ በ#ኛውና
ቅንጣቢውን : እንደሚጠበቅ መንግሥትንና ሚና ላይ እዚህ
እየገነጠለ : ስም በከፍተኛ ህልውናዬ # መለኮታዊነት
በእውነት : ምዕራፍ ነበሩ ፍልስፍናን ባህሪ ሐሳብበዓለም
የማያሞግስና : በመሆኑ በሕገ አስፈጻሚ በእንግሊዝ እዚህ
የማይተች : እንዲሰጥባቸውና አስፈላጊውን እየወደድናቸው ማየት ድረስ
ቁጥሩ : ሶሳይቲ የሚል ጉድለቶች መርሆአችን የዚህ
ቢበዛም : ኦሮሞነት እሳቤዎችን የሚናገሩባቸው መርጠው ሁኔታ
አድርባይነትና : ያውም በላይ ያለውን ሚና ላይ
አሻጥር : ጎልቶ ቆራጭ ሐሳብበዓለም የሚጣጣሩትን እዚህ
የሚጠልፈው : ተቀባይነት በብዙዎቹ መለኮታዊነት ሥልጣንን የሚጣጣሩትን
አይድንም : ያስቸግራል አይችሉም ይበዛል አሳድዷል አይደሉም
እያየሁና : ወዳጄ ጋር ብል ፈቅደው መንግሥትንና
እየተገነዘብኩ : ቴሌቪዥን ፖሊሲ አቅጣጫ ሥልጣንን ሚዲያ
ከአንዳንድ : ዘመቻ የፓርቲው ሐሳብበዓለም እንዳልዘነጋሁ የሚጣጣሩትን
ሰዎች : ተግባር ሚዲያው በሕገ ሁኔታ ደርግ
ስነጋገር : ጓደኞች እንደግ አገዛዝ ሚና ገለልተኝነትንና
መቼም : ግራ ሐሳቡ ሥራዎችን ፕሮፓጋንዳ የፈላጭ
ሪፖርተር : ለማስገባት አቋም የአንባቢውን ቅሬታቸው የሚገነባ
ሐሳቤን : የሚቆጠሩትም ተነገረ የሚያፍንና ንጉሣዊ ሚና
አይጥለውም : ሎክ ተዓማኒነት የሚባለው አምባገነናዊ እዚህ
በሚል : መታየት ኃላፊነት የፖለቲካ የውጭ ብዙዎች
ብዕሬን : ሊባል መቅረፅ መዝለፍ ሊፈርድ ይበጅ
ያነሳሁት : ያዳግታል አለበት አሉ ይታወቅልኝ እዚህ
ኢንዱስትሪው : እንደሌለው ክፍለ ገለልተኝነትንና ላይ *
በዕውቀትና : ካርሎስ ኢንዱስትሪውን ዕገዳና መገልገያ የውጭ
በአገራዊ : ከማሳየት መርሆዎች የፈላጭ ሚዛናዊነትን እዚህ
አለመመራትና : እንዳይሆን የአገሪቱ ዘመን ግን እዚህ
አለመገንባት : እንዳሳደረባቸው እሱ መንግሥታት መርጠው አስፈጻሚ
ሊያነጋግረን : አጣብቂኝ በሚታትር ያለበት የሚጣጣሩትን ለመጠበቅ
ይባልልን : አስመስክሯል ይገባዋል ይታወቅልኝ * ይመስለኛል
ከአዘጋጁ : ዲ ቤንጃሚን መካብ አክራሪነትና ሲያበቃ
ፀሐፊውን : እነዚህና እንለወጥ ሆኗል የተቀናጀ መፈናቀል
በኢሜል : ቤት በላቲን መሪዎችን የአምባገነን ገለልተኝነትንና
አድራሻቸው : ብል የመሰሉ የፈላጭ የሚጣጣሩትን እዚህ
ማግኘት : ኢኮኖሚያቸው ቫይረስ በኩል ጎተራ እንደሆነ
ይቻላል : ይፈሩ ይገባዋል ይታያል መፍረስም ተቀላቅለዋል
የሮማው : እንግዲህ በአካል በግብርና አ ለእውነትና
ካቶሊክ : ብዙዎች በእንግሊዝ ንድፈ አምባገነናዊ ገለልተኝነትንና
ቤተ : የመያዝና ቢያቀነቅንም በተጨማሪ ኢንዱስትሪውን የአመለካከት
ክርስቲያን : ከሆነና ፔንሲልቫኒያ ከሙያዊ እዚህ *
ጳጳስ : ይበጅ
ከጥር : የለውም ይቀናቸዋል ናት አይገባም በሆነ
በፊሊፒንስ : አንዳንዶች የገቢዎችና ኢትዮጵያዊያንና የሐሳብ ዋናው
የሚያደርጉትን : ምኞት ጽሑፍ ቆራጭነት ልማድ አባልነትና
ጉብኝት : ባለበት መምጣታቸውን ፍራንስ የሚባለውን የተባለው
በማስመልከት : የተለየና ሆኑ መቶ ጊዜ ይህም
ትራፊክ : እያቀያየርን የህሊና ገብነት ዓ.ም. አምባገነናዊ
ፖሊሶች : ጀርባ መለኮታዊነት የሚጣጣሩትን * ይበጅ
ዳይፐር : ካለው ኢንዱስትሪውን መገልገያ መርሆ ሚዲያ
እንዲያደርጉ : ቤትን የሚል አዎንታዊ ሥልጣንን ሚዲያ
ትዕዛዝ : የሚገልጸውን ካለው የሥርዓቱ ተጭኗቸው መዋቅሮችን
እንደተሰጣቸው : በሄድን ግንኙነት መቶ ፍልስፍናው መርሆ
አጃንስ : ለአጃንስ ገዥው ሐሳቡን ዓ.ም. ይህም
ፍራንስ : በመገናኘት የፈላጭ እዚህ * ይበጅ
ፕሬስ : በአቶ ያገኙት ተገቢ ነው አገዛዝ
ዘግቧል : ተወስኖባቸዋል አቅርቦታል ለጠፉ ታይተዋል የሚጎዳና
የተሰጠው : ያለማንም ፈቃድ መሪዎችን መዋቅሮችን የፈላጭ
በጳጳሱ : እንቅፋቶች የሌለበት ባይባልም ነፃነትና መንግሥትንና
ለረዥም : ዓይነት በሚዛናዊነት የኅትመትና የሙያው በመካከለኛው
ሰዓታት : ጉልህ እንደሆነ በእንግሊዝ ክፍለ ሚዛናዊነትን
በሥራ : እንደመርግ ዓላማም መለኮታዊነት እዚህ ይበጅ
ገበታቸው : ከተዘረዘሩት የሚዘርፉ መንገድ ነፃነት የመንግሥት
በተጠንቀቅ : ለ# በስሜታዊነት # ፍልስፍናው ብዙዎች
እንዲገኙ : ፖሊስ የሥርዓቱ መዋቅሮችን በሥልጣን እዚህ
ታስቦ : ማድረግ የተነሳ አኳኋን አይደለንም የሚወሰድ
ዳይፐሩን : አክራሪነትና ቢያንስ ዜጎችን በሙሉ ሚና
ትራፊኮች : ለአጃንስ ገዥው ይልቅ ይህም እዚህ
ሳይሆኑ : ወዲህ መሃላቸው ሁለት አባልነትና ያለውን
የፀጥታ : ስም በከፍተኛ መለኮታዊነት የሚጣጣሩትን ሚዛናዊነትን
አስከባሪዎችም : አስከባሪዎች ማስፈን ፓርቲ ትንሽ መሆኑ
ጭምር : የማለቱን ተጭኗቸው መዋቅሮችን የሚሰብክና ለመጠበቅ
የሚያደርጉ : በተያያዘም ቤት ይታይ ብዙዎች ገለልተኝነትንና
ሲሆን : ከአገዛዙ ክፍለ በ#ኛውና ሚዲያ *
ፀጥታ : ክሶች አሠራር አገር በ#ኛው የሚባለው
አስከባሪዎቹም : ያለፉት ሥራን ዘግቧል ተገቢ ጊዜም
ለተፈጥሮ : የአገር አልፎ የሚመስል ተቃዋሚዎች በሥራው
ጥሪ : በሚናፈስበት ኃይሎችን ማበብ ቢመዘን *
መፀዳጃ : ካቶሊክ ጉድለቶች አለመላቀቁ ብዙዎች የፈላጭ
እንሂድ : የሚዘርፉ ያለው በላይ ብሎ የሙያው
ሳይሉ : ቢታወቅም ለምርመራ ሥነ በእስያም ያለውን
ቦታቸው : ሥርዓቱ ርዕዮተ ተጭኗቸው መዋቅሮችን በእንግሊዝ
ማድረጋቸው : የታተሙት የተዛባ የተባለው የሚወርደውን ቆራጭ
አስፈላጊ : ስለነበረ ጊዜም ሙሉ ዴሞክራሲያዊ ይታወቅልኝ
ሆኖ : የቀረቡት ካለህ የሕዝቡ ሊረጋገጥ በመደገፍ
በመገኘቱ : የሬዲዮ የሚቆጠሩ ሚዲያን እንደመርግ ከአገዛዙ
ጉዳዩ : አባልነትና የተሟላ ሚና የሚጣጣሩትን ላይ
የሚመለከታቸው : ተቋማቱ ብለው ሥልጣን መርሆ ሚና
ኃላፊ : ሊገቡ እንደተጀመረ ይበጅ
ኤመርሰን : ያዘነበለ ብቃት የሚናገሩ ነው ሐሳብበዓለም
ካርሎስ : ቅሬታ ኢንዱስትሪውን ደርግ አገሮች ከአገዛዙ
ለአጃንስ : ገዥው ይልቅ ጊዜ የሚንገታገቱ ይህም
ተናግረዋል : * ይመስለኛል ይበጅ
ዕቅድ : መተላለፍ ኢትዮጵያዊያንና ይህም ግን ላይ
ከጳጳሱ : እየጨመሩ ማስወገድና ጣልቃ መርሆ ሚና
ቀደም : በጻፏቸውና የኤሌክትሮኒክና ልማታዊ የፖለቲካ መንግሥትንና
እንደሚሞከርም : ለአባቱና መኖራቸውስ ነፃ ለምሳሌ በተስተካከለና
አስታውቀው : ለማወቅ የሚታበል የተስማሙበት ይበጅ
ጳጳሱ : በጣት ባይሆንም ኢትዮጵያዊያንና የሐሳብ ዋናው
ከፍተኛ : ጠቅላይ ቆራጭነት ጎልቶ ንጉሣዊ ቆራጭ
አድናቆት : ወገኖችን ናቸው ሥርዓት የሙጭኝ በላቲን
ስለሚሰጣቸው : ለምርመራ በመደገፍ ያለውን አገር ሚና
በጉብኝታቸው : ብሎም የሕዝብን መለኮታዊነት በ#ኛውና የሚጣጣሩትን
ቁጥር : ቀን ይገልጸዋል አረጋገጠ ሐሰት በዚህ
እንደሚጠበቅ : ወዲህ ቅንጣቢውን በአሠራር በረጅም ሚና
የገለጹት : ንድፈ ሚዛናዊነትን እዚህ * ይበጅ
የሕዝቡ : የሚባለው አምባገነናዊ የሚጣጣሩትን * ይበጅ
ብዛት : እንደዚያ ማፅናቱ ሐሳብ ሚዲያ ላይ
ከልክ : መመርያዎች አቀራረብ አፋኝ አገር ይህ
ስለሚችል : አስረድተው መንግሥታት ኃላፊዎችና ቼክሊስት ፈተና
እንሰጣቸዋለን : ክፍተት የሚወሰድ እንዳልዘነጋሁ * ይበጅ
ብለዋል : ይነገራል ሐሳብ * ይበጅ
ትራፊኮችንና : ቅሬታቸው በመቶዎች መሣሪያዎቹ ፈቅደው ያለበት
ኃይሎችን : ማየት መዋቅሮችን እዚህ * ይበጅ
የማስደረግ : ምንዛሪ የተባለው የሚወርደውን የፈላጭ ዘመን
ፕላን : ማረጋገጥ የአምባገነን መለኮታዊነት ታሪክ ሚዲያ
በብዙዎች : መውጣቱ የአክሲዮን ሰፊ ጋዘጠኝነትን እ
ቀልድ : ሊሆኑ መዝለፍ የሚታበል ይበጅ
ታይቷል : ይሆን ይሻላል አሉ በሙያተኛው ይታወቅልኝ
ለትራፊክና : ከዚህም በአመለካከት ዜጎችን በሙሉ ሚዲያዎችን
ለፀጥታ : ሰው ርዕዮተ ኤርትራን ያለበት መለኮታዊነት
አስከባሪዎች : አስከባሪዎችም አልፎ ቤቶች አስተሳሰባቸው ትንሽ
እንደፌዝ : ክፍተት እንደቆሙ የሚወሰድ እንዳልዘነጋሁ ይበጅ
እብድ : ዝዋይ ፕሮፌሰር የፍራንኮ አትምጡብኝ ለረዥም
የሰው : አባልነትና የተሟላ ሚና ግን እዚህ
አኗኗሩ : ወንጀል ባህሪ ሐሳብበዓለም እንዳልዘነጋሁ ላይ
ቢለይ : ሁሉ አንፃር መንስዔ የሚያበረታታ ከሦስት
ሐሳቡ : ሥራዎችን በፈላጭ ዴሞክራሲ የፈላጭ ሚና
ቢመጥቅ : ሕጋዊ ለብሶ ለብሰው ነፃ ጋዜጠኝነት
ቢተኮስ : በሥራው * ይበጅ
ባይመስለው : ቲሸርት ስለነበረም ፕሮፓጋንዳ የዚህ የፈላጭ
ቆሞ : የውጭ ክፍለ ሚዲያ ንድፈ ይታወቅልኝ
መሃላቸው : ፊላደልፊያ ሳይሆኑ አስፈጻሚ የፈላጭ እዚህ
ንግግሩ : የለም ማብቂያ ክፍለ ሚዲያ አምባገነናዊ
ቢከብድ : በተያዘው ያዘነበለ መርሆ የሚጣጣሩትን ግን
ቢያደናግራቸው : ዘመቻ ሊረጋገጥ የሚገነባውና አፋኝ አገር
ይሉታል : ጥበባዊ ነኝ ማግኘት ይባልና ለመገንባት
አፋቸው : ሚዲያው በማድረግ በ#ኛውና ገለልተኝነትንና ላይ
ሀሰትን : መጽሔት የጉዞ ባህሪ ሐሳብበዓለም እዚህ
በጠላ : ሳለ አሠርታት ይጫወት በፊት አሠራር
ሐቅን : መንግሥታዊ የመውሰድ በገዥው ዘመን ሚዛናዊነትን
ባፈቀረ : በጋዜጠኛ እንደሚያደርስ ማድረሳቸው ለምን ያለውን
የውስጠቱን : ወደነበሩበት አገዛዝ ይመስለኛል ይበጅ
በቃላት : ወንጅሏል አሜሪካና የመንግሥት በ#ኛውና የሚባለው
ባኖረ : ባከበረ በተሳሳተ ሕዝቡ የአንድ የኅትመትና
አትምጡብኝ : ጽሑፎች ሎክ የመንግሥት የሚባለው ይመስለኛል
ባለ : እምነቱ ሜዳ ተሳትፎ ነፃነት ይህ
ለብቻው : ከጽሑፎቹ አቀባይ የሙያው በሙሉ አገዛዝ
በኖረ : የሚጠየፍና ሚዲያው እንደሆነ አሠራር ክፍለ
ሐሜትን : የፍራንኮ ትችቶች በረጅም መስተዳድርን የመሰሉ
ሥራን : ተገቢ ተቋማት በብዙዎቹ ነው አገዛዝ
ባከበረ : ሊያስቀጣቸው ሞተ ለሚነገር ያለውን አሠራር
እብድነቱ : ከኋላቀርነት ተጎዳ ይባልና ለመገንባት ገድሏል
ተነገረ : ሐሳቤን ማድረሳቸው ፓርቲዎች ልማድ የሚንገታገቱ
እንበልጽግ : ልበ ከመጣ መንግሥታትም የሙጭኝ ንድፈ
እንደግ : ስነጋገር ጋዘጠኝነትን የሚመስላቸው አንድና ሕዝቦች
እንለወጥ : ተፈጽሞባቸዋል የመሰላቸውን ንድፈ ይታወቅልኝ እዚህ
በባህል : የሚታፈኑ ለምርመራ መሣሪያነታቸውም በፖለቲካ በመደገፍ
በይሉኝታ : ወንጅሏል በቃላት አሜሪካ የሚለውን በመከታተያ
ታስረን : ማስወገድና ጉዳይን ባህል ጣልቃ የፖለቲካ
እንቀመጥ : ምኞትም በእስያ የጋዜጠኞች የመሰሉ በመደገፍ
እንኑር : የአንባቢውን ሁለት የሚያፍንና በመደገፍ የሚጣጣሩትን
እንደየምርጫችን : ስለ አገራዊ በዛሬው ለሚዛናዊነት የመሰሉ
እኛ : ጥሩውን የሚነሳ ፍልስፍናን አገር ይበጅ
እንወስን : ማለት ተጎዳ የመስኩ አሜሪካና ያደርጋል
ሕይወታችን : አይችልም መብት ስለማይችል ከመጣ የተባለው
አይቶት : ጉዳታቸውና ገድሏል አሜሪካና እንደሌለው የመንግሥት
ማንሰምቶት : የሚታፈኑ ሚና ላይ እዚህ ይመስለኛል
ወገኑማ : ጥላሸት አሜሪካ ሚዲያዎች በመካከለኛው የሚባለው
ትቶት : ሊገድብ ፍልስፍናን ቢሆን ነው እንዳልዘነጋሁ
ሸሽቶት : ተቀጥተዋል ይገልጸዋል አሳድዷል መንገድ የመንግሥት
ማለዳ : ቀን ይገልጸዋል አረጋገጠ መንገድ በሥልጣን
አየናቸው : ሰብሳቢ ቢሆኑም የሚንገታገቱ ላይ ይመስለኛል
አሰፋ : ይታረም ስህተት ፕሮፓጋንዳ በመካከለኛው ያደርጋል
ሆረስ : በጉብኝታቸው ወታደራዊ እስከ መለኮታዊነት በ#ኛውና
አሉባልታ : የመረጃና ዕገዳና ጊዜ ዋናው ንጉሣዊ
ክፉኛ : በመመለስ መምጣት በሕገ የአገሪቱ መገልገያ
በሚናፈስበት : ኃይሎችን ሲታይ የሆኑ ተጭኗቸው መዋቅሮችን
የመንፈስ : ጎረቤት ፍልስፍና የፈላጭ ዘመን የሚጣጣሩትን
እርጋታ : የበለጠ አፋኝ ያለውን ሐሳብበዓለም ሚና
እንዳይለይህ : ለማብጠልጠልስ ሚዲያን ትንሽ መለኮታዊነት *
በተድላ : አለማዳመጥ የሚዲያ መዋቅሮችን ይነገራል ሐሳብ
ከመጠን : ድንጋጌዎች የሚሆን ተርጓሚ አደረጃጀት የሚባለውን
ያለፈ : ተቀባይነት ናቸው የርዕዮተ ንድፈ ሚዛናዊነትን
ደስታ : የነበረችውን ንጉሣዊ መርሆ ሚና ግን
እንዳይለውጥህ : ዕድሜ ቀጠሮ ይዘዋወር ሊካድ ሊኖረው
ተጠንቀቅ : ጋበዛቸው ሆኗል ደርሰዋል ያደርጋል ይታወቅልኝ
በሠራው : ቅጽ አፍ ኢሕአዴግ በማድረግ ዋናው
ተጸጽቶ : ለመጠቀም አብረውት የሚፈልገውን ነበር ማብቂያ
ይቅርታ : ጽሑፋዊና ሕጋዊ ጋዜጠኝነት አስተሳሰባቸው ቁጥራቸው
የሚጠይቅ : አገራዊ የሙያው አገዛዝ ይመስለኛል ይበጅ
ሌሎችንም : የተጠቀሱትን ጋዘጠኝነትን ሚና ላይ እዚህ
ዝግጁ : ተግባር መምጣት ሚዲያው ያሉ በ#ኛውና
ጥርጥር : አይደለንም ይበጅ
የለውም : ይቀናቸዋል ናት አይገባም ይታያል ስለማይችል
ከእኔ : ለኦሬንጅ ያሉ የሐሳብ ቀዳሚው ላይ
ግልጽ : የተገመተ ፍልስፍናው ንድፈ ገለልተኝነትንና ይበጅ
ካለህ : ሆኖ አተገባበር ሁለት ሊተች እንደመርግ
ንገረኝ : የመሆን የተፈለገውንም ብቻ ክፍለ በ#ኛውና
ከሌለህ : ፖለቲካ ጎልቶ ሐሳብበዓለም ሚና ላይ
ሐሳቦቼን : የሚያደርጉ ይታይ ገለልተኝነትንና ግን ላይ
ከማከናውናቸው : መልስ ለመፈተሽ እንደመርግ ተሳትፎ የሕዝብን
ተግባራት : መንግሥትና ጊዜ መገለጫ ለመጠበቅ ይበጅ
ዓይተህ : ከአገር ጠቃሚና ነፃነትን እንዳልዘነጋሁ ይበጅ
ተጠቀምባቸው : ያደርጋል ይታወቅልኝ ይመስለኛል ይበጅ
ሞልየር : ዋነኛ ቀዳሚው አምባገነናዊ ገለልተኝነትንና *
ጓደኞቻችንን : በእንግሊዝ እዚህ * ይበጅ
የበለጠ : ከየዓይነቱ አፋኝ ሚዲያ ሚና የሚጣጣሩትን
እየወደድናቸው : አምሐ ያለበት መርሆ የሚጣጣሩትን ገለልተኝነትንና
በሄድን : መርሆዎችና ሳንቲም የፕሬስ የውጭ መሪዎችን
መጠን : አደንዛዥ የሚዲያ መዋቅሮችን እዚህ *
ማንቆለጳጰሳችን : ቁልፍ ጀርባ መለኮታዊነት * ይበጅ
እየቀነሰ : የሚጎድላቸው እንዳይኖር ይበጅ
ይሄዳል : አስረድቷል ጠየቀ ይታወቅልኝ * ይመስለኛል
ንጹህ : ከሳምንታት ለትራፊክና በአመለካከት ዓ.ም. አምባገነናዊ
ፍቅር : መሣሪያነታቸውም ሐሳብበዓለም ሚና ገለልተኝነትንና ላይ
የሚኖረውም : በፍርድ ንባብ የተገረመው የሕዝብን የመንግሥት
ዓይነት : በቡድሂዝምና ለረዥም ፕሬዚዳንት ሁሉ የሚያበረታታ
ስህተት : ሁሉ የተባለውን አስተዳደርና አማራጭ ሌላ
ሲሠሩ : ወዘተ የመንግሥት የሚባለው አምባገነናዊ *
በማረም : የተገመቱት አግባብ ከማቅረብ ምግባርና በሕገ
በይቅርታ : ስሙንም የፈላጭ በእንግሊዝ እዚህ *
ስናልፋቸው : ያህል ይበጅ
ቤንጃሚን : ሆኖም ከአዘጋጁ ሁልጊዜም ሲያበቃ ዋነኞቹ
ፍራንክሊን : ሊብራል ኒዮሊብራሊዝም ቃል አገር ሚዲያ
ጋዜጠኛና : በማተሙ ከፍተኛ ከልማታዊ ልማድ ብለው
ሳይንቲስትም : መቀጮ በግልጽ በነፃነትና ሥርዓት ነው
የነበረው : መደበኛ ተዓማኒነት ያለመዘጋጀት አሠራር የሚባለው
ለአባቱና : መኖራቸውስ ነፃ መገናኛ በአፍሪካ ዋናው
ለእናቱ : በሌላው ሚዛናዊ አስተሳሰባቸው እንደመርግ የአፈና
#ኛ : ለውጥ በረጅም ነፃነት ይህ ይመስለኛል
ልጅ : እንቅረፀው ሥፍራ የመጣ እንደተጫናቸው እንደመርግ
አባቱ : ዕትም ባለፉት በግብርና ከሕዝብ ለዚህ
ድሃ : የቀረበውን ለረዥም መደበኛ መድረሻ አገራዊ
ስለነበረም : ቆይታቸውን ባይመስለው ቁጥር ይገልጸዋል ህንድ
በ# : ግብና በቪዲዮ አነብናቢነት በብዙዎቹ የሚገነባውና
ዓመቱ : ጉድለቶች በብዙዎቹ ናቸው እንደሌለው የዚህ
ፊላደልፊያ : ሊተች ሊረጋገጥ ተሳትፎ አስፈጻሚ የፈላጭ
በሚገኝ : የሚያስችሉ ሊሆን ማረጋገጥ ሐሳብበዓለም የሚጣጣሩትን
ማተሚያ : ሁሉ አስተዳደርና ቢሆኑም የሚታበል ነፃነትን
ተቀጠረ : አሳድዷል አይደሉም የመንግሥት በሥልጣን በእንግሊዝ
ወዲያውኑም : አድልኦ ቀዳሚው አምባገነናዊ የሚጣጣሩትን ላይ
የራሱን : አልያም እንደነበረው ልማታዊ ፈቅደው ሚዲያ
ለማቋቋም : በገዥው አስፈጻሚ የፈላጭ እዚህ *
ስለፈለገ : ቅጣት ጠቃሚ ጨምሮ መንገድ ተደርጎ
ያኔ : የሐሰት ቤት ዛሬም የአምባገነን ንጉሣዊ
አሜሪካን : ዜና መውጣቱ አርዓያ የፈላጭ የሚጣጣሩትን
ትገዛ : ከአገዛዙ ክፍለ ሚዲያ ለመጠበቅ ገለልተኝነትንና
የነበረችውን : ደግ መርሆ ሚና ግን ላይ
የእንግሊዝ : በላይ ሜዳ አፋኝ ይህ እዚህ
የገንዘብ : ድንጋጌ ትራፊኮችንና አለማየት በእንግሊዝ እዚህ
ዕርዳታ : ይገባል ሥራ እንደተጀመረ እንዳልዘነጋሁ ይበጅ
ጠየቀ : ይታወቅልኝ እዚህ * ይመስለኛል ይበጅ
የሚፈልገውን : ነበር ቀዳሚው አምባገነናዊ የሚጣጣሩትን ላይ
ገንዘብ : ጂቡቲ የማለቱን ማብቂያ በሥልጣን ሐሳብ
ሊያገኝ : ሚዲያን የውጭ ያለበት የአፈና ከአገዛዙ
ተረጋገጠለት : ከዚያ ይበዛል ተቀላቅለዋል ይታወቅልኝ እዚህ
ዓላማውን : እንደግ በየትኛውም ጋዘጠኝነትን አንድና ሚና
እግቡ : ዕድሜ ማለፍ ማድረጉ መዝለፍ ይበጅ
ለማድረስም : ተማረከ ቀርተውበታል ይቀናቸዋል ይታያል በሆነ
ለ# : # ብዙዎች መለኮታዊነት * ይበጅ
ወራት : ባለፉት በዚህ መንገድ የግልና ዋናው
በማተሚያ : እንዲያምፅ ጉልህ የልማት እየተስፋፋ ፕሮፓጋንዳ
ተቀጥሮ : ወገኑማ በመካከለኛው የመንግሥት የሚባለው ንድፈ
መሥራት : እንዲነሳ የድጋፍ መቀባት የሚናገሩ የሚጣጣሩትን
እንደሚኖርበት : በመኖር መሻሻልን ሊካድ ማጋነን የሚገባው
ተረዳ : ይቀነቀናል አልነበረም ይነገራል ይታወቅልኝ እዚህ
ከጊዜ : ጉዞአቸውን በዚህም ኢሕአዴግ አምባገነናዊ ሚዛናዊነትን
በኋላም : በነበረው አንዳንዴም አሜሪካ ሙያዊ አሜሪካና
የማተሚያ : እንዳይለይህ ኤርትራን ታሪክ እዚህ *
ገዛና : እንደሚገመት ቪክተርና በእርሱ መንገድ ምርመራ
በመመለስ : ቢገለጽም በንቃት ወዳጄ መገልገያ ፍልስፍና
ፔንሲልቫኒያ : ባቀረበው ለመፍጠር በሥራው መርጠው ከሙያዊ
ጋዜት : ተቃዋሚዎች የከፋው አለማዳመጥ ኤርትራን የሚዲያ
ጋዜጣ : በማያፈናፍን ክፍለ ሚዲያ ገለልተኝነትንና እዚህ
ማሳተም : ተዓማኒነትን አስሯል እንደተጀመረ እንዳልዘነጋሁ ላይ
ጀመረ : እንዲሁ መካከል የሚጎዳና ተጎዳ ሙሉ
የጋዜጣው : የእውነቴን በአፍሪካም ቀጥሎም የአዲስ ዕርምጃ
አዘጋጅም : ይታረም ያልተለመደም ከድህነትና በፖለቲካ ፍልስፍናው
እራሱ : አይችልም አካሄድ አለመላቀቁ ሥልጣንን ንድፈ
ስለነበረ : መዝዞ ናቸው በላቲን ይታወቅልኝ ሚዛናዊነትን
ተቀባይነትና : ይዘቱና በምሁራኑ አቀራረብ ሕዝቡን የተለመደ
የሥራው : በፖለቲካዊ ያልተገለጸ አሜሪካ የቦርድ አሠራር
ተነባቢነት : እንኳን እንዳይጨምር የጎላ ቢሆኑም በመደገፍ
ሆነ : የሚባል አውጪዎችና ጎልቶ ንጉሣዊ የሚጣጣሩትን
ዛሬ : የሚቀርቡ ራሱን ሰጪ በመቶዎች ዘመን
ዩኒቨርሲቲ : እንደሌለ በነፃ በረጅም በላይ የከተሞች
የፔንሲልቫኒያ : ምርመራ በ#ኛው ሚዲያ ላይ እዚህ
ኮሌጅ : ሌላ በመካከለኛው ንድፈ ይመስለኛል ይበጅ
አቋቋመ : ከቫይረሱ እንደሚላቸው ምዕራፍ ሰነባብቷል ይታያል
ላይም : ቴክኖሎጂ አሠራር ክፍለ ገለልተኝነትንና ላይ
ስለኤሌክትሪክ : የዜጎች በፈላጭ ቢሉም ሕዝብ አበባ
ማጥናት : እስራትና ሰሎሞን ፍላጎት ሊባል ሊፈርድ
ዓመቱም : በተግባራቸው በሕጋዊ የሐሳብ ቀዳሚው የሚጣጣሩትን
ሮያል : ቃል የጋዜጣ አገር ሐሳብበዓለም ሚና
ሶሳይቲ : ቁጥሩ ጉድለቶች መርሆአችን የለውጥ በብዙዎቹ
አባል : መያዝ በክልልና # መለኮታዊነት ሐሳብ
የመሆን : ትግል ያቀረባቸውን ገንዘቡን ፌስቡክ ጎደል
አጋጠመው : አስቆጥሯል አልቻለም አሉ የዚህ ይታወቅልኝ
በሳይንስ : ከተባለ ሲከፍት የፀጥታ መንስዔ የሚለውን
መስኩ : የከተሞች ላይ እዚህ ይበጅ
የሚያደርገው : በዛሬው በማያፈናፍን የመንግሥት የፈላጭ በእንግሊዝ
ምርምር : ለጉባዔው ፕላን መፈናቀል ማረጋገጥ ሥልጣንን
እየተሳካ : እንኳን የሚመስላቸው አንድና እየተስፋፋ እንደሌለው
እንደነበረ : በሚችለው እንዲሁም የለውጥ ፍልስፍናው ብዙዎች
ቢታወቅም : በእስያም የመሰሉ ያለውን አገር ይህ
በፖለቲካዊ : ያልተገለጸ አለመጠናከር ገድሏል አሜሪካና አሠራር
እንቅስቃሴም : ያልፈተሹትን የሚያፍንና ያለበት እዚህ ይበጅ
ግንባር : እንዲናወጥ አገራዊ ትችቶች በእስያም የመሰሉ
ይጫወት : ሳለ ጆን አሜሪካ በአፍሪካና አሠራር
ብዙ : የወሰነባቸው በፊውዳሊዝም መልስ የአንድ በሕገ
ነገሮች : ሐሳቡ እንደሚጠበቅ የሞላበት ኮሙዩኒኬሽን ሥነ
በጅምር : ሊወጣ አኳኋን ሥራ ነፃነትን እንዳልዘነጋሁ
ቀርተውበታል : ተማረከ ለማድረስም አይገባም ይታያል የዚህ
በአሜሪካ : ዋነኛ ቀዳሚው አምባገነናዊ * ይበጅ
ሁነኛ : ደሳለኝ በመቆጣጠር ሐሜትን ቶማስ ሌላ
በማድረጉም : የማይመረምር ሰጪ አንድ መለኮታዊነት የሚጣጣሩትን
የአሜሪካ : እንዲነሳ የተያያዘ የሚያስችሉ ቆራጮች ተደርጎ
አብዮታውያንን : ተብሎ መልዕክት መያዝ ድምዳሜን የልማትና
በመወከል : ግለሰብ ከዚያ የማለቱን ተጭኗቸው ከአገዛዙ
ፈረንሳይ : ጎን አስሯል እንደቆሙ ሥልጣን የሚወሰድ
ሄዷል : ይታያል ሥርዓቱ የሆነ ምርመራ ታሪክ
ተልዕኮውም : በሠለጠነ አንዳንድ መገናኛ በአፍሪካ በ#ኛውና
ተሳክቶለት : የመዘገበው የአገራችን አካባቢዎችም ግንኙነቶችም የሚቆጠሩ
ድጋፍ : ማወቅ ሊገቡ ሥራ እንደተጀመረ ይበጅ
አስገኝቷል : ይናገራል በሆነ የቅድመ ቆራጭ ሐሳብበዓለም
ከእንግሊዝ : እንደሆነ ክፍለ ሚዛናዊነትን እዚህ *
ቅኝ : ለምርመራ የጋዜጣ የመሰሉ የሚወርደውን የፈላጭ
ግዛት : ኃላፊነትን አዘጋጅም ተቀሰቀሰ ከድህነትና አውሮፓዊያኑ
ከተላቀቀች : የሚገልጹት እንደሚላቸው የተባለውን ወርዶ ሌላ
በሁለቱም : ሳይታለም በሙሉ ጭቁን በ#ኛው አምባገነናዊ
መካከል : ተፈጽሟል ጀመረ ከሦስት ሙሉ *
ሰላም : ዓቃቤ የምዕራባውያን ከሆነ ሆኑ መነሳትና
ለመፍጠር : ፔንሲልቫኒያ ከሙያዊ በገዥው አስፈጻሚ አምባገነናዊ
አድርጓል : ወጥቶ የተመልካቹ ሁሉ የተባለውን ወርዶ
ተሾመ : በሠለጠነ መኖራቸውስ መገናኛ በአፍሪካ ዋነኛ
ብርሃኑ : የተለመደ የሙያው ሕዝቦች አሠራር በ#ኛው
ከማል : ሙያዊ እንደሆነ ገድሏል በማድረግ የመንግሥት
ታላላቅ : ይኼ እንደመርግ ዋነኛ መለኮታዊነት በ#ኛውና
ጸሐፊዎችና : ዓመታትን እንዲይዙ መሻሻልን ማጋነን እንደመርግ
ጥቅሶቻቸው : ይተቸዋል አለባቸው ይታያል ቀብሯል ይነገራል
የፌስ : ጥያቄዎችን ሊረጋገጥ ብዙዎች በሥልጣን ክፍለ
ቡክ : በፌዴራል ትንሽ መርሆ * ይበጅ
ጓደኛን : የአሁኑን በቀጣዩ ከሆነ ጥቂት ሚዲያዎችን
ፍለጋ : ከየዓይነቱ ሚዲያ ሚና የሚጣጣሩትን እዚህ
ቤልጄማዊው : በመጡበት የአምባገነን ንጉሣዊ መርሆ ሚና
ቪክተር : ብርና ተናጋሪዎች የሙስና የሚወርደውን ሚና
ቫን : በሕግ የተወሰነበትን ቢያደናግራቸው የፍልስፍናው መስፋፋት
ሮዚም : በ#ኛው ይህ የሚጣጣሩትን ላይ እዚህ
ወትሮው : ስሙንም የሃይማኖት በኤዲተርነትና የፈላጭ ሚና
ፌስቡክ : የመሆን ማብቂያ በሥልጣን ክፍለ እዚህ
ሲከፍት : አስተሳሰባቸው * ይበጅ
ኒል : በመንግሥትና ለውጥ ሜዳ እዚህ ይመስለኛል
ዲ : ለማዋል ከአዘጋጁ በሙሉ ያለውን በ#ኛው
ፌቴክ : ለአምስት መኖራቸውስ መገናኛ በአፍሪካ ብዙዎች
ከተባለ : የመሰለውን በሳይንስ የሚጠልፈው ተቀባይነት በላቲን
አሜሪካዊ : ጋር ሊተች የሚሰብክና በ#ኛው ይህ
ወዳጆች : ክፍለ ሚዲያ ገለልተኝነትንና ላይ እዚህ
እንዲሆኑ : የተባለውን ወርዶ የራቀ ሰብሳቢዎችና ብሎ
የሚጠቁም : ድምዳሜን ጉድለትን በከፍተኛ ሚዲያን ከአገዛዙ
መልዕክት : አብዮታውያንን ብዛት ሐሳብ ይታወቅልኝ *
ያገኛል : ይቀነቀናል ይነገራል ሐሳብ * ይበጅ
የ# : ለባለሀብቱ ቁጥራቸው ብዙዎች አሠራር የአፈና
ቪክተርና : ከተገመተው በሥልጣን በ#ኛው ሐሳብ እዚህ
ፍላጎት : ሊፈርድ ይበጅ
የላቸውም : ከጥር ይቀናቸዋል አይገባም በሆነ የቅድመ
ሆኖም : ከሳምንታት በአመለካከት በሙሉ አምባገነናዊ እዚህ
በፌስቡክ : ሕዝቡን ጨምሮ የሚመልስ በፊት አሠራር
ጓደኞች : ስነጋገር በሸቀጥነት የሚመስላቸው አገዛዝ ገለልተኝነትንና
እንደጠየቀው : ባለው አሠራር በ#ኛው ይህ ላይ
ለማወቅ : አስታውቀው መሆን የሚታበል ነፃነትን የተስማሙበት
ስለ : አገራዊ ጊዜም በፊት ብሎ በማያፈናፍን
ፈጽሞ : እንዲሰማቸው ቢኖርም መዋቅሮችን የሚጣጣሩትን እዚህ
የተለያዩ : ጸሐፊ እያደገ የአገሪቱ መርሆ ግን
ባነበበው : ናይጄሪያና የእኛ በሙሉ በ#ኛው ይህ
ተማረከ : ቀርተውበታል ለማድረስም ይቀናቸዋል ናት አይገባም
በአካል : የአዲስ የሳንሱር እንደሌለው ዋናው አምባገነናዊ
መተዋወቅ : ከአውሮፓ ሊረጋገጥ ምሥራቅ አሠራር አገር
እንዳለበትም : የመጣ እውነት የተስማሙበት ይበጅ
ወሰነ : ጠይቀዋል የነበሩት አልነበረም ያደርጋል ይታወቅልኝ
ከፊልም : ለምሳሌ ኢሕአዴግ ዜጎችን በመካከለኛው እንደሌለው
ትምህርት : የሚባሉ የተዛባ ልማድ የተሟላ የፈላጭ
ከተመረቀ : ያጋለጠውን ተግባር የአንድ ምግባርና አንድ
ጓደኛው : ሚዛናዊነትን እዚህ * ይበጅ
ማይል : የጋዜጣው ቀጥሎም የነፃነት የለም ማብቂያ
ተጉዘው : ጉድለቶች የፖለቲካ ፍልስፍናው ብዙዎች ሥልጣንን
ኦስተን : ስለነበረ ወስደው በነበሩት ባለቤት የሚባለውም
ቴክሳስ : ሲያበቃ ለዚህ በሙሉ ሚና ላይ
ገቡ : አስታወቀ ገልጿል አይደሉም በሥልጣን ይታወቅልኝ
ጉዞአቸውን : ከጊዜ በዚህም ኢሕአዴግ አምባገነናዊ ሚዛናዊነትን
በቪዲዮ : ገድሏል እንደሌለው ክፍለ በ#ኛውና አምባገነናዊ
ካሜራ : ቤቱ መሣሪያነታቸውም ሚና ላይ እዚህ
እየረቀፁ : መመንዘር የሚያብጠለጥሉ የሚታበል እንደተጫናቸው የተስማሙበት
ኒልን : እንደማይቀርም ብዕሬን መቅረፅ ማጋነን ካልሆነ
የሚያውቅ : ከእንግሊዝ መንስዔ እንደሆነ የአፈና ክፍለ
አጠያየቁ : ይሻላል ለአንድ ይታገላል ሰነባብቷል ደርሰዋል
የምታውቁ : እንደመርግ አሠራር በ#ኛው ለመጠበቅ ገለልተኝነትንና
አገናኙን : መነሳትና ኢንዱስትሪውን መንግሥትና መገልገያ የውጭ
ፖስተር : ፈረንሳይ ምሁራን እንዴት መሆኑን ባለሙያዎች
ለጠፉ : አቅርቦታል የሚጎዳና ከመጣ አይደሉም በእንግሊዝ
የአፋልጉን : ከፊልም ለምሳሌ ኢሕአዴግ ዜጎችን አገዛዝ
ቲ : እነዚህና መምህር ፀሐፊውን ዴሞክራሲያዊ ንድፈ
ሸርት : በብዙዎቹ ጭቁን እንደሌለው የሚባለው አምባገነናዊ
ለብሰው : አንድ አሠራር በ#ኛውና የሚባለው አምባገነናዊ
ከተማውን : ሊፈርድ የሚገባው የተስማሙበት ይበጅ
ዞሩ : ታውቋል ይታወቃል ያደርጋል ይመስለኛል ይበጅ
የጻፋቸውና : ሊያሳውቅ ለማረጋገጥ የሕዝብ ልማታዊ ነፃነትና
የሚወዳቸውን : በራሳችን ያደረሰው መሣሪያነታቸውም ሐሳብበዓለም እንዳልዘነጋሁ
አካባቢዎች : አይፈቀድለትም ድክመት የተስማሙበት ይበጅ
አሰሱ : ተቀላቅለዋል አልነበረም አይደሉም ያደርጋል ይታወቅልኝ
ከአንድ : በቁጥጥሩ ከሦስት ንድፈ * ይበጅ
ሳምንት : ሆነናል ጽንፈኝነትን ተቀላቅለዋል ያደርጋል ክፍለ
መጽሐፍ : እግዚአብሔርና ወደኋላ የአፈና ይህ ሚዲያ
መደብር : በመቶ የጻፋቸውና ምንም ሊያሳውቅ ለማረጋገጥ
ያገኙት : ተቀጥረው ተገቢ ነው አገዛዝ አገር
አገናኛቸው : ይዶላቸዋል አስታወቀ ይቸገራሉ ጽፈዋል ሰነባብቷል
በቪክተርና : የዴሞክራሲ ለዚህም ዋናው ላይ *
የተገረመው : ምስክርና ያለፈ በብዙዎቹ የሚባለው ንድፈ
ለአንድ : ለጽሑፌ ግላዊ መንገድ እንደሌለው ምርመራ
ወር : እንደፍልሰፍና በቋንቋ ብዙዎች አሠራር ክፍለ
አብረውት : ይህን ማብቂያ የውጭ ክፍለ ሚዲያ
እንዲቆዩ : እስራትና አምርሮ በብዛት ሊፈርድ ይበጅ
ጋበዛቸው : ተረጋገጠለት ተጠንቀቅ ተቀላቅለዋል ይታወቅልኝ እዚህ
ቆይታቸውን : ስለነበረም ለብቻው ይገልጸዋል ይከለክላል አቀባይ
በካሜራቸው : መንስዔአቸውን ሙያተኛ ኃላፊዎች መንገድ አስፈጻሚ
የመዘገበው : ተሳክቶለት ተጎዳ በከፍተኛ አስተሳሰባቸው ዓላማም
ፍለጋዬ : ዓላማና አለመጠናከር ድምፅና ለመገንባት አሜሪካና
መጠኑን : በነፃ ፖሊሲው የተሟላ መኖር ያለውን
ያልተለመደም : ያልተጨበጠ የሚገነባውና በተስተካከለና አፋኝ የሙያው
እኔና : ተጓዦች የሚጠየፍና በሌላው ሚዛናዊ በማድረግ
ጥሩ : ሌሎች ፍልስፍናዬ ፍልስፍናው ብዙዎች ክፍለ
ሆነናል : ተፈጽሞባቸዋል ለአዲስና ናቸው ከመጣ በእንግሊዝ
ለኦሬንጅ : ዝግጁ ተግባር ሚዲያው ያሉ በ#ኛውና
ኒውስ : መሆኑን ይበጅ
ገልጿል : አይደሉም ይታወቅልኝ እዚህ * ይመስለኛል
ራሱን : የሚቀርቡ ዛሬ መርጠው በመቶዎች ንጉሣዊ
ያጋለጠው : ኢትዮጵያ በላይ ደግሞ ጊዜ በ#ኛው
ዕፅ : ሐሳብ ሐሳብበዓለም እንዳልዘነጋሁ እዚህ *
ሻጭ : ዘመን ታሪክ አምባገነናዊ እዚህ *
አደንዛዥ : መጠን የሚዲያ ዓላማም ክፍለ ሐሳብ
አዘዋዋሪዎችን : የአገርን የተዛባ ዴሞክራሲ የሚንገታገቱ ሚዲያዎችን
በቁጥጥር : ደኅንነት አማራጭ ከአገራዊ ያደርጋል ዓላማም
ስር : እስከ ነው * ይመስለኛል ይበጅ
ለማዋል : ሲያበቃ በሙሉ ሚና ግን ላይ
ክትትል : እንዳይኖር እንደተጀመረ እንዳልዘነጋሁ ይበጅ
ያደርጉባቸዋል : ይቀላቀላል ተችሏል ይታገላል አሳድዷል የመንግሥት
አዘዋዋሪዎቹም : ተስፋ ተመልሶ የፈላጭ እዚህ *
ፖሊስ : እንዲገኙ የሥርዓቱ መዋቅሮችን በሥልጣን እዚህ
እጅ : አገሮች ያሉ ያለበት መርሆ የሚጣጣሩትን
እንዳይገቡ : ማሪዋና የአሁኑን መራሹ የፈላጭ በእንግሊዝ
ሲጣጣሩ : መጽሔቶች ሊጤን እንዳልዘነጋሁ ይበጅ
ይስተዋላል : አስመስክሯል ይገባዋል ይታያል ከመጣ እስከ
ከፍሎሪዳ : በፓርቲዎች ወዲያውኑም አድልኦ በተለይ ጠቃሚ
የተሰማው : የሐሰት ኤርትራን የአምባገነን ታሪክ እዚህ
ከተለመደው : ተብሎ መያዝ ድምዳሜን ጉድለትን መለኮታዊነት
ወጣ : በእርሱ ምርመራ ሐሳብ ታሪክ ይታወቅልኝ
ዓመት : ቀናት መመርያ ጥያቄዎችን የብሮድካስት በሥልጣን
አዘዋዋሪ : ፖሊሶች ቆራጮች ካልሆነ በአንፃሩ ፍልስፍና
የሚፈልግ : እንሰጣቸዋለን ክፍተት እንደቆሙ የሚወሰድ ቆራጭ
የእውነቴን : በአፍሪካም በአንዳንድ የአዲስ በአፍሪካ ዋናው
አደገኛ : ቀናት እየተካሄደ ማፅናቱ የብሮድካስት በሥልጣን
ይዣለሁ : አዘጋጅ ሐሳብመነሻው ሐሳብበዓለም ሚና ላይ
ቲሸርት : ባይመስለው ካቶሊክ ጉድለቶች ብዙዎች አምባገነናዊ
ለብሶ : አንድ እንደመርግ መለኮታዊነት በ#ኛውና የሚባለው
ከመደብር : የሚደፈቅበት ያለው መንገድ በ#ኛው ላይ
ይዘዋወር : ሊወጣ የሚታበል ነፃነትን የተስማሙበት የሚወሰድ
ቲሸርቱን : ደግሞ በንጉሡ ኢትዮጵያዊያንና ላይ እዚህ
ያየ : የወሰነባቸው ሚዛናዊነትን እዚህ * ይበጅ
ለጥያቄ : በመዋለድ አባልነትና በመቶዎች ንጉሣዊ ግን
ሲጠጋው : መርምረው በግልጽ በነፃነትና ማረጋገጥ መርሆ
ማሪዋና : እንዳይገቡ ማስፈን ፓርቲ የተባለው መሆኑ
ሊሸጥ : የሚገነባውና በመደገፍ አገር ሚና ላይ
እየተደራደረ : አለመሆኑንም ሊወጣ እየታየ ነፃነትን እንደተጫናቸው
ፖሊሱም : ማለትስ በዚህም ዕርምጃ በአፍሪካ ዋነኛ
ያጋለጠውን : በእያንዳንዱ ከተመረቀ ዝግጁ የአገራችን መምጣት
ወንጀለኛ : በራሳቸው እያደገ ተቋማቱ ሙሉ ተጭኗቸው
ፊት : በጅምር ሊወጣ አኳኋን እንደቆሙ እንዳልዘነጋሁ
አቅርቦታል : ለጠፉ ታይተዋል ከመጣ አሳድዷል የሙጭኝ
የኢቦላ : በፍልስፍና በግብርና ሲያበቃ በሙሉ መንገድ
ቫይረስ : ማግኘት የውጭ ብዙዎች ከአገዛዙ በ#ኛውና
በምዕራብ : እንደነበረው ልማታዊነት ዓለም ሥርዓት ዘመን
ያደረሰው : ፍቅር ቆራጮች ተደርጎ ሐሳብበዓለም የሚጣጣሩትን
የኢኮኖሚ : የአገራችን አካባቢዎችም በክልልና ዓላማም አስፈጻሚ
ኪሳራ : ያለበት መርሆ ሚዲያ ግን እዚህ
ቢልዮን : በተጨማሪም ለማጠቃለል የነፃነት አድልኦ ለዚህ
ዶላር : በቀረቡበት ጆን ነፃ ተዓማኒነት ለምሳሌ
እንደሚገመት : በማሰራጨት ገዛና ወጥቶና መንገድ ሚና
የዓለም : ተፈጻሚነቱም ባኖረ በእስያ ጊዜ በሙሉ
ባንክ : ግንኙነት መቶ የውጭ ገለልተኝነትንና ላይ
አስታወቀ : አስቆጥረዋል ገቡ አይታበልም ተቀላቅለዋል አይደሉም
ባንክን : ተመልሶ በእንግሊዝ እዚህ * ይመስለኛል
ጠቅሶ : ባለሀብቶች በህንድ መለኮታዊነት ዘመን ቀዳሚው
እንደዘገበው : በወረርሽኙ መንግሥታት በኤዲተርነትና የሚጣጣሩትን እዚህ
የተጠቁት : የትራፊክ ማስፈን ቢኖርም ዘመን ታሪክ
ጊኒ : ሆነው የሚናገሩ ያለበት የሚጣጣሩትን ገለልተኝነትንና
ላይቤሪያና : ተቀባይነት በብዙዎቹ ነው የሚጣጣሩትን እዚህ
ሴራሊዮን : ልማታዊ አገር ሚዲያ ሚና ገለልተኝነትንና
ኢኮኖሚያቸው : ማግኘት የሚለውን እንደሆነ ቁጥራቸው ብዙዎች
እየተጎዳ : ማካሄዳቸው አለመስጠት የተስማሙበት ይበጅ
በእነዚሁ : ይኼውም በየትኛውም መነሻው ሲያበቃ ለዚህ
በተያዘው : ሳቢያ ቢከብድ የሚናገሩ የሚጣጣሩትን ላይ
የአወሮፓውያኑ : ያልተለመደም ያልተጨበጠ አውሮፓዊያኑ የሚገነባውና አፋኝ
በሚኖረው : በእጃቸው ቀፍድደው ከአገዛዙ ሚዲያ የሚጣጣሩትን
ዕድገት : የሐሰት የማያይ ወገኖችን እንዳይሆን የሙጭኝ
እንደሚያደርስ : ሕጎች በአሠራር በረጅም ሊተች ያለውን
የተገመተ : ግልጽ አለመፈለጉ የለውጥ ጊዜም ፍልስፍናው
ባለፈው : የሚወጡ እንደሆነ እንደሌለው ክፍለ ገለልተኝነትንና
ከተገመተው : ቪክተርና ምርመራ በሥልጣን የሚሰብክና በ#ኛው
ቢሊዮን : እንደሚገመት ስለነበረም ለማረጋገጥ ሳንሱር የዚህ
መሻሻልን : ዓመታትን ችግሩ መዝለፍ ማጋነን የኅትመትና
አሳይቷል : መርጫለሁ ይቀላቀላል ይለቃሉ አሳድዷል የመንግሥት
ወረርሽኙ : ቦታ የለም መገናኛ በአፍሪካ ብዙዎች
ታይቶባቸው : መሻሻልን በብዛት የኅትመትና ይበጅ
የነበሩት : ማስታወቂያ ወሰነ ተረዳ ተቀላቅለዋል አልነበረም
ማሊ : በሰነድ ቪዛው አቋም ማድረግና ያለበት
ናይጄሪያና : ባነበበው በሙሉ አስፈጻሚ ሚና ላይ
ሴኔጋል : የሚፈቀድለት ርዕዮት ህልውናዬ # ሚዲያን
ከቫይረሱ : አቋቋመ አስፈጻሚና ፕሮፓጋንዳ በሆነ የቅድመ
መሆናቸው : መሄዱ የሚወሰድ እንዳልዘነጋሁ * ይበጅ
የኢቦላን : ዓ.ም. ይህም አስፈጻሚ ሚዛናዊነትን ግን
ሥርጭት : ቢኖሩም የሚንገታገቱ የመሰሉ ያለውን የፈላጭ
በመቆጣጠር : ሌላ የቅድመ አገዛዝ የፈላጭ ንድፈ
ብሎም : በጉብኝታቸው የሕዝብን በ#ኛውና * ይበጅ
በወረርሽኙ : እንደዘገበው መንግሥታት በየትኛውም መርጠው የሐሳብ
ከተጎዱት : በመከተል ጀርባ ያልፈተሹትን ፍልስፍና ታሪክ
ጎረቤት : ሬዲዮና ብል እንደነበረው ፍልስፍና የፈላጭ
እንዳይዛመት : በአብዛኛው ከመጣ የፈላጭ በእንግሊዝ እዚህ
ፖሊሲ : እንደነበረው ሚዲያ የሚጣጣሩትን ለመጠበቅ ገለልተኝነትንና
አውጪዎችና : የተያያዘ ጎልቶ ንጉሣዊ ሚና ላይ
የዕርዳታ : አለመላቀቁ ንድፈ ሚዛናዊነትን ገለልተኝነትንና እዚህ
ሠራተኞች : መናገሩም በማድረጉም አንድ ፍፁም ነበር
ያደረጉት : ጥበብና ማሳወቅና አሜሪካዊ ጋር ሊተች
እገዛ : እየገነጠለ ስም # ሥልጣንን እንዳልዘነጋሁ
በኢኮኖሚው : ድረስ ሐሳብ ይታወቅልኝ * ይመስለኛል
ይደርሳል : ዓመቱ መልካም ጉድለቶች ድምፅና ናቸው
ተብሎ : አባል መያዝ # ከአገዛዙ መለኮታዊነት
የሚገመተውን : እንደሆነ ገድሏል በ#ኛውና የሚባለው አምባገነናዊ
እንዳይጨምር : ምኞትም ሁለት ያለውን ሚና የሚጣጣሩትን
ማገዙንም : ሴኔጋል ስም ሚዲያን ኤርትራን ያለበት
ባንኩ : ዕርዳታ ተዓማኒነትን እንዴት እንደተጀመረ እንዳልዘነጋሁ
ብሔራዊ : የሚስተዋሉ ጣልቃ ዴሞክራሲ በመደገፍ ሚና
ማንኛውም : እንዳለመታደል ቁጥር ዕርምጃ አምባገነናዊ የሚጣጣሩትን
ግለሰብ : የአገርና ዘርፍ ከአገዛዙ የሚሰብክና ክፍለ
ሲገባ : የሚናገሩባቸው ያለበት ነው መርሆ ሚዲያ
ሲወጣ : ጥያቄዎችን በሥልጣን ሐሳብ ሚዲያ እዚህ
የሚችለው : የሚባለውን ተቋማቱ የተባለው ማረጋገጥ መርሆ
ብርና : የሙስና አለማየት የሚወርደውን ሐሳብበዓለም ሚና
ምንዛሪ : የሚጓዙ የማስደረግ የሚወርደውን የፈላጭ ሚና
ማስተካከያ : አዲስ እንደሚጠበቅ እንቅፋቶች ሚዲያዎችን መንግሥትንና
ማድረጉ : አስታውቀው ይበጅ
ታወቀ : ቀርተውበታል ደርሰዋል ይታያል የዚህ ይታወቅልኝ
ከሳምንታት : በአመለካከት ሐሳቡን ባይሆንም ዜጎችን ዓ.ም.
ባወጣው : የሚናገሩ መለኮታዊነት የሚጣጣሩትን * ይበጅ
የማሻሻያ : ሊያስደስት ቃል ሚና ላይ እዚህ
መመርያው : ምስክርና ንባብ መሥራት የሕዝብን መለኮታዊነት
መሠረት : የተጠናከረ የኅትመትና ያለውን ይህ ላይ
የሚገቡም : የሚከት ተቀምጦ እንበልጽግ ከመጣ እስከ
የሚወጡ : ምግባርና ያለውን አሠራር ይህ የሚጣጣሩትን
ተጓዦች : ከርዕዮተ ቢያቀነቅንም የአፈና ክፍለ ይህ
በእጃቸው : ቀፍድደው ያለበት ከአገዛዙ ሚዲያ የሚጣጣሩትን
እንዲይዙ : ይጽፋል በአሠራር ማጋነን ሊተች ሚና
የሚፈቀድላቸው : ጥረት መንግሥትንና ሚና ላይ እዚህ
ብርም : ይነገራል ይታወቅልኝ * ይበጅ
ጭማሪ : ሽብር ጎን እንደቆሙ የሚወሰድ እንደተጀመረ
ከዚህ : ማብቂያ በእንግሊዝ አምባገነናዊ እዚህ ይመስለኛል
መመርያ : ዓመት በአንፃሩ # እንደሌለው ፍልስፍና
የወጣው : ስለነበረም ተናጋሪነት ጭቁን * ይመስለኛል
ከኢትዮጵያ : የሚወራለትን በሥራው እዚህ * ይበጅ
የሚነሳ : እኛ የሚያደርግ ሥርዓት ፍልስፍናን የአምባገነን
ተጓዥ : የራቀ ይመስለኛል ይበጅ
ብር : እና ማጋነን የሚንገታገቱ እንደመርግ አስፈጻሚ
እንዲይዝ : ከሕዝቡ መንግሥትንና ሚና ላይ እዚህ
የሚፈቀድለት : ርዕዮት ህልውናዬ # ዓላማም ሐሳብ
ጂቡቲ : ገንዘብ ዓመታት የማለቱን ማብቂያ ተጭኗቸው
የሚጓዙ : ምንዛሪ የማስደረግ ጋዜጦችና መፈናቀል የተባለው
ይፈቀድላቸዋል : ተረጋገጠለት ይሆናሉ ይችላል ሐሳብ ይታወቅልኝ
በነበረው : በኋላም አሜሪካ ገድሏል የመንግሥት አሠራር
አይፈቀድለትም : አካባቢዎች ሊሆኑ ደጋግሞ ማድረግ ድክመት
ከውጭ : ዋናው አምባገነናዊ ገለልተኝነትንና ላይ እዚህ
በተያያዘም : የሚያደርጉ በብዙዎቹ ሥርዓት ብዙዎች መለኮታዊነት
ኤምባሲዎች : ባለማወቅና በሰላም በላይ ምርመራ ሚዲያ
ተቀጥረው : ያገኙት በጥናት ጎልቶ ነው ሚና
የሚሠሩ : ያለፈ # ብዙዎች የሕዝብን መለኮታዊነት
እንዲሁም : የሦስት እንደነበረ አለመፈለጉ በቋንቋ መንስዔ
ዓውደ : ጉዳይ ሚዛናዊነትና ጣልቃ ልማታዊ የፖለቲካ
ጥናቶችንና : እንደተሰጣቸው ግንኙነት ዴሞክራሲ ሥልጣን መንግሥትንና
ሥልጠናዎችን : የሚለውን ሚዛናዊነትን እዚህ * ይበጅ
ለመሳተፍ : ከአገዛዙ መለኮታዊነት መርሆ የሚጣጣሩትን ለመጠበቅ
ውጭ : ሐሳብአሁን ተጭኗቸው ያለበት ንጉሣዊ ሚዲያ
ግለሰቦች : አውሮፓዊያኑ በተስተካከለና ፍልስፍናው ገለልተኝነትንና ላይ
ሺሕ : ማንሰምቶት ኮሙዩኒኬሽን አልፈው በእስያም ይህ
እንደሚችሉ : እንዲገኝ አስሯል እንደተጀመረ ላይ ይበጅ
ተደንግጓል : ጠየቀ ይታወቅልኝ ሚዛናዊነትን እዚህ ይመስለኛል
ፈቃድ : ማስወገድና ከሆነ ሆኑ እየተከተሉ የአገሪቱ
ለማግኘት : አስከባሪዎች ትንሽ * ይበጅ
ግለሰቦቹ : የዘለቀውን የከፋው ውስጥ በመቶዎች መዋቅሮችን
የድጋፍ : እንዲነሳ የሚናገሩ ያለበት የሚጣጣሩትን እዚህ
ደብዳቤ : አንስተን ጥያቄያቸው ማረጋገጥ የሚወርደውን ሥልጣንን
ከቀጣሪዎቻቸውና : ለሕገ በንቃት እንዳይሆን ሚዲያን መሪዎችን
ሥልጠናውን : የፓርቲው አሁንም ሊተች የሚሰብክና ሐሳብበዓለም
ከሚያዘጋጀው : የላይኛው የተመልካቹ ድህነት ሰብሳቢዎችና በፖለቲካ
ማቅረብና : ሬዲዮና አስተሳሰብ ልማታዊነት የፈላጭ ዘመን
አስፈላጊውን : የዘለቀውን የሚባል የማይተች ያለበት ንጉሣዊ
የባንክ : እንዲታተሙ እየወደድናቸው አደጋ የአምባገነን እንዳልዘነጋሁ
ማለፍ : መዝለፍ ይበጅ
ጣሪያው : በእስልምና ነፃና የራቀ አፋኝ መገለጫ
በተጨማሪም : ቢልዮን ሁሉም አድልኦ ሲያበቃ ለዚህ
ዜግነቱ : ሸቀጥ የሚሰብክና ለመጠበቅ እዚህ ይበጅ
ኢትዮጵያዊ : ነው ሐሳብበዓለም የሚጣጣሩትን ላይ እዚህ
ነዋሪ : አስፈላጊ የአምባገነን ሚዲያ ንድፈ ይታወቅልኝ
ይዞ : የአገሪቱ ፍልስፍና መርሆ የሚጣጣሩትን ግን
ከገባ : ተጠሪነቱ ፕሮፓጋንዳ አልፈው በተስተካከለና ሥልጣን
ቀናት : ዓመት ዘገባ የብሮድካስት በሥልጣን አስፈጻሚ
በእጅ : ገንዘብ የማለቱን ተጭኗቸው በሥልጣን ሐሳብ
እንዲገኝ : እንደሚችሉ አስሯል የሚንገታገቱ ሥልጣን እንደተጀመረ
አይፈቅድም : ማድረግ እንዴ ይነገራል ይበጅ
ከማለቃቸው : አመሐ ታሪካዊ መድረሻ ትውልድ መልስ
ለሚመለከተው : ሒሶች መለኮታዊነት * ይበጅ
ማሳወቅና : አሜሪካዊ የእኛ ጋር የሚሰብክና በ#ኛው
ምንዛሪውን : ሐሳብመነሻው የሚወርደውን ቆራጭ ሐሳብበዓለም ላይ
ሕጋዊ : ቢመጥቅ ጋዜጠኝነት በ#ኛውና አምባገነናዊ *
በሆኑ : የሚሆን አዲስ ዋና የሚወርደውን ሐሳብበዓለም
መቀየሪያ : የይግባኝ በቋንቋ በማያፈናፍን ብዙዎች አሠራር
ቢሮዎች : የአወሮፓውያኑ የሚገነባውና በተስተካከለና አገር ሚና
መመንዘር : እየረቀፁ የሚታበል የተስማሙበት አሠራር ይበጅ
መጠኑ : ሕዝቦች ገለልተኝነትንና ላይ እዚህ ይበጅ
በታች : በአፍሪካም አንዳንድ በተጨማሪ ዋናው ክፍለ
ከሆነና : የወሰነባቸው ክርስቲያን ፈጥኖ ከሙያዊ በሕገ
ግለሰቡ : ሲያበቃ ለዚህ ቀዳሚው ሚና ላይ
የጉዞ : በባዶ ሐሳብበዓለም እዚህ * ይበጅ
ካሟላ : ውጤትም የሌለበት ካልሆነ ነፃነትና ፍልስፍና
ገንዘቡን : መንግሥታት ይታዩና ክፍለ በ#ኛው እዚህ
ቪዛው : ይዞ የአገሪቱ መዋቅሮችን መርሆ ሚዲያ
እስከሚያገለግልበት : ምሥራቁ ሊሆን ማፅናቱ የሚወርደውን እዚህ
አዲስ : የሚችሉትን በሆኑ ማስተካከያ ወጥቶና ለማረጋገጥ
የነበሩበትን : በሚል መታየት ጉድለቶች ተቀባይነት ብዙዎች
መመርያዎች : ከልክ ብሮድካስት በረጅም የኅትመትና የሚያፍንና
የሻረ : ባህል መቶ የውጭ ፍልስፍናው ክፍለ
ተፈጻሚነቱም : በጋዜጠኛ ባከበረ ባፈቀረ ያለውን ሚና
አገሪቱ : ችግሮችን ተቋማት ወደነበሩበት ዛሬም የሕዝብን
በቅርቡ : ማንቆለጳጰሳችን መለኮታዊነት * ይበጅ
ካስተዋወቀችው : በምሁራኑ መልቀቅ በነፃ በጥናት ደረጃ
በመቶ : በማሰራጨት መደብር ሌሎችንም ሚና ላይ
የምንዛሪ : ያቀረበ ቢመጥቅ ጆን ጋዜጠኝነት በ#ኛውና
ተመን : ፍርደኞቹ ውዝግብ ባህልን የሚዲያ መዋቅሮችን
አብሮ : የሚባል ውስጥ በመቶዎች ቀጣይነት ንጉሣዊ
እንኳን : አውሮፓዊያኑ የሚገነባውና በተስተካከለና የሙያው አገር
የሚችሉትን : ዘውግ አዲስ በሆኑ ብርና ወጥቶና
ያደረገ : እንደ ተቋማት በሆነ መሣሪያነታቸውም ሥርዓት
ነባራዊ : መገለልና በማያፈናፍን ፍልስፍናው አሠራር ክፍለ
ግባ : መግዣ መያዝ በክልልና ብቻ ከአገዛዙ
የሚባል : ንጉሣዊ ሚና የሚጣጣሩትን ላይ እዚህ
ከባንኮች : ጋር ሊተች በመደገፍ የሚሰብክና አገር
እያገኙ : ዝንባሌና በእስልምና ቆመው የሚገነባውና አሠራር
እንዳልሆነ : የተመልካቹ በፖለቲካ ፍልስፍናን ነው የሚወርደውን
ተችሏል : ያስቸግራል የሚያውቁት ያደርጉባቸዋል ይታገላል አሳድዷል
ከዚህም : ቴክኒካዊ ለትራፊክና በአመለካከት ቢያንስ ዜጎችን
ባንኮች : በሥራው ከሙያዊ መሀል መርሆ እዚህ
ባጋጠማቸው : የፔንሲልቫኒያ የከተሞች ነፃነት ምርመራ የሚሰብክና
እጥረት : የአክሲዮን እሴት ሊሸፈን መገልገያ የአፈና
ሳቢያ : በተያዘው የሚናገሩ ያለበት የሚጣጣሩትን እዚህ
አዳዲስ : እንደነበረው ልማታዊነት መርሆ ሚዲያ እዚህ
ፋብሪካዎች : መላክ ማፅናቱ ብቻ ዓላማም ሐሳብ
እያቋቋሙ : በጥናት ምዕራፍ አልፈው ብሎ አፋኝ
ለጥሬ : እንዳይጠቀሙ ፍፁም ርዕዮተ የአፈና ከአገዛዙ
ዕቃ : ሥር ውስጥ መንገድ የሚጣጣሩትን እዚህ
መግዣ : መያዝ በክልልና ከአገዛዙ መለኮታዊነት በ#ኛውና
የሚሆን : በሆኑ ዋና የተባለው የሚወርደውን ሐሳብበዓለም
ባለመቻላቸው : መርሆ ሚና የሚጣጣሩትን ግን ላይ
የፍራንኮ : ሐሜትን በሚዛናዊነት ትችቶች ሌላ የመሰሉ
ቫሉታ : ስሙንም ጓደኛው አሜሪካን ሲልም ሚዛናዊነትን
ተጠቅመው : በሕገ አስፈጻሚ ሚዛናዊነትን እዚህ *
ለማስገባት : ሪፖርተር ከፍ በአሠራር ጋር የግል
እየጠየቁ : መቀባት ተገቢ ኒዮሊብራሊዝም በአፍሪካና የሙያው
መሆናቸውን : ማረጋገጥ መርሆ ሚዲያ ሚና እዚህ
ታውቋል : ይታወቃል ያደርጋል ይመስለኛል ይበጅ
ፍራንኮ : የዜጎች የሚባለውን የፈላጭ ሚና እዚህ
ለመጠቀም : ተጸጽቶ እንዳይሆን መርጠው ሁኔታ መለኮታዊነት
የሚቀርቡ : ሰጪ ውስጥ በመቶዎች የአገሪቱ ያለበት
ጥያቄዎች : አድርባይነትና በአሠራር ያለውን ሚና እዚህ
እየጨመሩ : ከጳጳሱ መርሆ ሚና ግን ላይ
መምጣታቸውን : ተፈጥረው መሪዎችን የፈላጭ በእንግሊዝ ሚዛናዊነትን
ያነጋገራቸው : ምስክርና አምሐ ሰፊ ማፅናቱ የሚጣጣሩትን
አረጋግጠዋል : ይቀናቸዋል ናት ይኖርባቸዋል አይገባም ይባላሉ
ስታስበው : ተብለው ከባንኮች በመመለስ በሥጋት ኃላፊዎች
ኢትዮጵያ : ያጋለጠው በላይ ደግሞ ያለውን ይህ
ተቀምጦ : ስለነበረ እያገዘፉ እስከ የሙጭኝ በላቲን
እኔ : ባለው አገራዊ በፊት ምሥራቅ አሠራር
የትግራይ : እኔ ቫን አገራዊ ብሎ የሙያው
ነኝ : ጥበባዊ ይሉታል ገድሏል በ#ኛውና *
አማራ : የራቀ አሠራር በ#ኛው ገለልተኝነትንና ይመስለኛል
አፍ : ኢሕአዴግ የመንግሥት አምባገነናዊ ሚዛናዊነትን እዚህ
ሞልቶ : ጋዜጠኛ ዘመን ሐሳብበዓለም እዚህ *
መናገሩም : ሠራተኞች ገጽታዎች አንድ ፍፁም ብዙዎች
አለማወቅ : ሥራ እንዳልዘነጋሁ ይበጅ
በሴት : የምናየው የሳንሱር በአፍሪካ ዋነኛ ዋናው
አያቶቻችን : ለማቋቋም ከሙያዊ በገዥው አስፈጻሚ እዚህ
በራፍ : ያልተጨበጠ በግል በምሁራኑ አቀራረብ አፋኝ
እንዳለፈ : በመጠየቅ ጆን የቦርድ አሠራር የሚባለው
ስንቶቻችን : እንለወጥ የገለጹት ፀሐፊውን የተቀናጀ የሆነ
ነን : ምንጫቸው ሊኖረው ደጋፊነት ሥራ ይበጅ
የምናውቀው : የሚያውቁት ያደርጉባቸዋል ይቸገራሉ መመለስና አይደሉም
የእኔን : መስተዳድርን ጎልቶ ለዚህ ሚዲያዎችን የዚህ
ኦሮሞነት : እንዲነሳ ቢበዛም መርጠው ፍልስፍና የሚጣጣሩትን
እግዚአብሔርና : ከማጋለጥ ያውም ተሳትፎ የአፈና ይህ
የሴት : መቀጮ ጉምሩክ ትኩረት መርሆአችን በፖለቲካ
አያቶቼ : የሚጠልፈው ማጣትንም የፌደራሉም ቁጥራቸው ከአገዛዙ
የሚያውቁት : ያስቸግራል ተችሏል አስታወቀ አሳድዷል አይደሉም
የሁሉንም : ማጋነን ያህል እንደቆሙ የሚንገታገቱ ዋነኛ
እንዲሁ : ጀመረ ጠየቀ ታየ ተጎዳ ሙሉ
ጦር : የኢቦላን ዓ.ም. ይህም ሚዛናዊነትን እዚህ
ባለፈ : ማድረግና ካለው ውዝግብ ኢንዱስትሪውን ደግሞ
በመዋለድ : የሚቀርቡ ራሱን ንጉሣዊ ግን እዚህ
በንግድ : ኃላፊዎች ዕገዳና የአገሪቱ ሚና ግን
በመገናኘት : ትራፊኮችንና መርሆ እዚህ * ይበጅ
ተቸግሮ : አጣብቂኝ የከፋው ያለበት መርሆ የሚጣጣሩትን
ከአገር : ዓይተህ ሥራ እየታየ እንዳልዘነጋሁ ይበጅ
ወጥቶ : እንደሚላቸው ጥቅም አይመስለኝም ፕሮፓጋንዳ ነበሩ
ቦታ : ዕርምጃ በአፍሪካ አምባገነናዊ ገለልተኝነትንና እዚህ
በመኖር : መውሰድ ሊፈርድ የሚገባው ይበጅ
ይቀላቀላል : ይገልጻል ያደርጉባቸዋል ተጫውቷል ይታገላል አሳድዷል
ዕውቁ : በመንግሥቱ ከእኔ በቅድሚያ የገቢዎችና ያሉ
ገጣሚና : ሳይደረግ ጓደኛን ጥቂት መዋቅሮችን በእንግሊዝ
ጸሐፊ : የተለያዩ የሚንቀሳቀሱ ግን እዚህ *
መምህር : ቲ የጋዜጠኝነት ሥርዓት የአምባገነን ንድፈ
ሰለሞን : ጋዘጠኝነትን አንድና የሙያው አገዛዝ ሚና
ዴሬሳ : አይጥለውም ሎክ የመንግሥት የሚባለው አምባገነናዊ
ከሪፖርተር : ስለኤሌክትሪክ ውዝግብ ገዥው ዓ.ም. ይህም
መጽሔት : ሀሰትን እነ ለውጥ መስተዳድርን ጎልቶ
ቆይታ : ለትችት ጋር ያለውን አገር ሚና
የኢትዮጵያውያን : ሰባት ሊያስከትል በሕግ የፍልስፍናው በአፍሪካና
ኅብረ : ነዋሪ መዝዞ በነፃነትና የሆነ ሚዲያን
ብሔራዊነት : አስተሳሰብ የሚጣጣሩትን ግን ላይ እዚህ
የኢትዮጵያን : እግዚአብሔርና ምግባርና ፍፁም ሁኔታ የአፈና
ሞዛይክነት : ፍርደኞቹ የተዓማኒነት ኤርትራን መርሆ ለመጠበቅ
ያመሰጠረበት : የሚታፈኑ ብሎ የጋዜጣ የሚወርደውን አገር
አገላለጹ : ነፃነትን የተስማሙበት የሚወሰድ ይበጅ
በሥነ : ሥነ የፈላጭ ክፍለ ይህ ለመጠበቅ
ጽሑፍና : እኔና የሚጠየፍና ሚዲያው የአመለካከት በማድረግ
ግጥም : በቃላት የሚጠየፍና ሙያዊ ቢረጋገጥም ገድሏል
ጥበብና : በፌስቡክ ሕዝቡን ጨምሮ በፊት በመደገፍ
ቴክኖሎጂ : ላይም ጊዜም ገለልተኝነትንና ላይ እዚህ
ክህነቱ : ስለሚሰጣቸው በእስያም የመሰሉ አገር ለመጠበቅ
ተጠባቢነቱ : የሆኑት የመስኩ መቶ የአመለካከት ፍልስፍናው
ሥፍራ : እንቅረፀው ልጅ ደጋፊነት የሚታበል የተስማሙበት
ነበረው : የላቸውም ይቀናቸዋል አይገባም የቅድመ አገዛዝ
ሰሎሞን : ማጋነን ላይ * ይበጅ
ደሬሳ : ይይዛል ይለቃሉ ተጫውቷል ጽፈዋል የመንግሥት
ለአምስት : ለምሳሌ መገናኛ በአፍሪካ ዋናው አምባገነናዊ
አሠርታት : በፊት አሠራር አገር ይህ የሚባለው
ጥበባዊ : ይሉታል ገድሏል አሜሪካና ክፍለ በ#ኛውና
ጽሑፋዊና : ይቅርታ ጋዜጠኝነት አስተሳሰባቸው ቁጥራቸው አሜሪካና
ጋዜጣዊ : ጋና የሚመሩ የክልል እንደሌለው አሠራር
አበርክቶው : ገለልተኝነት መፈናቀል ለማረጋገጥ ብቃት መሣሪያነታቸውም
ትይዩ : በመጠየቅ ሠራሽ መገለልና አሠራር ገለልተኝነትንና
በተካነበት : ጉዳይን የጋዜጣ አገር ሚና ላይ
የምሥራቅ : የሆኑት እብድነቱ ልቦናና ያልተገለጸ ከኋላቀርነት
ኦሬንታል : መስጠቱ ብርቱ የተሟላ የመሰሉ ቀጣይነት
በጠሊቅ : ስለ ይጫወት በአፍሪካና የሚያበረታታ ሚዲያዎች
ንባብ : የማይመረምር ተቀባይነት የሚናገሩ የርዕዮተ የሕዝብን
ከቀሰመው : ኢንዱስትሪውን ሁኔታ ደርግ አገሮች ያለበት
የምዕራባውያን : ሥልጣኔ ሆኑ ጊዜ ብዙኃን ይህም
አስተሳስሮ : የሚመስላቸው ሕዝቦች አገዛዝ ገለልተኝነትንና ላይ
ሚኔሶታ : ተብለው አድርባይነትና በሥጋት ክፍለ በ#ኛው
በአይሁድ : እየጠየቁ ለምክር በፖለቲካ የሙያው በመካከለኛው
በክርስትና : በቋንቋ መርሆአችን ናቸው ፍልስፍናው ብዙዎች
በእስልምና : ጣሪያው ነፃና አፋኝ በመደገፍ አገር
በቡድሂዝምና : ዓይነት ለረዥም ሁሉ አገራዊ በመካከለኛው
በሌሎች : የአመለካከት ደርግ እንደመርግ ከአገዛዙ በ#ኛውና
ሃይማኖቶች : ሜዳ በሥልጣን አስፈጻሚ በእንግሊዝ እዚህ
የሃይማኖት : ወትሮው የፈላጭ መርሆ ሚና እዚህ
ንፅፅር : ልማታዊነት ፈቅደው መሪዎችን ሚዲያ ሚዛናዊነትን
ኮምፓራቲቭ : የተያያዘ ልማድ ሙያና ሚና የሚጣጣሩትን
ሪሊጂን : ገዥው ምሳሌ የመጻፍ መቶ ሙሉ
ፕሮፌሰር : የሚሰጥ አፈጻጸም የሚያበረታታ አገራዊ ይመስለኛል
ሲሠራ : ማድረግና የአገሪቱ ብለው ያለውን ሚና
ቆይቷል : ተቀጥተዋል ይገልጸዋል አሳድዷል የመንግሥት በሥልጣን
ተማሪ : የተባለውን ወርዶ ሰብሳቢዎችና አውሮፓዊያኑ ፍልስፍናን
ሳለ : ይጫወት በጠላ አሜሪካ በፊት አሠራር
ደሳለኝ : መቀባት የመሰሉ ያለውን ነው የፈላጭ
በጠበቃው : አቀባይ የሙያው ጭቁን እንደሌለው አሠራር
በአቶ : ያገኙት ፕሬስ ተገቢ ነው አገዛዝ
አምሐ : ምግባሮች እየወደድናቸው ከአገዛዙ መለኮታዊነት በ#ኛውና
መኮንን : ጎደል መምጣት ቅሬታ ዋናው ክፍለ
አማካይነት : ይታዩና የአፈና ክፍለ እዚህ ይበጅ
በፌዴራል : ሥልጣኔ በማስመሰል የአመለካከት መርሆ እዚህ
ጠቅላይ : ከፍተኛ አስፈጻሚና ቆራጭነት ጎልቶ ቆራጭ
ፍርድ : ህንድ የመንግሥት አምባገነናዊ * ይመስለኛል
ባቀረበው : ፔንሲልቫኒያ መርጠው አንድ እንደመርግ መለኮታዊነት
ይግባኝ : አቀራረብ ነፃነት በ#ኛው ይህ የሚባለው
ክርክሩን : የኤሌክትሮኒክና አድልኦ መገናኛ በአፍሪካ ቀዳሚው
አደረገ : ካሰሙ አሰሱ ተረጋገጠለት ተጫውቷል ይበዛል
የተከታተለው : ማስተዋል መተዋወቅ አቅጣጫ የፖለቲካ አሠራር
የተወሰነበትን : የአወሮፓውያኑ ቢያደናግራቸው የአድማጭና የሚገነባውና የመሰሉ
የሦስት : እንዲሁም ለባለሀብቱ በማያፈናፍን ቁጥራቸው ፍልስፍናው
የእስራት : የወሰነባቸው እንደሆነ ቁጥራቸው አሜሪካና የፈላጭ
ቅጣት : ጠቃሚ ጨምሮ አንድ ነበር ተደርጎ
እየፈጸመ : ወንጅሏል ምሳሌ በማድረግ አሜሪካና የሕዝብን
ባለበት : ኃይሎችን ጉብኝት በዋናነት ሊሆን ዓለም
ማረሚያ : ለሚመለከተው ጦርነት ሠርቶ ሒሶች #
ዝዋይ : እብድ አገራዊ የሙያው ይመስለኛል ይበጅ
እስር : ስድስትና ግልጽ መርሆአችን አማራጭ ዴሞክራሲያዊ
በፕላዝማ : እንደቀረ የመጣ እውነት የሚገባው የተስማሙበት
ጋዜጠኛ : የሚጋርጥ የመሰሉ የፈላጭ ዘመን የሚጣጣሩትን
ተመስገን : ቢቀያየርም ሳይንቲስትም የሚያደርጉ ወታደራዊ እስከ
በከሳሽ : እንዳይጠቀሙ የሚቆጠሩ ገድሏል አስተሳሰባቸው ደርግ
ዓቃቤ : ቢቻል ሰላም ውዝግብ ደግሞ እዚህ
ቀርቦበት : ጅምሮችና ቆራጮች ብቃት መሣሪያነታቸውም ሐሳብበዓለም
ክስ : ትርጉም የመስኩ የአመለካከት ዓላማም ከአገዛዙ
እሱ : የአገራችን የሚቆጠሩ ሚዲያን ከአገዛዙ መለኮታዊነት
የፍትሕ : የሚቃወም ማሳወቅና እንዲገነዘብ ለውጥ ሊተች
አዘጋጅ : ይዣለሁ ቆራጭ ሐሳብበዓለም ሚና ላይ
በጋዜጣው : በአስተሳሰብ ደርግ መርሆ የሚጣጣሩትን ገለልተኝነትንና
በቅጽ : ሞተዋል መብቱ ከርዕዮተ አይታበልም ተከናውነዋል
ቅጽ : በሠራው ዓ.ም. ዋናው በእንግሊዝ ክፍለ
ዕትም : አባቱ በግብርና ለዚህ መንገድ ዋናው
በራሱና : ማስረጃዎችና ጎተራ አሜሪካ ጽንፈኝነትን ፍልስፍናዬ
አመንጭነት : በሥር መልቀቅ የሞላበት ለውጥ ትችቶች
የተጻፉ : ታሪካዊ ቢኖሩም የመሰሉ ያለውን የፈላጭ
ጽሑፎችን : የሚሰጥ የሙያው ሕዝቦች አሠራር ይመስለኛል
አትሞ : ድጋፍ ከመሆን እንደተጀመረ እንዳልዘነጋሁ ይበጅ
አውጥቷል : ጠቁመዋል ሰነባብቷል ይመስለኛል ይበጅ
በመሆኑም : በንጉሡ ኢትዮጵያዊያንና የግልና የሐሳብ በሙያተኛው
በመንግሥትና : ከሆነ ተመልካች መገልገያ እዚህ ይመስለኛል
መንግሥታዊ : ሐቅን የሕግ የማያይ በመቶዎች መዋቅሮችን
እንዲያምፅ : በማተሚያ ጉልህ ሲል ጉድለቶች ጊዜም
ቀስቅሷል : የሚታፈኑ ዴሞክራሲ መንግሥትንና ሚና ላይ
በሐሰት : በመጠኑ ቃል የሚያፍንና ያለውን ነው
ወንጅሏል : በቃላት ጉዳታቸውና በመከታተያ ገድሏል አሜሪካና
ስሙንም : በይቅርታ የፈላጭ እዚህ * ይመስለኛል
አጥፍቷል : ጎራ ጨምሮ ሊረጋገጥ ጭቁን ያለውን
የሐሰት : ቤት በላቲን የአምባገነን መለኮታዊነት ዘመን
ወሬዎችን : የለብለብና የሚስተዋሉ የሚንገታገቱ ሚና የሚጣጣሩትን
በመዘገብና : ከርዕዮተ አለመፈለጉ ክፍለ ይህ ገለልተኝነትንና
ለሕዝቡ : የፈላጭ በእንግሊዝ እዚህ * ይበጅ
በማሰራጨት : ወጥቶና ለሚነገር ሚና ላይ እዚህ
እንዲናወጥ : የሚሰጥ ትችቶች የኅትመትና የሙያው በእስያም
በቀረቡበት : ዶላር በጠላ አይጥለውም ተዓማኒነት ጭቁን
ሦስት : ለክሱ ጨምሮ ነው አገር በ#ኛው
ክሶች : ፀጥታ ጎራ በፊት አሠራር የሚባለው
ከአሳታሚው : እንደፍልሰፍና አሜሪካ በፊት በማያፈናፍን ብዙዎች
ማስተዋል : የተከታተለው የፖለቲካ በማያፈናፍን ክፍለ ሚዲያ
ማስታወቂያ : አቤቱታ መንስዔ በዛሬው ተቀላቅለዋል አሜሪካና
ድርጅት : እያደገ በአሁኑ የኅትመት በንጉሡ በሙያተኛው
ጥፋተኛ : ተጸጽቶ እሳቤዎችን ሕዝብ ያሉ ቀዳሚው
ተብለው : አድርባይነትና የለብለብና በሥጋት ሊተች ያለውን
ተወስኖባቸዋል : ሰጥቷል የሚጎዳና ልበ ከመጣ አሳድዷል
እስራትና : አምርሮ በብዛት መቅረፅ ሊፈርድ ያህል
ድርጅቱ : በሥራው መንስዔአቸውን አስፈጻሚ የሚጣጣሩትን እዚህ
ተቀጥተዋል : ሸሽቶት ይገልጸዋል አሳድዷል የመንግሥት በሥልጣን
የሥር : ፖለቲካ ለጠቅላይ ማንሰምቶት ቃል ፖሊሲው
የወሰነባቸው : ብዙ አንዳንዴም መልስ ሙያዊ በሕገ
አግባብ : በማረም የሚደፈቅበት ያለው ሲያበቃ አፋኝ
አለመሆኑና : የሚጥል ንድፈ ሚዛናዊነትን እዚህ *
እንዳሳደረባቸው : የህሊና ገብነት አስፈጻሚ የሚጣጣሩትን እዚህ
ፍርደኞቹ : የተዓማኒነት ያለ ቢሆንም ባህልን ኢንዱስትሪውን
ለጠቅላይ : የሥር ጠቅላይ ከፍተኛ በነፃ ጎልቶ
ባቀረቡት : ቆይታ በተሳሳተ ያለውን ሚና ላይ
የይግባኝ : መቀየሪያ በአፍሪካና በፊት የሚገነባውና ብዙዎች
አቤቱታ : ማስታወቂያ መንስዔ ተመሳሳይ ናቸው ተቀላቅለዋል
የቅሬታ : መልስ የመሰሉ የሚባለው የሚጣጣሩትን ለመጠበቅ
ነጥቦቻቸውን : ችግሩ የኅትመትና የተስማሙበት ይበጅ
አስረድተዋል : አይታበልም ተቀላቅለዋል አሳድዷል ያደርጋል ይመስለኛል
ቀጥተኛ : ተቀባይነት ሥርዓት ነው መለኮታዊነት ገለልተኝነትንና
ምስክርና : ተቀባይነት የሚናገሩ መለኮታዊነት የሚጣጣሩትን እዚህ
በሰነድ : ማድረግና በሥጋት እየተከተሉ ለመጠበቅ ላይ
የተጠናከረ : መሠረት የኅትመትና የሚንገታገቱ መገለጫ ያለውን
ማስረጃ : ቤቶች የሥርዓቱ የሐሳብ ይህም መዋቅሮችን
ለሥር : ለጠቅላይ ጠቅላይ በነፃ ፖሊሲው ሚና
ያቀረበ : የሚመሩ አሜሪካ መንገድም ሳይሆን ገድሏል
ወንጀል : አኗኗሩ ሐሳብበዓለም እንዳልዘነጋሁ ላይ ይበጅ
ተፈጽሞባቸዋል : እንለወጥ ለዴሞክራሲ ናቸው ንድፈ ይታወቅልኝ
ያቀረባቸውን : ሙያተኛ መንገድ በሥልጣን የሚሰብክና ክፍለ
የተጠቀሱትን : ከድህነትና አውሮፓዊያኑ በተስተካከለና በፖለቲካ ፍልስፍናው
ዕትሞች : በነበሩት ለገበያና ወገኖችን ንድፈ ሚዛናዊነትን
እንደወሰንበት : አለመሆኑንም ሥራ እየታየ እንዳልዘነጋሁ ይበጅ
አስረድቷል : ይሄዳል ይታወቅልኝ * ይመስለኛል ይበጅ
አንባቢው : በቋንቋ ፍልስፍናው ብዙዎች ሥልጣንን ሚዲያ
ዝንባሌና : በግል አፋኝ በ#ኛው ይህ ሚዲያ
አረዳድ : መንስዔ ይባልና ቁጥራቸው የአፈና ክፍለ
አቅም : ብንወያይበትም አርዓያ መገልገያ እዚህ *
ሊያሳጣ : ካለ በብቃት መግዣ የአክሲዮን ነበር
ሊያስደስት : ብቃት የአምባገነን ሚና ላይ እዚህ
የተለየ : በስሜታዊነት ጋዜጠኝነትን # ብዙዎች በእንግሊዝ
ስሜት : የጋዜጣ እዚህ ይበጅ
ላይሰጥ : ኃላፊነትን ብርሃኑ ተቀሰቀሰ የሚያበረታታ የሙያው
ከሚችል : ጦርነት አይችልም አካሄድ ንድፈ እዚህ
በስተቀር : ተፈጻሚነቱም ዩኒቨርሲቲ ማንሰምቶት ደረጃ ያለውን
የታወቀ : መስፋፋት የብሮድካስት በሥልጣን ሚዲያ እዚህ
መለኪያ : ግንኙነት እየተከተሉ የውጭ ፍልስፍናው ገለልተኝነትንና
ሳይኖርና : በዋናነት እዚህ * ይበጅ
እንዲውል : ሲገባው ያለ ባለፈውና ፈተና የሥርዓቱ
ሳይደረግ : አለማዳመጥ መዋቅሮችን እዚህ * ይበጅ
የጽሑፍ : መንስዔአቸውን ዕድል የሚሰብክና የሚጣጣሩትን ለመጠበቅ
አሳታሚ : ለሕገ እንዲሰማቸው እህል ያለበት መዋቅሮችን
በሥር : ለሥር በነፃ በረጅም ደረጃ ፖሊሲው
የተገመቱት : በማረም ከማቅረብ ምግባርና የሚመልስ ያለውን
ወንጀሎች : ፍልስፍናን እንዳልዘነጋሁ ገለልተኝነትንና ይበጅ
የመሥራትን : ተፈጽሟል በነበሩት ድምፅና መሥሪያ ናቸው
ከጽሑፎቹ : ለብቻው ተሰበረ አቀባይ ለምሳሌ ኢሕአዴግ
ባሻገር : አስከባሪዎች አስተሳሰባቸው ትንሽ * ይበጅ
ደጋፊ : ሊጋጭ ዓ.ም. የሐሳብ አስፈጻሚ ሚዛናዊነትን
ሳይረጋገጥ : የአሁኑን አስፈጻሚ በእንግሊዝ እዚህ *
እንደማይቻል : ተዓማኒነትን ልብን እንደተጀመረ እንዳልዘነጋሁ *
በመነሳት : ሊገደብ ከቀሰመው መነሳትና ደግሞ አገሮች
ተፈጽሟል : የመሥራትን በነበሩት ድምፅና ናቸው የመስኩ
በፍርድ : የመንግሥት አምባገነናዊ ሚዛናዊነትን እዚህ *
ቤቱ : ጅምሮችና መሣሪያነታቸውም ነፃነትና ሚና ገለልተኝነትንና
የተሰየሙት : እሱ ቢሆንም ከአገዛዙ እዚህ *
ዳኛ : ከአንዳንድ ዘመቻ አለማየት የጋዜጣ ምርመራ
ግላዊ : ለአንድ ልማታዊ እንደሌለው ነው ሥልጣንን
ውሳኔ : ፈጥኖ በሕገ አስፈጻሚ ሚዛናዊነትን እዚህ
ከሚሆን : ለመገንባት እንደሆነ ቁጥራቸው አሜሪካና ብዙዎች
ከፍርድ : አሜሪካ መንገድም የመንግሥት የሚባለው አምባገነናዊ
ቤቶቹ : ዘመን የሚጣጣሩትን ግን እዚህ *
የሚጠበቀውን : ኃላፊዎችና ሁኔታ ደርግ ያለበት ከአገዛዙ
የውሳኔዎች : ሥልጣኔ ብዙኃን መርሆ እንደተጀመረ ሚዛናዊነትን
ተጨባጭነት : ጫፍና እንደሚችልና ተመን መጠን ከፈላጭ
ሊያረጋግጥ : ቢመዘን ቤት ትንሽ መለኮታዊነት *
የጋዜጠኛ : በቅድሚያ ዓ.ም. ይህም አስፈጻሚ ላይ
ጠበቃ : ዘገምተኛ ተገቢ እ ሌላ በሆነ
ለፍርድ : መንግሥትን ከሦስት የመንግሥት የሚባለው ንድፈ
የተገለጸን : ባለሀብቱ የቅድመ አገዛዝ ዘመን አምባገነናዊ
በማየት : አሜሪካና በ#ኛውና * ይመስለኛል ይበጅ
ፈጽሟል : ተፈጽሟል በነበሩት ሳንቲም ናቸው ከሦስት
የሚወስኑ : የጥፋተኝነት የሐሰት ቴክኖሎጂ ርዕዮተ እስከ
መንግሥቱ : አስሯል እንደተጀመረ እንዳልዘነጋሁ ላይ ይበጅ
አንቀጽ : አይፈቅድም በኋላ ነፃነትን የሚወሰድ ይነገራል
የተረጋገጠውንና : አምባገነናዊ የሚጣጣሩትን ገለልተኝነትንና * ይመስለኛል
ሐሳብን : እንደሚችልና አለፎ አውጪ ዓለም ትንሽ
የመግለጽ : በአይሁድ በመቆጣጠር ወደነበሩበት ሌላ በመካከለኛው
አጣብቂኝ : በሚታትር ያለበት እዚህ * ይበጅ
የሚከት : ለገበያና እንዳይሆን የሚለውን # ቁጥራቸው
የጋዜጠኛው : ተመልካች መስተዳድርን ሥነ የመሰሉ የፈላጭ
ዜጎች : ከልማታዊ ሚና ላይ እዚህ ይመስለኛል
የሚገልጹት : ሌላ በፖለቲካ የቅድመ አገዛዝ ንድፈ
መቼ : ማበብ ባህልን ከፈላጭ የሚዲያ መዋቅሮችን
ሊያስቀጣቸው : ባከበረ ለሚነገር ያለውን አሠራር በ#ኛው
እንደሚችልና : ሐሳብን ባሻገር አስተሳሰባቸው ሚዲያን ይነገራል
ጥበቃ : ጥያቄያቸው ቢከብድ ነፃነትና ማረጋገጥ መንግሥትንና
እንደሚደረግላቸው : ሚዲያው ማንም የሚቆጠሩ በ#ኛውና ገለልተኝነትንና
ባለማወቅና : ኤምባሲዎች በሰላም ከሆነ ተጭኗቸው ያለበት
ግራ : ሥራዎችን ሥነ ዴሞክራሲ በመካከለኛው የመሰሉ
በመጋባት : የሚከት በይሉኝታ ለገበያና ራስን የሕዝብን
በመብታቸው : ከመዳፋቸው መርዶ ከላይ የሚያፍንና የሚጣጣሩትን
እንዳይጠቀሙ : በከሳሽ አምሐ ተግባር የሚቆጠሩ ገድሏል
በተዘዋዋሪ : ሳይኖርና ሕግ ባህልን እዚህ *
ገደብ : አዲስ ማስተካከያ እንደሚገመት የጻፋቸውና ለማረጋገጥ
የሚጥል : ባልታየ አለመሆኑና መልካም ጊዜም ናቸው
እንደማይቀርም : ዓመታትን ይጽፋል ማጋነን የሚንገታገቱ እንደመርግ
አስገንዝበዋል : ተደንግጓል ያደርጋል ይታወቅልኝ ይመስለኛል ይበጅ
ንዑስ : እንደማይቀርም እና ይጽፋል የሚንገታገቱ እንደተጀመረ
ሊገደብ : ሰፊ ያለው አገሮች ያለበት ያለውን
በሕግ : ቫን መልካም በማያፈናፍን ብዙዎች የፈላጭ
የሚገልጸውን : ካለው ፈተና መንግሥትና የሥርዓቱ ተጭኗቸው
ድንጋጌ : የገንዘብ አካላት የተባለው የሚወርደውን ሐሳብበዓለም
እንደሚቃረን : ቆራጭነት ዋነኞቹ የተባለው ዘመን ግን
ጠበቃው : መግለጽም አይደለንም ሥራ ያህል ይበጅ
ክሱ : ህንድ አምባገነናዊ እዚህ * ይመስለኛል
ሲቀርብ : ካለ ሊያሳጣ ነበር ከአገዛዙ ቀዳሚው
በእያንዳንዱ : ያጋለጠውን ከተመረቀ መምጣት የሚቆጠሩ ያሉ
የወንጀል : የሚመስል ሥርዓቱ መዋቅሮችን በእንግሊዝ እዚህ
ሥር : ዕቃ አይደለም ሥርዓቱ ድረስ ያለበት
የተገለጸውን : የሚፈልገውን አስፈጻሚ የሚጣጣሩትን እዚህ *
ያስረዳል : ተፈጽሞባቸዋል ለዴሞክራሲ ናቸው ከሦስት ከመጣ
የቀረቡት : ሆኖ ለግል በተለይ ሲያበቃ ሊተች
ማስረጃዎችና : በሕግ አሜሪካ ተናጋሪነት ብዙዎች አሠራር
ለክሱ : ሦስት ያለውን ነው ሚና ላይ
የሆኑት : ተጠባቢነቱ መቶ ክፍል የአመለካከት የውጭ
አምስት : ሰብሳቢ ይልቅ የተሟላ የሚንገታገቱ የመሰሉ
ጽሑፎች : አትምጡብኝ ሎክ የመንግሥት የሚባለው አምባገነናዊ
አስረድተው : ስለሚችል የሚመራባቸውና ኢትዮጵያዊያንና አስፈጻሚ ሚና
በጋዜጠኛ : ሕጎች ያለውን ሚና ላይ እዚህ
ተመስገንና : እንዲላክላቸው አለመላቀቁ ንድፈ ይታወቅልኝ ገለልተኝነትንና
የተጻፉትና : ያለውን ይህ የሚጣጣሩትን ለመጠበቅ እዚህ
የታተሙት : ማድረጋቸው የሚወርደውን ቆራጭ ሐሳብበዓለም ሚና
መመልከት : ከሦስት ርዕዮተ አስተሳሰባቸው የሙጭኝ በላቲን
ቢቻል : በመንግሥትና በመሆኑ ተመልካች በላይ አስፈጻሚ
ያለማንም : እንደማንኛውም ከሆነ ሳንቲም መሪዎችን የፈላጭ
የመሰለውን : ከተባለ የሚጠልፈው ተቀባይነት የሚለውን ብዙዎች
አመለካከት : ቀፍድደው ሊሸፈን ሚዲያ የሚጣጣሩትን ላይ
የመያዝና : ሰው ኢንዱስትሪውን ከአገዛዙ ክፍለ ይበጅ
እንዳለው : በአስተሳሰባዊ መርጠው የሚጣጣሩትን ግን እዚህ
የተደነገገውን : ማስተዋል ለምርመራ የፖለቲካ አገር ሚዲያ
የሚቃረኑ : ለኦሬንጅ የዴሞክራሲ ሚዲያው ማንም ዋነኛ
በአንደኛው : ለጽሑፌ ሦስት ያልተጨበጠ ጨምሮ በፊት
ያቀረባቸው : በእያንዳንዱ ያጋለጠውን የሚንቀሳቀሱ ያሉ ያለበት
ድንጋጌዎች : ከመጠን አደረጃጀት ንጉሣዊ ሐሳብበዓለም ሚና
ከሕገ : መገልገያ አስፈጻሚ ከአገዛዙ መርሆ የሚጣጣሩትን
የሚጋጩና : ለንግድ የሚያደርጉ በሸቀጥነት ጊዜም እየተስፋፋ
በአስተሳሰባዊ : እንዳለው ጎራ አንድ ሁኔታ አፋኝ
ይዘቱና : አቀራረብ በፊት አፋኝ አሠራር ይህ
ሊያስከትል : የኢትዮጵያውያን የተባለውን በመካከለኛው እንደሌለው ይመስለኛል
በሚችለው : እንደነበረ የለውጥ ፍልስፍናው ብዙዎች ከአገዛዙ
አስተሳሰባዊ : በሌሎችም እህል እንደሆነ ክፍለ ለመጠበቅ
ውጤቱ : ተመልካች ተሳትፎ አስፈጻሚ እዚህ *
ሊገድብ : ትቶት በጥናት ቃል ብሎ ሌላ
ከተዘረዘሩት : ገበታቸው መንገድ ነፃነት የመንግሥት በ#ኛው
ልዩ : ለ# የሚሠራ በከፍተኛ ጋዜጠኝነት ፍልስፍናው
ሁኔታዎች : ምንዛሪውን ምንም አስፈጻሚና ወጥቶና አልፈው
በመብቱ : በሚናፈስበት ዓመታት የማለቱን ሊሆን የብሮድካስት
ጠቁመዋል : አውጥቷል ሰነባብቷል ይመስለኛል ይበጅ
የሕገ : መርሆ ሚዲያ ግን እዚህ *
ትርጉም : ክስ ቤተ በሌላው በከፍተኛ የመስኩ
እንዲሰጥባቸው : የኅትመት ንጉሣዊ እዚህ * ይመስለኛል
ለሕገ : አሳታሚ መዋቅሮችን ሚዛናዊነትን እዚህ *
ጉዳዮች : አጣብቂኝ በሚታትር ሚዛናዊነትን እዚህ *
አጣሪ : ጥያቄያቸው ማረጋገጥ የሚወርደውን ሐሳብበዓለም እንዳልዘነጋሁ
ጉባዔ : ሲገባ ስለነበረ ቦትስዋናና እስከ የውጭ
መላክ : አዳዲስ የአንዳንድ አበባ እንደነበረው ፍልስፍና
ሲገባው : ያለ ቢሆንም ውዝግብ መነሳትና ኢንዱስትሪውን
በማለፍ : ሁለት አባልነትና ያለውን ሚና የሚጣጣሩትን
የጥፋተኝነት : የሚወስኑ ቴክኖሎጂ ሰፊ የምናየው ዋናው
መስጠቱ : ቶማስ ብርቱ የመሰሉ ያለውን የፈላጭ
አለመሆኑንም : ሊወጣ አኳኋን እየታየ እንዳልዘነጋሁ *
አብራርተዋል : አይደሉም ይታወቅልኝ ሚዛናዊነትን እዚህ *
አቶ : መቶ ገድሏል በማድረግ በ#ኛውና ገለልተኝነትንና
አመሐ : መልስ ተመልሶ ብል በገዥው የመሰሉ
ሰፊና : መግዣ ንገረኝ በክልልና አንድ ነበር
ዘርዘር : መሆኑም የጋዜጠኝነት ሊሆን ቢኖርም ሐሳብበዓለም
ቤትን : ሥርዓት # ሥልጣንን ዘመን ታሪክ
የሚቃወም : አሜሪካዊ ጋር ሊተች ያለውን የሚሰብክና
ማመልከቻቸውን : ገለልተኝነት ሳይንቲስትም ሥልጣንን ንድፈ እንዳልዘነጋሁ
በክርክር : ከድህነትና የራቀ አውሮፓዊያኑ አሠራር ይመስለኛል
ካሰሙ : አስታወቀ ሳምንት የሚያደርገው በዛሬው ተቀላቅለዋል
ደንበኛቸው : ከፊልም ለምሳሌ የምናየው ኢሕአዴግ ዜጎችን
በማተሙ : ጋዜጠኛና የአገርን ልማድ ሙያና ቆራጭ
መባሉ : ሰጪ እንዳይሆን ዘመን የሚጣጣሩትን ሚዛናዊነትን
እንዲባልላቸው : ባለቤት ኃላፊነት # ፍልስፍና ሚዲያ
ዳኝነት : ቅንጣቢውን ለምርመራ መንግሥትንና ያለውን አገር
ጠይቀዋል : አይታበልም አለበት አልነበረም አይደሉም ይታወቅልኝ
የተባሉት : ብዙዎቹ በመቶዎች የአገሪቱ ንጉሣዊ ግን
በጋዜጣ : ሲገባ ስለነበረ የምዕራቡ ሥርዓቱ እስከ
በጻፏቸውና : ቀደም ይታይ ልማታዊ የፖለቲካ ፈቅደው
እንዲታተሙ : ቡክ አደጋ ኤርትራን አገሮች መርሆ
ባደረጓቸው : ውግንናው ፖሊሲው የተሻለ የመሰሉ ይመስለኛል
የተፈቀደ : ያለፉት የዲሞክራሲ የርዕዮተ በፖለቲካ ነው
ከመሆኑ : ለሕገ የከፋው ዓለም መዋቅሮችን መርሆ
ከእስር : እንደዘገበው በኤዲተርነትና የአገሪቱ ያለበት ፍልስፍና
እንዲፈታና : በክሶቹ ዓላማም ከአገዛዙ እዚህ *
በድርጅቱ : የሚወራለትን ሥርዓቱ ተጭኗቸው መዋቅሮችን ይታወቅልኝ
የተጣለው : ከድህነት ሚና ላይ እዚህ *
መቀጮ : ሳይንቲስትም በግልጽ ሥልጣንን ሚዲያ ንድፈ
እንዲነሳ : የድጋፍ የሚናገሩ የሚጣጣሩትን ግን እዚህ
እንዲታዘዝላቸው : ዝንባሌና ፍራንክሊን ያልተጨበጠ አፋኝ አገር
በክሶቹ : በሥጋት መገልገያ ፍልስፍና አስፈጻሚ ከአገዛዙ
የተጠቀሱት : ያጋለጠውን ሰው የአገራችን ገለልተኛ ውዝግብ
ን : አድልኦ መነሻው በአንዳንድ ከመንግሥት መገናኛ
በመሆናቸው : ከሆነ በእንግሊዝ እዚህ ይመስለኛል ይበጅ
ሕገ : ልማድ ጥረት የግል መሣሪያነታቸውም ፍልስፍናን
እንዲሰጥባቸውና : ቢሆንም ያለበት መርሆ * ይበጅ
ታግዶ : መርጠው ሁኔታ የአገሪቱ ያለበት ከአገዛዙ
ጥያቄያቸው : ማረጋገጥ ሥልጣንን መርሆ ሐሳብበዓለም የሚጣጣሩትን
ለጉባዔው : መቀጮ ሳይንቲስትም ሚዲያ ንድፈ ገለልተኝነትንና
እንዲላክላቸው : እንዲባልላቸው ተመስገንና ባለቤት የለውጥ በነፃነትና
በመጠየቅ : ትይዩ የቦርድ ሚዲያዎች ምሥራቅ አሠራር
አቤቱታቸውን : አለመሆኑንም በጅምር ሊወጣ አኳኋን ሥራ
አብቅተዋል : ወሰነ ይቀነቀናል አልነበረም ያደርጋል ይታወቅልኝ
የቀረበውን : ድሃ ዓይነት ለረዥም ፕሬዚዳንት ወዘተ
ያስቀርባል : ከማቅረብ መንገድ እንደሌለው የመንግሥት ዋናው
አያስቀርብም : ከሚለው ተፈጽሟል ኦስተን አድርጎ የሚባለውም
ለጥር : ይለቃሉ ይከለክላል ይታገላል አገራዊ አቀባይ
ቀን : ቁጥር ይገልጸዋል አረጋገጠ በዚህ መንገድ
ቀጠሮ : ዕድሜ እንዳይለውጥህ የሚንገታገቱ ዓላማም ይበጅ
ሰጥቷል : ተወስኖባቸዋል ከመጣ ሙሉ በእንግሊዝ ይታወቅልኝ
በመንግሥቱ : ዕውቁ አጃንስ ገብነት ያሉ የሐሳብ
መስፍንበዚህ : በመረጋገጡ መዋቅሮችን ሚዛናዊነትን እዚህ *
ከሚለው : አያስቀርብም ባለቤት ሙስናን ባህልን አስተሳሰባቸው
እያቀያየርን : ትራፊክ እንዳይሆን ውስጥ ዘመን ሚዛናዊነትን
ብንጠቀምም : ሚዲያ እዚህ * ይበጅ
የሬዲዮ : ሚዲያን መዋቅሮችን ከአገዛዙ መለኮታዊነት መርሆ
የቴሌቪዥንና : በእጅ እንዲገኙ እንደማይችል የሥርዓቱ ተጭኗቸው
የተመለከተ : የተስማሙበት ይበጅ
በመሠረቱ : በነገራችን በዚህ በሕጋዊ ነበር ቀዳሚው
የሚለው : አማራጭ የዚህ ንድፈ * ይመስለኛል
ከሚል : ለግል አንደኛው ማጋነን ሚና ላይ
የላቲን : የጠነከረ የመንግሥት በእንግሊዝ አምባገነናዊ እዚህ
የተገኘ : ለኦሬንጅ ክፍል የአመለካከት በ#ኛውና *
ለጽሑፌ : በአንደኛው ለአንድ ያልተጨበጠ አገራዊ የሚደፈቅበት
ዓላማ : ቀጥተኛ መሥራት ተቀባይነት የሚናገሩ ሥርዓት
እርሱን : አርዓያ የአክሲዮን ያለው በብዙዎቹ መገልገያ
መውሰድ : ሊፈርድ ይበጅ
ይሻላል : መብቱ ይታወቃል ደርሰዋል አሉ ይታወቅልኝ
ቴክኒካዊ : ከዚህም ናይጄሪያና ባነበበው መሃላቸው ሳይሆኑ
ከማንም : ማስፈን መዋቅሮችን እዚህ * ይመስለኛል
ያልወገነና : እንዲነሳ ቀርቦበት ኦሮሞነት የተያያዘ በተለይ
አንድን : የተቀናጀ የሆነ ሥልጣንን ታሪክ ሐሳብበዓለም
ከላኪ : ድብልቅልቅ መስፋፋት ሜዳ የሚሰብክና ክፍለ
ተቀባይ : በማተሚያ መፀዳጃ ጉልህ ጉድለቶች በስሜታዊነት
በብቃት : ሊያሳጣ የነበሩበትን የእንግሊዝ ከማቅረብ ተመሳሳይ
ለማድረስ : ኃላፊዎችና ሁኔታ ማብቂያ ከአገዛዙ መለኮታዊነት
የሚችል : አድራሻቸው ብል ፍልስፍና ያለውን የሚጣጣሩትን
አገናኝ : መሠረት ከልክ የኅትመትና አፋኝ ላይ
ዘውግ : የሚችሉትን ቪክተር የነበረችውን ምንም የሚያስመድቡት
ኅትመት : ገለልተኝነት ብቃት ማረጋገጥ ሐሳብበዓለም እንዳልዘነጋሁ
ከ#ኛው : በ#ኛው ይህ ላይ እዚህ ይመስለኛል
አጋማ : አሠራር በ#ኛው የሚባለው ሚዲያ ገለልተኝነትንና
#ኛው : በ#ኛው ይህ ላይ እዚህ ይመስለኛል
አጋማሽ : መግዣ የአገራችን የሚቆጠሩ ሚዲያን ከአገዛዙ
የዘለቀውን : ግለሰቦቹ ኃይሎችን ውስጥ ያለበት መዋቅሮችን
ጅማሬ : የበላይነት ጋዜጠኝነትን ሥልጣንን ንድፈ *
ይይዛል : ደሬሳ ይለቃሉ ይታገላል ጽፈዋል አገራዊ
በእኛም : ጉድለታቸው በየትኛውም ሲያበቃ ለዚህ በሙሉ
አዕምሮ : አቀንቃኞች ሚዲያን መለኮታዊነት መርሆ *
ከተሰኘው : እንደሚጠበቅ ቅንጣቢውን ለውጥ በረጅም የጋዜጣ
አንስተን : ደብዳቤ ነፃነትና የሚወርደውን ግን ላይ
ጉዞ : የራሳቸው የአድማጭና ቢኖሩም የቦርድ የመሰሉ
ብናጤን : ቢሊዮን እንደተብራራው እ ሊሆን በሆነ
ዕድሜ : ዓመታትን እስራትና እንዲቆዩ እንዳይለውጥህ እንዳለበት
ተቆጥሯል : አልቻለም አሉ ይታወቅልኝ ይመስለኛል ይበጅ
በረጅሙ : ግለሰቡ ባይባልም ሲያበቃ ለዚህ ነፃነትና
ውስጥም : ፖሊስ እንዲገኙ የማለቱን መገልገያ ከአገዛዙ
ጋዜጦች : ባለማወቅና ከሆነ የሚባለውን ሚና ላይ
ተፈጥረው : መምጣታቸውን መሪዎችን የፈላጭ መርሆ ሚዛናዊነትን
በመጡበት : አድርገው መሣሪያነታቸውም ተደርጎ ሐሳብበዓለም ሚና
ዘገምተኛ : ጠበቃ ተገቢ ወደነበሩበት ሌላ የሙያው
ሞተዋል : በቅጽ በረከተ መብቱ ሰነባብቷል ይመስለኛል
በጣት : ኢትዮጵያዊያንና የሐሳብ ቀዳሚው ግን ላይ
የሚቆጠሩትም : ሐሳቤን አባልነትና በመቶዎች የሚያፍንና ንጉሣዊ
ያለፉት : ጊዜም የዲሞክራሲ ናቸው በፖለቲካ የሕዝብን
አራት : መንግሥታዊ የተለያዩ መርሆ ግን እዚህ
ከመዳፋቸው : መርዶ የአንባቢውን የሚያዳክም የግል ያለበት
ሳያወጧቸው : ሊገድብ የሚታፈኑ መከናወን ብሎ በፖለቲካ
ስድስትና : በፖለቲካ ዴሞክራሲያዊ ንድፈ ገለልተኝነትንና ይመስለኛል
ሰባት : የኢትዮጵያውያን መልካም በማያፈናፍን በመካከለኛው ፍልስፍናው
አሥርት : የሚመሩ ገድሏል ቁጥራቸው አሠራር ክፍለ
ዓመታትን : ዕድሜ መሻሻልን ጸሐፊዎችና ማጋነን የኅትመትና
አስቆጥረዋል : አስታወቀ ገቡ አይደሉም ይታወቅልኝ እዚህ
ለግልና : ኮምፓራቲቭ ከፍተኛ ቆራጭ ሚና ላይ
ለንግድ : የሚጋጩና ጊዜም በፖለቲካ አገዛዝ ንድፈ
የተፈቀደው : በመረጋገጡ ቢኖርም እዚህ ይመስለኛል ይበጅ
መንግሥታዊው : በህንድ የሚመስላቸው በሆነ ሥልጣንን ሐሳብበዓለም
በዓለም : በማላቀቅ በማስመሰል ዘርፍ ዓላማም እዚህ
ተቀርፆ : እንደሚያደርስ የሚንገታገቱ ላይ ይበጅ
ከተገበረ : በሃይማኖት አቀባይ መስተዳድርን የሚጋርጥ የመንግሥት
አዋጅ : አንደኛው ከልማታዊ ማጋነን የሚንገታገቱ ሚና
ወጥቶለት : ተፈጽሞባቸዋል እንለወጥ ለዴሞክራሲ ናቸው በእንግሊዝ
ከጀመረም : ይገልጸዋል ይታገላል መንገድ የመንግሥት በሥልጣን
አስቆጥሯል : አጋጠመው ያተኩራሉ ደርሰዋል አሉ የዚህ
እንዳለመታደል : ማንኛውም ህንድ ዕርምጃ አምባገነናዊ የሚጣጣሩትን
ሬዲዮና : እንደነበረው የፈላጭ መርሆ ሚዲያ እዚህ
ቴሌቪዥን : አበባ # ፈቅደው ሥልጣንን ሚዲያ
የሚወራለትን : በድርጅቱ የብሮድካስት በሥልጣን በእንግሊዝ እዚህ
ከኅትመቱም : ዋነኛ አምባገነናዊ * ይመስለኛል ይበጅ
ባነሰ : የተሰየሙት የሚዲያ ከአገዛዙ እዚህ ይበጅ
የረቡበት : ለማን እንደሚኖርበት የያዛቸው ሊኖረው ሊፈርድ
ከሐሳብ : የገቢዎችና ከሕዝብ የመረጃና ኢትዮጵያዊያንና ዋናው
አማራጭና : ሁለት ብል ያለውን ሚና ግን
ገለልተኝነት : አበርክቶው የከሸፈ መፈናቀል ለማረጋገጥ መሣሪያነታቸውም
ሚናው : ጥሩውን በአስተሳሰብ ቃል እያደረገ ርዕዮተ
ላለፉት : ቲሸርት ባይመስለው መልካም የዚህ የፈላጭ
ሃምሳ : ለማብጠልጠልስ ሊጋጭ እንዳይሆን የሚቆጠሩ ትንሽ
ገደማ : ከሚሆን ለመገንባት ጋዜጠኝነት ቁጥራቸው አሜሪካና
ስሙና : ማየት የተባለው ድረስ ፍልስፍና መርሆ
ሎጎው : ይዘቱና አቀራረብ አፋኝ ያለውን ይህ
ቢቀያየርም : ተመስገን ጊዜም የአምባገነን ሥልጣንን ገለልተኝነትንና
ኃላፊነትን : ግዛት የሙያው አሠራር ገለልተኝነትንና ላይ
ተሸክሟል : ይከተሉ የሙጭኝ ሚዛናዊነትን እዚህ *
ቢባልም : ተቀርፆ እንደሚያደርስ እንደሌለ አምርሮ መገለጫ
እንደቀረ : በፕላዝማ የመጣ እውነት ደጋፊነት የሚገባው
እርግጥ : ዋናው ክፍለ ገለልተኝነትንና ላይ እዚህ
በቁጥጥሩ : ከአንድ ይከተላሉ ህልውናዬ መንግሥታትም ንድፈ
አቋሙ : በተጨባጭ እንደሆነ ፍልስፍናዬ ክፍለ ሚዛናዊነትን
ይከተሉ : ችግሮችን አለባቸው የጋዜጠኝነት የሙጭኝ ዛሬም
እየሠራ : ፖሊሱም ለኦሬንጅ ራስን ሚዲያው ዋነኛ
ይገልጻል : ተጫውቷል ይታገላል ሜዳ አሳድዷል የመንግሥት
እውን : በእኛም ጉድለታቸው በየትኛውም ቆራጭነት ዋነኞቹ
መሰል : ዛሬም መለኮታዊነት ታሪክ ንድፈ ሚዛናዊነትን
ቅስቀሳና : በእጃቸው ማስቀደም ከአገዛዙ መለኮታዊነት የሚጣጣሩትን
የላይኛው : ከሚያዘጋጀው እኛ ተቀሰቀሰ ያልተጨበጠ ቆመው
የሚንደቀደቅ : የተገመቱት ከማቅረብ ተመልካች አስፈጻሚ ይህ
መትረየስ : ድክመት እንዳልዘነጋሁ ይበጅ
ይሆን : ታይቷል ይበዛል አለበት አሳድዷል ይታወቅልኝ
ለአማራጭ : አምባገነናዊ * ይበጅ
የማይሰጥ : ምንም ልማታዊ የሚወርደውን ላይ እዚህ
ወይስ : ጭቁን የሚባለው የሚጣጣሩትን * ይመስለኛል
ከሕዝቡ : መንግሥትንና ሚና ላይ እዚህ ይበጅ
የሚነገሩ : ታስረን ተፈጥሯዊ ከድህነትና ፕሮፓጋንዳ በማያፈናፍን
የማያደርስ : ፍልስፍናስ ንድፈ ሚዛናዊነትን እዚህ *
ካለፉት : ባለፉት ቀጥሎም መንገድ የግልና በሥልጣን
ወዲህ : እንደሚጠበቅ ሳይሆኑ በአሠራር በረጅም ያለውን
የተፈጠሩ : ጉድለቶች በስሜታዊነት የለውጥ ይታይ ፍልስፍናው
ውጤቶችስ : የተዛባ የሚባለውን ሚዲያዎችን የሚወርደውን ሚና
ፍልስፍናስ : የማያደርስ ያለፈ የዲሞክራሲ ናቸው ከሦስት
የሚሉት : ሊካድ በብዛት መቅረፅ ሊፈርድ እየታየ
ሊብራል : ፍራንክሊን መርዶ ኒዮሊብራሊዝም ለሚፈልግ ነው
ማወቅ : ሊጤን ይበጅ
ያስቸግራል : የሚያውቁት ተችሏል አሳድዷል አይደሉም በሥልጣን
ፍልስፍናውን : ተፈጥሯዊ ብዙዎች አሠራር የሚባለው ንድፈ
በራሳችን : የሚወዳቸውን ኒዮሊብራሊዝም መከናወን መሣሪያነታቸውም ባህሪ
ዓላማና : ወንጅሏል በቃላት ያልተገለጸ በመከታተያ አሜሪካና
ምኞትም : እንዳይጨምር ሥነ ሊረጋገጥ የሚገነባውና በመደገፍ
እንቅረፀው : የሚታበል የተስማሙበት አሠራር ይበጅ
እንበል : አለበት ይታወቅልኝ እዚህ * ይመስለኛል
በጋዜጠኝነትና : በኤዲተርነትና የግል ግን እዚህ *
በመገናኛ : የዲሞክራሲ ንድፈ ገለልተኝነትንና ግን እዚህ
ቁልፍ : ማንቆለጳጰሳችን መለኮታዊነት * ይበጅ
የተባሉ : ሐሳብበዓለም የሚጣጣሩትን ላይ * ይበጅ
ምግባሮች : ምግባርና ከአገዛዙ ክፍለ በ#ኛውና የሚጣጣሩትን
ሊዘነጉ : ይበጅ
ይችላሉ : ጠየቀ ይታወቅልኝ እዚህ * ይመስለኛል
ጋዜጣና : ኢትዮጵያዊያንና የሐሳብ ግን ላይ እዚህ
ጋዜጠኛው : ጥያቄያቸው እንደሚቃረን መፈናቀል ማረጋገጥ ዘመን
ከብረት : ቢባልም መስኩ መገለጫ ላይ ይበጅ
የጠነከረ : የሚያደርገው በዛሬው የመንግሥት በሥልጣን በእንግሊዝ
ዘንግተው : ሆኖም በኤዲተርነትና ዕርምጃ በሙሉ አስፈጻሚ
ፖለቲካ : የሥር ከሌለህ ቃል ፍልስፍናን የሚወርደውን
ይዶላቸዋል : አገናኛቸው ጽፈዋል አሳድዷል ይመስለኛል ይበጅ
በፓርቲዎች : ከፍሎሪዳ በተለይ ለዚህም በሕጋዊ ከመንግሥት
ትግል : የሚመራባቸውና ውዝግብ ይታዩና ኃላፊዎች መገልገያ
ተገዳዳሪ : ባህል ያለበት መርሆ ገለልተኝነትንና ላይ
ለማጥፋት : መለኪያ የፕሬስ የአመለካከት የውጭ መሪዎችን
ለማጥቆርና : አካላት በመቶዎች የፈላጭ ዘመን እዚህ
ለማብጠልጠልስ : እንደሚደረግላቸው እንዳይለይህ የሚቆጠሩ ሚዲያን መለኮታዊነት
ይፈሩ : ተቀላቅለዋል ይታወቅልኝ እዚህ ይመስለኛል ይበጅ
ባልታየ : የሚጥል ተቀባይነት በብዙዎቹ አለመላቀቁ #
ድክመቶች : የመያዝና ኢንዱስትሪውን የኅትመትና ከአገዛዙ ላይ
ከማሳየት : በአገራዊ መርሆዎች ከፈላጭ መዋቅሮችን የፈላጭ
ችላ : ሌላ የሙያው አገዛዝ የሚባለው ንድፈ
ማለትስ : ዕርምጃ በአፍሪካ ዋነኛ አምባገነናዊ ሚዛናዊነትን
ለማን : በመኖር ፍላጎት ሊፈርድ ይበጅ
ይበጃል : ይዶላቸዋል አለበት ጽፈዋል አሳድዷል አይደሉም
ብዙኀን : የሚያዳክም ያለበት መርሆ ሚዲያ ሚዛናዊነትን
የራሳቸው : የመሰሉ በመደገፍ ያለውን የፈላጭ ለመጠበቅ
ግብና : ቫን ድብልቅልቅ በቋንቋ በማያፈናፍን ቁጥራቸው
አይኖራቸውም : ሊረጋገጥ ጭቁን አገር ሚና ላይ
ባይባል : በቋንቋ ስቶ የፖለቲካ በማያፈናፍን ምሥራቅ
በዕውቀት : ግጥም የሚጠየፍና የዩናይትድ መንስዔ የሚለውን
በዲሞክራሲያዊነት : ኒዮሊብራሊዝም ነው የሚጣጣሩትን እዚህ ይበጅ
ጥሩውን : ነፃና ሰብሳቢዎችና አውሮፓዊያኑ ብሎ ፍልስፍናን
ድክመትን : የሚዘርፉ የኅትመትና ያለውን ላይ እዚህ
ይታረም : አሰፋ ሁሉ በመካከለኛው ፍልስፍናው ብዙዎች
ገደለ : ይበጃል አስቆጥረዋል ገቡ አይደሉም የመንግሥት
እንግዲህ : ለእውነትና መገናኛ በአፍሪካ ዋነኛ ዋናው
እነዚህና : እንዳልሆነ መሣሪያ ጉምሩክ በፖለቲካ ንድፈ
ሌሎች : ጥሩ ተፈጥሯዊ ፍልስፍናዬ በማያፈናፍን ፍልስፍናው
በርካታ : ታግዶ ስለሚችል መርጠው የአገሪቱ አስፈጻሚ
የመንግሥትና : ተጭኗቸው መዋቅሮችን ይታወቅልኝ እዚህ *
ጫፍና : ተጨባጭነት መጠን የሚዲያ መዋቅሮችን እዚህ
የረገጡ : እንደ መብት ዘመን ግን *
ድክመቶችን : አሁን ማረጋገጥ ግን እዚህ *
በመገንዘቤ : ያልተጨበጠ አለመፈለጉ በቋንቋ ለሚዛናዊነት ገለልተኝነትን
የተገነባ : ጀርባ መሆኑም ቆራጮች ጉድለቶችን ተደርጎ
መከራከሪያ : ነጋሪዎች መቅረፅ ጎን ማጋነን እንደቆሙ
የዘርፉን : ዋናው ክፍለ በ#ኛውና ሚና ላይ
እየቆጠቆጠ : የሚሰብክና በ#ኛው ይህ የሚጣጣሩትን እዚህ
ከመጣው : ተገዳዳሪ የሕገ ባህል መርሆ ሚዲያ
ፍልስፍናና : እንደነበረ የለውጥ በማያፈናፍን ፍልስፍናው ብዙዎች
ምኞት : የሚያደርጉትን የሚጋርጥ አባልነትና የመሰሉ ቆራጭ
መመልከትን : ድጋፍ ዕርዳታ ለማለት እንዴት ሥራ
መርጫለሁ : አሳይቷል ይታወቃል አሳድዷል በ#ኛው ይህ
የሚስማማ : ሶሳይቲ ቁጥሩ የሚል ድብልቅልቅ አሉ
ካለ : ሊያሳጣ አብረውት መታየት ሁኔታ ነበር
ብንወያይበትም : አቅም በሥልጣን አስፈጻሚ የሚሰብክና ላይ
