ለአባቱና : ተልዕኮውም ወዲያውኑም ዓመቱ ድሃ *
ለእናቱ : እኔና የሚጠቁም አገሮች ዩኒቨርሲቲ የገንዘብ
#ኛ : ሱራፌል ተያያዥ ማሳወቅና ኢትዮጵያዊ ቪክተርና
ልጅ : እንቢ ተቋሙን በአንድ ኦስተን *
ነበር : መንደር በተካነበት አገላለጹ ፊት መንግሥትን
* : መንግሥትን በ# ልጅ ለአባቱና
አባቱ : ሚያዝያ የኢቦላ ቆይታቸውን ተሾመ #ኛ
ድሃ : አሠርታት ታይቶባቸው እንደጠየቀው ይጫወት ወራት
ስለነበረም : በማተሚያ አባቱ ለአባቱና
በ# : ኤድያ ምዘናው ከእንግሊዝ እየተሳካ *
ዓመቱ : ለማዋል ጥሩ እንደ ሁነኛ ወራት
ፊላደልፊያ : ምርቃትና አሳዳጊዎችህን ዜግነቱ በፌስቡክ አሜሪካዊ
በሚገኝ : ማለት በዓለም ክሬቲቭ የተጠቁት ቡክ
አንድ : የማኅበራችን ፕሮፌሰር ብርሃኑ ይጫወት ድሃ
ማተሚያ : ከጥቂት የነበረው የተለያዩ ለማወቅ እንደነበረ
ቤት : የሚያደርጋቸውን በሚኔፖሊስ እንደሚኖርበት የሚፈልገውን የገንዘብ
ተቀጠረ : ይጠየቃል ካዘጋጁት ገቡ ተቀጥሮ ጠየቀ
ወዲያውኑም : በእግዚአብሔር ይህ የእውነቴን ከፍሎሪዳ ቤንጃሚን
የራሱን : ቦታ ቪዛው ጊኒ ዕፅ ሊያገኝ
የሆነ : ሚና ምርምር ዋና መንግሥትን ነበር
ለማቋቋም : ቀንሰው ጥበብ አያቶቻችን ጓደኛን ተቀጥሮ
ስለፈለገ : ምናልባት ያስተምር ጥበብና እንደ በሁለቱም
ያኔ : ኅብረ ከተባለ በማድረጉም ግን በሚገኝ
አሜሪካን : እንደሚታየኝ ላይቤሪያና ተመሳሳይ ቀደም ሊያገኝ
ትገዛ : ሊፈጠር ዜግነቱ ግለሰብ ነፃነት የመሆን
የነበረችውን : ይመራ የሚሆን የሚባል የወጣው ማሊ
የእንግሊዝ : በላይ ፈጽሞ ተሳትፎ በኋላም ሊያገኝ
መንግሥትን : በረባ አልኮርጅም የሚቀመጠውን * ነበር
የገንዘብ : ጥያቄያቸው በሌሎችም ተመሳሳይ መስኩ ሊያገኝ
ዕርዳታ : ይገባል ሲታኘኩ ጉዳይ ኃላፊ ባንኩ
ጠየቀ : አመልክተዋል ተደንግጓል ገልጿል አሰሱ ለማድረስም
ነገር : ብርሃነየሱስ ያለውን ባነበበው ሮዚም ጥረት
ግን : በአሁኑ ከፍሎሪዳ ሸርት ተሾመ ያኔ
የሚፈልገውን : ቻይና ፔንሲልቫኒያ ዓላማውን ቤት በሚገኝ
ያህል : ትወለዳለህ ከቫይረሱ ለማድረስም ማተሚያ ነበር
ገንዘብ : ሲወጣ ፖሊስ ዕፅ አጋጠመው የነበረችውን
ሊያገኝ : ተመሳሳይ የገንዘብ አሜሪካን የራሱን ለእናቱ
እንደማይችል : ዕድል ሮያል ዕርዳታ የሆነ ማተሚያ
ተረጋገጠለት : ተደርጓል ተደንግጓል ሄዷል ጠየቀ በ#
ዓላማውን : ጋራዦቹ ስፖንሰር ውስጥ ዓመቱም የሚፈልገውን
እግቡ : አረጋግጠው እንዲቃጠል ድረስም ታይቶባቸው ሊሆን
ለማድረስም : ተማረከ ጠየቀ ስለነበረም #ኛ ለእናቱ
ለ# : አያቶቼ ዛሬ ጋዜጣ የገንዘብ የነበረችውን
ወራት : ጵጵስናቸው ከማለቃቸው ድሃ #ኛ ለአባቱና
በማተሚያ : ጋዜጣ ስለነበረም አባቱ ልጅ ለአባቱና
ተቀጥሮ : የተማሩት ያድናችሁ የሚያደርገው ተቀጠረ ቤት
መሥራት : ሕንፃዎች አጠራር ኤምባሲዎች ከተመረቀ እንደሚኖርበት
እንደሚኖርበት : ማለፍ ቤት ድሃ ነበር #ኛ
ተረዳ : የአዲሶቹ መርቷል ያገኛል ጠየቀ ተቀጠረ
ከጊዜ : ቀጥሎም ስለነበረም አባቱ ለአባቱና
በኋላም : ሜትሮፖሊታንን መንበር አንዱና ግጥም ባንክን
የማተሚያ : ቲ ጋዜት ያኔ በሚገኝ *
መሣሪያ : ፖሊሲ አሁንም መልዕክት የሆነውን የገንዘብ
ገዛና : ይሰጥሃል ጎጆ የሚባል የሚችሉትን ታወቀ
ወደ : ጭፍን እቴጌይቱ አሠራር የዕርዳታ ፈጽሞ
አሜሪካ : ማስተካከያ መደብር የጻፋቸውና ጥረት ሮያል
በመመለስ : በዝምታ ጽሑፍና ያጋለጠው ሰላም በፖለቲካዊ
ፔንሲልቫኒያ : ቻይና የሚፈልገውን የገንዘብ የነበረችውን ቤት
ጋዜት : ውጭ የማተሚያ የገንዘብ በሚገኝ ለእናቱ
የሚል : አማኝ የደረሳቸው ክትትል የማተሚያ እንደማይችል
ጋዜጣ : በማተሚያ ለ# ማተሚያ ስለነበረም ልጅ
ማሳተም : ሆኖም ማጥናት እግቡ ዕርዳታ የሆነ
ጀመረ : ይጎድለናል አገናኙን አድርጓል ማተሚያ ለእናቱ
የጋዜጣው : የእውነቴን ያለ በአካል ወዲያውኑም በሚገኝ
ዋና : መኪና መምራት ፖፕ ኃላፊ የሚችለው
አዘጋጅም : በቁም ለአንድ ባነበበው ቢታወቅም በኋላም
እራሱ : በተከፈተ ገልጸው የሚፈቀድለት ሴኔጋል ወር
ስለነበረ : አስተዋጽኦ መለያ ከእንግሊዝ እራሱ የራሱን
ተቀባይነትና : አሜን በተሰጣቸው ለሙስና የአጫጭር ያስተምር
የሥራው : እየጠየቁ የተለያዩ በመወከል መንግሥትን ማተሚያ
ተነባቢነት : ሸኘን የመገንባቱን ፖስተር ቢታወቅም የፔንሲልቫኒያ
ከፍተኛ : ፊፋ እየረቀፁ ዩኒቨርሲቲ በኋላም ተቀጥሮ
ሆነ : በንግድ እዚህ የሚፈልገውን ቤት በሚገኝ
ቀጥሎም : በአዲስ ጉዞአቸውን ከጊዜ ወዲያውኑም ስለነበረም
ዛሬ : ትላለች ለ# መንግሥትን የነበረችውን በ#
ዩኒቨርሲቲ : ፊሎሶፊና የሚጠቁም አገሮች ከፍተኛ የገንዘብ
የሆነውን : ብሔራዊ የኢትዮጵያ ዋና የገንዘብ አሜሪካን
የፔንሲልቫኒያ : ሞት ፍጡራን ያመሰጠረበት ዕድል ኮሌጅ
ኮሌጅ : መምህርነት ተጋድሎ ሊሆን እንደነበረ የፔንሲልቫኒያ
አቋቋመ : ቤቶች ወጥቶ ተማረከ አድርጓል ያህል
ላይም : ማረፉን የፌስ ይጫወት በፖለቲካዊ ድሃ
ስለኤሌክትሪክ : አንዲት የኢትዮጵያ ሲጠጋው ዛሬ ጋዜጣ
ማጥናት : ሲሠራ ባንክን ማሳተም እግቡ ነገር
ዓመቱም : ፍረዱኝ በሴራሚክ ውስጥ ከተመረቀ ዓላማውን
ሮያል : አበርክቶው ቅኝ እንደማይችል ዕርዳታ የሆነ
ሶሳይቲ : ዲፓርትመንት ማስጠንቀቂያ በተያያዘም ይደርሳል ያለ
አባል : በቫቲካን ሞልቶ አዘዋዋሪዎችን ጥረት ድጋፍ
የመሆን : አንባረቁበት ብሔራዊነት ጊዜ አብረውት ተሳትፎ
ዕድል : ጭምር አለን እንደማይችል ዕርዳታ የሆነ
አጋጠመው : ብዛቱ የሚያውቁት ለማድረስም ጠየቀ ተቀጠረ
ቤንጃሚን : ብፁዕ ሕንፃዎቹም የፊፋ ከሳምንታት ፖሊሱም
ፍራንክሊን : ሠርግ ደስታዋን ጀምሮ ፍለጋ መስኩ
በሳይንስ : እርስ ድርጅት ሲከፍት ዩኒቨርሲቲ ለ#
መስኩ : የመጀመሪያ ሠርግ ደስታዋን ሞዛይክነት ፍራንክሊን
የሚያደርገው : ይገኛል ተቀጥሮ ተቀጠረ አንድ ስለነበረም
ምርምር : አጋማሽ ሴራሊዮን ኪሳራ የሆነ የራሱን
እየተሳካ : ይሰጥሃል ምናልባት እንደሚገመት ሊሸጥ በ#
እንደነበረ : እንደተመኘ እየጨመሩ ዓመት # በጅምር
ቢታወቅም : የመገንባቱን ሕግ ቢሆኑም ዩኒቨርሲቲ አዘጋጅም
በፖለቲካዊ : እንደሚያሳየው የሚገመተውን በቪዲዮ ላይም ከፍተኛ
እንቅስቃሴም : እያበሳጨው ባደረበት እጅ ድጋፍ ዓመቱም
ግንባር : የሺመቤት እንደሚያደርስ ቀደም #ኛ ለእናቱ
ቀደም : ሁለቱ ጥናቶችንና አሜሪካን ፊላደልፊያ ድሃ
ሚና : የሆነ ነበር ለአባቱና
ይጫወት : አይሥራው እኩል ቤትንም ጋዜጣዊ ላይም
ብዙ : ርዝማኔ ማሊ ላይቤሪያና እንዳይገቡ ያህል
ነገሮች : ጉዳዮችን ከፍ ተቀጥረው እንደሚያደርስ ቪክተርና
በጅምር : ከጊምቢ አካባቢዎች ለማወቅ ሆኖም ማሳተም
ቀርተውበታል : ሆነዋል ታትመውለታል ደርሷል ታወቀ አድርጓል
በአሜሪካ : መስኮት ብቻ ግለሰቦቹ ሳምንት የራሱን
ነፃነት : ደጃፍ በፈገግታ ስሙልኝ በመግለጽ ክሪቲካል
ላይ : ምንም ደብዳቤ አስገኝቷል በሚገኝ በ#
ሁነኛ : ውኃስ ሥልጠናዎችን እስከ ለማዋል ዓመቱ
ተሳትፎ : መለሰና ጦረኛ እጥረት ማይል የእንግሊዝ
በማድረጉም : ቁጥር እጅ ፔንሲልቫኒያ መሥራት በሚገኝ
የአሜሪካ : የሆነ በሚገኝ * #ኛ ለአባቱና
አብዮታውያንን : ራዲዮና ኢትዮጵያውያን የውጭ በ# *
በመወከል : ለአፍሪካ ብርና ጠቅሶ ወንጀለኛ የተለያዩ
ፈረንሳይ : መሆኑንና የ# ነገር ፊላደልፊያ #ኛ
ሄዷል : የደነገጠችው አስታውቀዋል ጥቅሶቻቸው ተረጋገጠለት ጠየቀ
ተልዕኮውም : ሆቴሉስ #ዎቹ ተሾመ ለአባቱና
ተሳክቶለት : አህጉሮች አደንዛዥ የመዘገበው ስለ ከማል
ድጋፍ : የፍልስፍናና ኢጣሊያ ያደረሰው እጅ እንቅስቃሴም
አስገኝቷል : ጥቅሶቻቸው ለማድረስም ስለነበረም አባቱ #ኛ
ከእንግሊዝ : አንዱ በ# * ነበር ልጅ
ቅኝ : ክህነቱ ጥረት ሮያል ተቀባይነትና ነገር
ግዛት : በኢንተርናሽናል በረባ አልኮርጅም መንግሥትን *
ከተላቀቀች : እኔን ከቫይረሱ አድርጓል ያህል በ#
በሁለቱም : ማለታቸው በራዲዮ ናይጄሪያና ሚና የሆነ
አገሮች : የገለጸች ኦስተን ለ# የገንዘብ ለእናቱ
መካከል : ተጓዥ የሚነሳ እኔና ቢታወቅም ድሃ
ሰላም : መልሰህ የሆኑ ችግር የፈጠራ ማቅረብና
ለመፍጠር : ተጠቅመው ዶላር በቪዲዮ ፔንሲልቫኒያ የሚፈልገውን
ጥረት : ብር የሆነ ፊላደልፊያ ነበር #ኛ
አድርጓል : አይደለም አይቷል ቀርተውበታል ጀመረ ገዛና
ተሾመ : #ዎቹ ሪፖርተር ከውጭ ተልዕኮውም ለአባቱና
ብርሃኑ : ብትን አንድ ድሃ ነበር ለእናቱ
ከማል : የወያላውን ተሰምቷል ጨርቅ ከጊዜ ተረዳ
ታላላቅ : አልቀረው ለመመረጥ እንዲቃጠል ራዲዮ መሻሻልን
ጸሐፊዎችና : መሆኑ ማለፍ እንዲቆዩ እንደሚኖርበት ድሃ
ጥቅሶቻቸው : አስታውቀዋል የላቸውም ሄዷል ተረዳ ተረጋገጠለት
# : ወዘተ የተወለደው እንደነበረ ድሃ *
ዓ.ም. : ጽሑፋዊና ማግኘት የምንዛሪ ይጫወት ዩኒቨርሲቲ
የፌስ : ላይም እራሱ ለአባቱና
ቡክ : ሲያደርጉ ለማግኘት ፖሊሶች በሚገኝ ልጅ
ጓደኛን : ማልማት ሰሎሞን ለማቋቋም #ኛ ለእናቱ
ፍለጋ : ያማርራል ሠርግ ክፍተቶች ፍራንክሊን የፔንሲልቫኒያ
ቤልጄማዊው : እንደራስ ያደረጉት ስለ ግን ያኔ
ቪክተር : ዮርዳኖሳዊው ካሜራ ገዛና #ኛ ለእናቱ
ቫን : እንከታተላለን ሥራዎች በተጨማሪም ፍለጋዬ ዩኒቨርሲቲ
ሮዚም : ያለውን ባነበበው ነገር አባቱ #ኛ
እንደ : ለማዋል ጥሩ ዓመቱ ለአባቱና
ወትሮው : ባህር የተገመተ ተልዕኮውም ቢታወቅም ከጊዜ
ፌስቡክ : ከእኔ ምን እንደሚቀርቡ ሐያቱ እሰጣ
ሲከፍት : ከአንደኛው በሳይንስ ለእናቱ ለአባቱና
ኒል : ከእነዚህ የምናውቀው ወይም አሰሱ በኋላም
ዲ : ደግሞ በጠሊቅ ጥሩ ነገር ዓመቱ
ፌቴክ : ተተኪ በአራት በአሁኑ ለአባቱና
ከተባለ : በፕሬዚዳንትነት ይሆናሉ ኄር ያኔ ድሃ
አሜሪካዊ : አሳዳጊዎችህን ስታስበው በተጨማሪም ፊላደልፊያ #ኛ
ወዳጆች : ያጉረመርማሉ ተመን ያጋለጠውን ከመደብር በላይ
እንዲሆኑ : ኢቢሲ ያመሰጠረበት ከሚያዘጋጀው እስከ የፔንሲልቫኒያ
የሚጠቁም : ዩኒቨርሲቲ ለእናቱ ለአባቱና
መልዕክት : ኃላፊ ምንዛሪ ሴራሊዮን መሣሪያ እንደማይችል
ያገኛል : ይደረጋል ተረዳ ተቀጠረ ለእናቱ ለአባቱና
የ# : የበቁት ዕውቁ በሴት ፈረንሳይ የአሜሪካ
ቪክተርና : አሳትሟል ሲሆን #ኛ ለእናቱ ለአባቱና
ተመሳሳይ : ሊያገኝ የገንዘብ አሜሪካን የራሱን ማተሚያ
ፍላጎት : ዓመታትን ኅትመቶች ሲጣጣሩ ጸሐፊዎችና እንደሚኖርበት
የላቸውም : ነን ጥቅሶቻቸው አስገኝቷል ሄዷል ቀርተውበታል
ሆኖም : ማዕረግና አይፈቀድለትም ማሳተም ዕርዳታ ማተሚያ
በፌስቡክ : አሳዳጊዎችህን ፊላደልፊያ ለእናቱ ለአባቱና
ጓደኞች : ቡና መነጋገሪያ አዘጋጅ ለ# አንድ
ለምን : ነን ታወቀ የላቸውም ቀርተውበታል አቋቋመ
እንደጠየቀው : ኢትዮጵያን ድሃ ለእናቱ ለአባቱና
ለማወቅ : መስማማታቸው አይፈቀድለትም አካባቢዎች በጅምር ዩኒቨርሲቲ
ስለ : ቅዳሜ ባደረበት ቤልጄማዊው ድጋፍ ተሳክቶለት
ፈጽሞ : በሐረርጌ በተጨማሪ በኋላም የእንግሊዝ አሜሪካን
የተለያዩ : የሥራው ማተሚያ ነበር ልጅ ለእናቱ
ሰዎች : በልቶ ላይቤሪያና በጅምር ድሃ ለአባቱና
ቢሆኑም : መመንዘር ቢታወቅም ድሃ ለአባቱና
ባነበበው : የሚሰጠው ዝግጅት ያለውን ሥራ ነገር
ተማረከ : ለማድረስም ያህል ጠየቀ በ# #ኛ
በአካል : በቡዳፔስትና በአራት ፖሊሱም ተሾመ ወዲያውኑም
መተዋወቅ : ጳጳስነት በአመራር በኋላም ስለነበረም አባቱ
እንዳለበትም : ካልተሠራ ሆነን ይመስለኛል ይጫወት የሚያደርገው
ወሰነ : አገኙ ተናግረዋል አሰሱ ዞሩ ጠየቀ
ከፊልም : ኪሎ የአገጣጠም ቆይታቸውን የአፋልጉን ለመፍጠር
ትምህርት : መፀዳጃ በማተሚያ ለ# ስለነበረም ድሃ
ከተመረቀ : አጠገብ ርቀት መሥራት ዓላማውን የነበረችውን
ጓደኛው : እግዚአብሔርና በሙሉ ከተባለ የሚፈልገውን የእንግሊዝ
ጋር : አለመመዘኑ እንዳይገቡ ቀደም አሜሪካ አሜሪካን
ሆኖ : ባንኮኒ ክህነትን ከሮም ቤቶች ሆኖም
ከ# : አምላክ የአገራችንን ግለሰቦች የውጭ የዕርዳታ
ማይል : ወግ የአቡነ የቤተ በእነዚሁ ተሳትፎ
በላይ : በሙሉ የእንግሊዝ ፊላደልፊያ #ኛ ለእናቱ
ተጉዘው : ካቶሊካዊት የአወሮፓውያኑ ያለፈ ግዛት መንግሥትን
ኦስተን : የተቃጠልነው አገሮች የገንዘብ ልጅ ለእናቱ
ቴክሳስ : ስትል ከውጭ ናይጄሪያና ለአባቱና
ገቡ : ያደረጋል አሰሱ ተቀጠረ ለእናቱ ለአባቱና
ጉዞአቸውን : ከአሜሪካዊቷ ቀጥሎም ከጊዜ በማተሚያ የእንግሊዝ
በሙሉ : በሰው አሥራተ ጳጳሳት በላይ የእንግሊዝ
በቪዲዮ : እንዲችው መመርያውን የፊፋ ለመፍጠር በፖለቲካዊ
ካሜራ : እንዲይዝ ቪክተር የሆነ ዓመቱ በ#
እየረቀፁ : ኮርስ ተቀምጠው በመሆንም መመንዘር አካባቢዎች
ውስጥ : በሴራሚክ ሠራተኞች ዓመቱም ዓላማውን የሚፈልገውን
ኒልን : መሆኑንም ለዮርዳኖሳዊው እየተነገረ መሻሻልን ታላላቅ
የሚያውቅ : መቼ ትምህርታቸውን ጽሑፍ ኃላፊ ዋና
ሰው : ግለሰቦቹ ብሔራዊ አካሄድ የሆነውን የራሱን
አጠያየቁ : አይታዩኝም አሰሱ ገቡ ጠየቀ ተቀጠረ
የምታውቁ : ካላስቀደማችሁኝ ከቦሌ የጂማ ነጋዴዎች ያለውን
አገናኙን : በስመ ከተላቀቀች ጀመረ ለማድረስም ሊያገኝ
ፖስተር : እንዲገኝ ተነባቢነት ዕርዳታ ነበር ልጅ
ለጠፉ : ባልነበረ አግኝቷል አቅርቦታል አለ ከማል
የአፋልጉን : ከፊልም ስለነበረም አባቱ ለአባቱና
ቲ : የሚወዳቸውን የማተሚያ ያኔ በ# ስለነበረም
ሸርት : ተቃጠለ ለአገሪቱ ዶላር ተቀጥሮ ግን
ለብሰው : ሲብጠለጠሉ የምንዛሪ ነፃ ላይም አንድ
ከተማውን : የዘለቀ ማለፍ ታይቶባቸው እንዲቆዩ እንደሚኖርበት
ዞሩ : ሰኔ ቆይቷል አሰሱ አጠያየቁ ጠየቀ
የጻፋቸውና : ማስተካከያ ሚና የሆነ አባቱ ነበር
የሚወዳቸውን : ቲ በ# * ለአባቱና
አካባቢዎች : በጅምር ነበር ልጅ ለእናቱ ለአባቱና
አሰሱ : አስታወቀ ገልጿል ገቡ ጠየቀ ተቀጠረ
ከአንድ : ግጥሞቹ ከሦስት የገንዘብ ማተሚያ ልጅ
ሳምንት : ይሁን ለሪፖርተር በአሜሪካ ለማቋቋም #ኛ
በኋላ : ማስጠንቀቂያ የምሩ ያለ ዛሬ መንግሥትን
በአንድ : ታዳጊ መጨረሻ ተቋሙን አንዱ ያለ
መጽሐፍ : ስብሰባ ውጭ ማሪዋና ጓደኛው በአሜሪካ
መደብር : ሳይስበው አሜሪካ ነገር የሆነ #ኛ
ያገኙት : የሆኑት መንግሥትን * ነበር ለአባቱና
አገናኛቸው : አይፈጠርም ወሰነ ተማረከ አቋቋመ በኋላም
በቪክተርና : ጋዜጠኝነቱን እንዲሁም በእነዚሁ የተጠቁት አብረውት
የተገረመው : ምዘናው አንዱ በኋላ በ# *
ለአንድ : ቢን አዘጋጅም በኋላም ነገር አንድ
ወር : እቴጌይቱ የሚፈቀድለት እራሱ ወደ ያኔ
አብረውት : አተረፈህ ሐያቱም የእናትህን ሲል የምታውቁ
እንዲቆዩ : ታይቶባቸው ጸሐፊዎችና እግቡ ድሃ ለአባቱና
ጋበዛቸው : ተደርጓል ይፈቀድላቸዋል ተረጋገጠለት ጠየቀ ተቀጠረ
ቆይታቸውን : የእኔን ከፊልም ስለነበረም አባቱ #ኛ
በካሜራቸው : ቢሸጡ ክርስቲያን ተገቢነት እንዳይጨምር አውጪዎችና
የመዘገበው : አደንዛዥ ተሳክቶለት ለእናቱ ለአባቱና
ፍለጋዬ : ሥራዎች ዳንኪ ላይም ዩኒቨርሲቲ አዘጋጅም
ትንሽ : ይጭናል ከጎኑ መሥርቶ አቀፍ አሜሪካ
መጠኑን : ለትከሻ የሚነገርላቸው የፈጠራ ተነባቢነት ለማቋቋም
ያለፈ : ጎጆ መንግሥትን የሆነ * ነበር
ሊሆን : ሲጣጣሩ እንዲቆዩ እግቡ የገንዘብ ድሃ
ይችላል : ኖሮ አይፈጠርም አገናኛቸው የሚያደርገው #ኛ
ያልተለመደም : ልጃቸው ለውጥ ከገባ ቢሆንም የተገረመው
ነው : ጽኑ በኋላ ትምህርት ዛሬ ተቀጥሮ
ቢሆንም : ያለፉ ቢሮዎች በ# * ነበር
እኔና : እሳትና ለእናቱ ለአባቱና
ጥሩ : ዓመቱ ለአባቱና
ሆነናል : የመንግሥት በቁጥጥር እንደነበረ ፍራንክሊን ስለነበረ
ሲል : ተሳፋሪውን የእናትህን ግለሰብ አሜሪካዊ ተሳትፎ
ለኦሬንጅ : የሚሸለም የሚጠበቁት አጠራር ጅምር ሕጋዊ
ኒውስ : ድረስም ሊሆን መስኩ ዕርዳታ የራሱን
ገልጿል : አስታወቀ አሰሱ ገቡ ጠየቀ ተቀጠረ
ራሱን : ከተለያዩ ቁጥር ባንኮች ዓመቱም የሆነውን
ያጋለጠው : በመስጠት በመመለስ ለእናቱ ለአባቱና
ዕፅ : ሁል ያጠናከረው ሲወጣ በኢኮኖሚው የራሱን
ሻጭ : ከእነዚህ አይታዩኝም ገጣሚና ኒል አዘጋጅም
ፖሊሶች : የኳታር የሚባል ቡክ የነበረችውን የሆነ
አደንዛዥ : አህጉሮች የመዘገበው ተሳክቶለት በመመለስ ለእናቱ
አዘዋዋሪዎችን : ይዣለሁ የሚፈልግ አባል ማሳተም አሜሪካ
በቁጥጥር : ከተደረገ ሆነናል ፍራንክሊን እግቡ ድሃ
ስር : እየጠየቁ ቢሮዎች የሥራው ገዛና መንግሥትን
ለማዋል : ዓመቱ አባቱ ለአባቱና
ክትትል : ከተጎዱት የሚል የሆነ ቤት በሚገኝ
ያደርጉባቸዋል : ያቆምነው ይጠይቃሉ ተችሏል አሰሱ ገቡ
አዘዋዋሪዎቹም : ብፁዕ ሁለተኛው ከሳምንታት ቤንጃሚን ለማቋቋም
ፖሊስ : ርዝማኔ ሲወጣ ገንዘብ የነበረችውን አሜሪካን
እጅ : ከመሠረቱት ሠራተኞች በማድረጉም እንቅስቃሴም ፔንሲልቫኒያ
እንዳይገቡ : ሾፌሩን ሲወጣ ጋር ብዙ አሜሪካ
ሲጣጣሩ : ሊሆን ፍላጎት ማሳተም የገንዘብ ድሃ
ይስተዋላል : ተቀብለዋል አይቷል ቀርተውበታል ጠየቀ ተቀጠረ
ከፍሎሪዳ : አዲሶቹ ወዲያውኑም ለአባቱና
የተሰማው : ሴኔጋል ጋዜት በሚገኝ ለእናቱ ለአባቱና
ዜና : ተወኝ ግዛት ቢታወቅም የሥራው መንግሥትን
ከተለመደው : እንዳዩት ሚኒስትሩ እንደሚታየኝ ብሔራዊ ላይቤሪያና
አካሄድ : የሚመስለው አስፈላጊውን ጊኒ ሰው ሊያገኝ
ወጣ : አገር ጎረቤት ላይቤሪያና አሜሪካ አሜሪካን
ያለ : በኋላ ሶሳይቲ ዛሬ የጋዜጣው ልጅ
ዓመት : የኢትዮጵያውያን እንደነበረ በ# ነበር #ኛ
አዘዋዋሪ : ድምፁን ያደረገ ካልሆነ ፖሊሶች ቡክ
የሚፈልግ : አዘዋዋሪዎችን ለማወቅ በሳይንስ አባል ያህል
አለ : አግኝቷል ብርም ሄዷል የማተሚያ በሚገኝ
የእውነቴን : የጋዜጣው ወዲያውኑም ልጅ ለአባቱና
አደገኛ : ሰሎሞን መጠን አገር ብሔራዊ የመሆን
ይዣለሁ : አዘዋዋሪዎችን አባል የሚል ዕርዳታ ቤት
ቲሸርት : ወጥታ ካቶሊካዊ ይደርሳል ጋዜጣ በማተሚያ
ለብሶ : በአክሲዮን አጠገብ በኩል የምንዛሪ ውስጥ
ከመደብር : ከጨረታ የሊዝ ሥፍራ መሥራት የነበረችውን
ይዘዋወር : ከጊምቢ ልጅነት በጅምር እንደሚኖርበት *
ቲሸርቱን : በሴት የ# ፈረንሳይ ስለፈለገ አባቱ
ያየ : የሚነጋገረው ጓደኛው በመመለስ ለእናቱ ለአባቱና
ለጥያቄ : የፍልስፍናና ኢጣሊያ አውጪዎችና ዋና ስለፈለገ
ሲጠጋው : ልቦለድ የዕርዳታ ስለኤሌክትሪክ ጋዜጣ በማተሚያ
ማሪዋና : ስብሰባ በጋራ መጽሐፍ ጓደኛው የገንዘብ
ሊሸጥ : ተነጥቆ በመምራት በእስልምና እንዳይጨምር እየተሳካ
እየተደራደረ : አስኪያጅነት አገላለጹ ፍላጎት ነበር ልጅ
ፖሊሱም : በሌላ በአካል ወዲያውኑም ለአባቱና
ያጋለጠውን : ወዳጆች ዓመቱም ዓላማውን የነበረችውን ለእናቱ
ወንጀለኛ : አንሶ ማኅበራዊ እንደማይችል ዕርዳታ ማተሚያ
ሕግ : ሺሕ ቢታወቅም አዘጋጅም ወራት ማተሚያ
ፊት : ልጅነት ጭማሪ ነበር ልጅ ለአባቱና
አቅርቦታል : ይጠየቃል ነበረው ለጠፉ ተቀጠረ በሚገኝ
የኢቦላ : አዲሶቹ አባቱ #ኛ ለአባቱና
ቫይረስ : መሰለ ዲግሪውን ከቀሰመው ወትሮው እንደነበረ
በምዕራብ : ምክትል እንደዘገበው የዓለም ፖስተር ለ#
አፍሪካ : የተቃጠልነው ከሐረር ዲግሪውን ንባብ ኦስተን
ያደረሰው : ካቶሊክ የፍልስፍናና ድጋፍ ስለፈለገ በሚገኝ
የኢኮኖሚ : ራዲዮ የኢትዮጵያን ያጋለጠውን ፊላደልፊያ ለእናቱ
ኪሳራ : በሥፍራ የተመረጠችበት መሆናቸው ምርምር ስለነበረ
ቢልዮን : የሰሎሞን ከዚህም አባቱ ለአባቱና
ዶላር : በሚያካሂዱበት ኑዛዜ ይመስለኛል ሸርት ለመፍጠር
እንደሚገመት : ይሰጥሃል የነበረውን የሚችለው የሆነ በ#
የዓለም : ሮሮ የመገበያያ በምዕራብ በማተሚያ ገንዘብ
ባንክ : አገሮች ለ# አንድ ልጅ ለእናቱ
አስታወቀ : ለየው ገልጿል አሰሱ ገቡ ጠየቀ
አጃንስ : ጋዜጠኛና በዚህም ስለ እንደ ተልዕኮውም
ፍራንስ : ከተደረገ ሥልጠናዎችን በቁጥጥር ሆነናል #
ፕሬስ : አስታውቀዋል አገሪቱ ሲከፍት ሄዷል በሳይንስ
ዓለም : አዳዲስ ፖስተር ተነባቢነት ገዛና ዕርዳታ
ባንክን : ኩላሊት ካለመቻላቸው ልምዱን ራይቲንግ እንደሚያደርስ
ጠቅሶ : ነጋዴዎቹ ክሪቲካል ፍለጋ ነፃነት የፔንሲልቫኒያ
እንደዘገበው : ለኢትዮጵያና የመገበያያ በወረርሽኙ በምዕራብ ያጋለጠው
ክፉኛ : ባለብርሃን ባነፈሰው ውጪ ልምዱን ፊላደልፊያ
የተጠቁት : ምክትል እስከሚያገለግልበት በሚገኝ #ኛ ለእናቱ
ጊኒ : ራሳቸውን መሆናቸው አካሄድ ስለኤሌክትሪክ የራሱን
ላይቤሪያና : ያልተረጋገጠው እንደሚታየኝ አሜሪካን የሆነ ፊላደልፊያ
ሴራሊዮን : ሞልታ ኃላፊ ምርምር መስኩ ዋና
ኢኮኖሚያቸው : የማይችል ለአምስት ዩኒቨርሲቲ ለ# የገንዘብ
አሁንም : ክህነቱ ሲጣጣሩ ሊሆን ቅኝ መሣሪያ
እየተጎዳ : አስቡት የመጣ ቢሆኑም ዩኒቨርሲቲ ተነባቢነት
በእነዚሁ : ይላል በ#ዎቹ ማይል ዓላማውን የሚፈልገውን
በተያዘው : በተደረገው በኦሬንታል ያመሰጠረበት ኢትዮጵያዊ እስከ
የአወሮፓውያኑ : ተቃውማችሁ ሆነን ተጉዘው ግዛት *
በሚኖረው : ጠቅላላ የፕሮግራም ጊኒ በፌስቡክ ላይም
ዕድገት : ሙሽራ ክሪቲካል ፍራንክሊን ተቀባይነትና ትገዛ
እንደሚያደርስ : ጉዳዮችን እንዳይጨምር ባንክን ግንባር ማጥናት
የተገመተ : ባህር ወትሮው ኮሌጅ የሥራው እራሱ
ሲሆን : ጉበት መድኃኒዓለም ቪክተርና ቀደም ግንባር
ባለፈው : በእጃቸው የ# ፌስቡክ ፈረንሳይ ዓመቱም
ከተገመተው : አሰሱ ገቡ ቪክተርና ጠየቀ ተቀጠረ
ቢሊዮን : የሚጓዙ ማስተካከያ ግዛት ብዙ ዛሬ
መሻሻልን : እንዳስታወቀው የትውልድ ኒልን ታላላቅ ፊላደልፊያ
አሳይቷል : ትመስላለህ አጠናቋል ደሬሳ ዞሩ ያገኛል
ለዚህም : በካሊፎርኒያ ጋዜጠኝነቱን በአሁኑ ዓላማውን ነገር
ምክንያቱ : ሊገነቡ ሥርጭት እግቡ የእንግሊዝ ድሃ
ወረርሽኙ : በኩል ተጠቅመው የነበሩበትን የሚፈልገውን ለማቋቋም
ታይቶባቸው : እንደሚያመለክተው እንዲቆዩ ድሃ ለእናቱ ለአባቱና
የነበሩት : ሥራ ፊላደልፊያ ለአባቱና
ማሊ : በሌሎችም ለቆ ሊያገኝ የነበረችውን አሜሪካን
ናይጄሪያና : በሁለቱም ሚና የሆነ ወዲያውኑም ለአባቱና
ሴኔጋል : የሚፈቀድለት ማገዙንም እራሱ ጋዜት ወደ
በአሁኑ : ኪሎ ሳቢያ ፌቴክ ግን ለአባቱና
ጊዜ : ስትሆን ዕቃ የመሆን ፊላደልፊያ #ኛ
ከቫይረሱ : ትወለዳለህ ያህል ማተሚያ ስለነበረም ነበር
ሙሉ : የሚያደርገው ተቀጥሮ ቤት አንድ በ#
ነፃ : ዙሪያ ለብሰው ለአባቱና
መሆናቸው : ራሳቸውን ጊኒ ኪሳራ የገንዘብ የነበረችውን
የኢቦላን : እናንተና ቫቲካን መንፈሳዊንት በእነዚሁ ማይል
ሥርጭት : የደሃና የፍራፍሬ ምክንያቱ መስኩ ፍራንክሊን
በመቆጣጠር : አሁን ታወቀ ዓመት የሚያደርገው ተቀጥሮ
ብሎም : እየጠየቁ የሥራው መንግሥትን በ# *
በወረርሽኙ : ሸምድዶ አፍ እንደዘገበው ለማዋል ጥሩ
ከተጎዱት : ክትትል አባል ጋዜት በሚገኝ ፊላደልፊያ
ጎረቤት : ጉስቁልና ወጣ አሜሪካ ገንዘብ ወዲያውኑም
እንዳይዛመት : እግር የመንግሥት ፍራንስ አጋጠመው ተረዳ
ፖሊሲ : አውቀዋል የታሪክ መሣሪያ የገንዘብ የራሱን
አውጪዎችና : አባላቱ የቀበሌና ኢጣሊያ ለጥያቄ በካሜራቸው
የዕርዳታ : የአየር የገለጸች ሲጠጋው ወደ የራሱን
ሠራተኞች : እስር ውስጥ መሥራት የሚፈልገውን የነበረችውን
ያደረጉት : የሚወዳቸውን ቤልጄማዊው ግን ያኔ ለአባቱና
እገዛ : ቢሆን በቅርቡ ማገዙንም ሴኔጋል ሲጠጋው
በኢኮኖሚው : ከአጭር ሲወጣ ፖሊስ ዕፅ ገንዘብ
ይደርሳል : ወጥታ በማተሚያ ስለነበረም ልጅ ለአባቱና
ተብሎ : ይፋ በመገናኘት ምርምር እራሱ የማተሚያ
የሚገመተውን : ጤና ብርሃኑ ተቀጥሮ ተቀጠረ አንድ
እንዳይጨምር : በእስልምና ሊሸጥ በካሜራቸው ፈረንሳይ ነገር
ማገዙንም : አገልግሎትም ታሪክ ሴኔጋል የተገመተ የመዘገበው
ባንኩ : ዕርዳታ የገንዘብ ነበር ልጅ ለእናቱ
የኢትዮጵያ : አፍሪካን ስለኤሌክትሪክ የሆነውን የራሱን በ#
ብሔራዊ : አይደል ይመክራል ትውስታ ሰው የሆነውን
ማንኛውም : ጊዜያት መያዝ ፖሊሲ መሥራት የነበረችውን
ግለሰብ : የኮንዶሚኒየም ሲል የመሆን ትገዛ #ኛ
አገር : ወጣ ፊላደልፊያ ልጅ #ኛ ለአባቱና
ሲገባ : በመገናኘት እጥረት ሥልጠናውን የሚፈልገውን ፊላደልፊያ
ወይም : እንደዚህ ከተደረገ የትግራይ አዘጋጅም በኋላም
ሲወጣ : በኢኮኖሚው ፖሊስ ገንዘብ አሜሪካን የራሱን
መያዝ : ማንኛውም መሆናቸው ለብሶ መሥራት የነበረችውን
የሚችለው : የነበረውን የሆነ * ነበር ለአባቱና
ብርና : የሚሆን ኢትዮጵያዊ በመወከል ገዛና መሣሪያ
የውጭ : ሲያስመካው ሾፌሩ መለያ ሃይማኖት ራዲዮና
ምንዛሪ : ምንዛሪውን አሜሪካ የሆነ የራሱን በሚገኝ
መጠን : የሆኑ በርካታ በሚከናወነው በመመለስ ለእናቱ
ማስተካከያ : የጻፋቸውና አሜሪካ የሆነ ስለነበረም አባቱ
ማድረጉ : ያስተላልፍ ግጥሞቹም ይዘዋወር ከተማውን የገንዘብ
ታወቀ : ታኅሣሥ አይደለም ቀርተውበታል ገዛና ጠየቀ
ከሳምንታት : ከመንፈቅ ሁለተኛው ዘበት ዓመቱ አባቱ
በፊት : ስንቶቻችን ቫን ትገዛ ፊላደልፊያ ለእናቱ
ባወጣው : ለመጠቀም እጅ በማድረጉም የሚፈልገውን በሚገኝ
የማሻሻያ : ሱፐር ጽሕፈት ታሪክ የኢትዮጵያ አፍሪካ
መመርያው : እንደዘገበው ዓለም ለማዋል ጥሩ ትምህርት
መሠረት : ጽሑፍና ሠራተኞች ለ# ድሃ ለአባቱና
የሚገቡም : ተቀምጦ ዓውደ ኢኮኖሚያቸው ላይም እራሱ
የሚወጡ : ቆይታችሁ የሞዛምቢኩ ተሰብስቦ ባንክን በኋላም
ተጓዦች : ምነው በላይ ወዳጆች ቀደም የእንግሊዝ
በእጃቸው : ይዳዳታል ባለፈው የ# በመወከል የነበረችውን
እንዲይዙ : ተሰብስቤ እንዲይዝ ጸሐፊዎችና ሚና ማሳተም
የሚፈቀድላቸው : የነፍሴ ግሪጎሪያን በሙስና ካፍ ለኢትዮጵያውያን
ብርም : ሰላማዊ ይገጥማል ኦርቶዶክስና አለ ያለ
ጭማሪ : ልጆችም እንዲገኝ እንደማይችል የሆነ ነበር
ከዚህ : ጳጳስነት መመርያውን ገልጸዋል በቪዲዮ ለመፍጠር
የነበረው : ጽሕፈት ማረጋገጫ ዲግሪውን በስመ ማተሚያ
መመርያ : አሜን ድካም ደካማነትና ከአባቱ የመንግሥት
የወጣው : ሰጥቶ የሚሆን ማንኛውም የነበረችውን የሆነ
በዚህም : ሆቴሉስ ተልዕኮውም ለአባቱና
ከኢትዮጵያ : መስኮት ያነጋገራቸው በማድረጉም በአሜሪካ ተቀጠረ
የሚነሳ : አምባሳደር ተማሪ አሠራር ወደ በኋላም
ተጓዥ : መካከል ይጫወት ድሃ ለእናቱ ለአባቱና
እስከ : ተፈተለከ እምነት በኦሬንታል ለውጥ በተያዘው
ብር : ግብግብ መደብር ጥረት አሜሪካ ነገር
እንዲይዝ : ካሜራ ቪክተር ሚና ዓመቱ #ኛ
የሚፈቀድለት : ቅርብ ሴኔጋል እራሱ ወደ የራሱን
ጂቡቲ : ኤምባሲ ጎረቤት ወጣ ፖሊስ አሜሪካ
የሚጓዙ : ተቀጥረው ቢሊዮን መደብር ቅኝ አሜሪካ
ድረስ : ታደሰ ጥያቄ ፖሊስ እንደማይችል የነበረችውን
ይፈቀድላቸዋል : ነዋሪ ጋበዛቸው ተረጋገጠለት ጠየቀ ዕርዳታ
በነበረው : ከዛሬ እየጨመሩ አካል እየተሳካ መሥራት
አሠራር : በስደት ወደ ድሃ ለእናቱ ለአባቱና
አይፈቀድለትም : ኢንቨስትመንት ለማወቅ ሆኖም የሚጠቁም ቢታወቅም
ከውጭ : ስትል #ዎቹ ተሾመ ተልዕኮውም ለአባቱና
በተያያዘም : ቲሸርት ሶሳይቲ ዛሬ ጋዜጣ ልጅ
ኤምባሲዎች : ሕክምናውን መሥራት የገንዘብ ቤት በሚገኝ
ተቀጥረው : ስብጥሩም በተካነበት የሚጓዙ ነገሮች ተቀባይነትና
የሚሠሩ : መሆንን ድርጅቶች ራስን ከእናቱ በፖለቲካዊ
አቀፍ : ጉንፋን ተመሳሳይ ሊያገኝ አሜሪካን የራሱን
ተቋማት : ይነጋገራል ገጸ በፖለቲካዊ በሳይንስ ላይም
እንዲሁም : አዲሶቹ በቪክተርና አባቱ #ኛ ለአባቱና
ዓውደ : የሚመለከት በተፈሪ አፍሪካን ቢሮዎች ብርም
ጥናቶችንና : የተሰየመች ቀደም ቢታወቅም አሜሪካ አሜሪካን
ሥልጠናዎችን : ሥርዓት ሁነኛ ወራት ተረጋገጠለት ትገዛ
ለመሳተፍ : ከመቆም አይሃለሁ ጽሑፍ ኒልን ታላላቅ
ውጭ : መሪዎች በበኩላቸው ጋዜት የእንግሊዝ ያኔ
ግለሰቦች : ክርስቲያናት አዘጋጅ ከ# ማተሚያ በ#
ከሦስት : ክርስቲያኒቷ ጽኑ ግጥሞቹ የድጋፍ አፍሪካ
ሺሕ : ቡትቱ ሕግ ቅኝ እግቡ ያህል
እንደሚችሉ : ማዕረግ ኃላፊ ዕድል ማሳተም የሆነ
ተደንግጓል : ጠየቀ ተቀጠረ ለእናቱ ለአባቱና
ይኼን : አስታውቋል ያገኛል ተረዳ ጠየቀ ትገዛ
ፈቃድ : ሲያንጣጣው ተመሳሳይ ሊያገኝ አሜሪካን የራሱን
ለማግኘት : ቡክ በሚገኝ ነበር ለእናቱ ለአባቱና
ግለሰቦቹ : ሰው በአሜሪካ መስኩ የራሱን #ኛ
የድጋፍ : ጥያቄዎች ከሦስት በ# * #ኛ
ደብዳቤ : ሌሰላው ምንም አስገኝቷል ላይ አባል
ከቀጣሪዎቻቸውና : ማሻሻያ ጉባኤውን ጎጆ ጊኒ እየተሳካ
ሥልጠናውን : የሆነ ፊላደልፊያ #ኛ ለአባቱና
ከሚያዘጋጀው : ባላጡ ሞቱ አብዛኛዎች ተማሪ ኢኮኖሚያቸው
አካል : ወርልድ ሹመቱ መሬት ኳስን የዓለምን
ማቅረብና : ገጣሚና ሰላም የመሆን አሜሪካን ፊላደልፊያ
አስፈላጊውን : አትሌት አካሄድ ፖሊስ ሰው መልዕክት
የባንክ : ታሪክ የሻረ የተገመተ የሥራው ማተሚያ
ሥርዓት : ሥልጠናዎችን እንዳይዛመት ጓደኛን ሁነኛ አጋጠመው
ማለፍ : ታይቶባቸው እንደሚኖርበት ድሃ ነበር ለእናቱ
ይኖርባቸዋል : አረጋግጠዋል የላቸውም ላይ ተቀጠረ በሚገኝ
ጣሪያው : በል ስለሆነ በእስልምና ተጠባቢነቱ መጠኑ
ብቻ : ጋዜት በሚገኝ #ኛ ለእናቱ ለአባቱና
በተጨማሪም : ወዲያው ሁኔታ አሜሪካዊ ቫን የፌስ
ዜግነቱ : እያወጋን ራዲዮ ፊላደልፊያ * ልጅ
ኢትዮጵያዊ : በጸሐፊነት ብርና በተያዘው #ኛ ለእናቱ
ነዋሪ : ይፈቀድላቸዋል ብርም ያለ ተረዳ ጠየቀ
ያለው : አስደናቂ አሊ ከተማ ያገኙት መንግሥትን
ይዞ : የፊፋው በእጃቸው ባለፈው በመወከል ኮሌጅ
ከገባ : አይ ነኝ ያልተለመደም በ# ስለነበረም
ቀናት : ድንገተኛ በመመረጥ የሚወጡ ጋር የእንግሊዝ
በእጅ : የወጣው የነበረችውን በሚገኝ አባቱ ነበር
እንዲገኝ : ሰቀቀን ፖስተር ጥረት ማሳተም የሆነ
አይፈቅድም : አይፈቀድለትም ይፈቀድላቸዋል የሚፈቀድለት ኒውስ ሆኖም
ከማለቃቸው : ወራት ዓመቱ ድሃ ለአባቱና
ለሚመለከተው : ታክሲዋን ለእውነት ገጸ እጅ ሲከፍት
ማሳወቅና : አስነሳ በግብፅ ባጋጠማቸው ነፃነት #ኛ
ምንዛሪውን : ዘመናዊ ምንዛሪ እንደማይችል ያህል ዕርዳታ
ሕጋዊ : ቀዘባዋ ከሽብር ጅምር የምንዛሪ መያዝ
በሆኑ : መሆናቸውን አካባቢዎች ቅኝ መሣሪያ እንደማይችል
መቀየሪያ : አዘጋጅም ተረጋገጠለት በ# * ነበር
ቢሮዎች : እየጠየቁ ስር ቢሆንም ግዛት የሥራው
መመንዘር : የዘለቀ ቢሆኑም ዩኒቨርሲቲ ከፍተኛ ማተሚያ
አለበት : የአዲሶቹ ጠየቀ ተቀጠረ ለእናቱ ለአባቱና
መጠኑ : ሠራሽ በሽንጣም በአዲሶቹ ላይቤሪያና ሰዎች
በታች : አለመመዘኑ እንጂ መንፈሳዊነት አገር የምታውቁ
ከሆነና : የ#ቱ መሆኑንና ከቀሰመው የ# ከማል
ግለሰቡ : በዚህ ናይጄሪያና ቴክሳስ ወዲያውኑም አባቱ
የጉዞ : ለመምራት ቲ የማተሚያ #ኛ ለእናቱ
መረጃ : የካፍ ያለ አጋጠመው ሶሳይቲ ልጅ
ካሟላ : ሰጥቶ የሚችለው የሆነ ነበር ለአባቱና
ገንዘቡን : ተፎካካሪ ሮዚም ነገር ወዲያውኑም ለእናቱ
ካልሆነ : እኛ በጸሐፊነት ብር እንዳይጨምር ኒልን
ቪዛው : አኅጉሮች አቡነ ቴክኖሎጂ የራሱን ለእናቱ
እስከሚያገለግልበት : የተጠቁት ይዣለሁ ድጋፍ አባል በሚገኝ
ይህ : እነዚህ ማይል ወዲያውኑም ፊላደልፊያ አባቱ
አዲስ : የገለጸች ትይዩ እኔና ወደ ልጅ
የነበሩበትን : ወረርሽኙ የሚፈልገውን የገንዘብ የነበረችውን ቤት
መመርያዎች : ካለመቻላቸው በተካነበት ተቀጥረው ያለፈ በካሜራቸው
የሻረ : እየጠየቁ የሥራው ገዛና ማተሚያ በ#
ተፈጻሚነቱም : እንደተደረሰበት በጄኔራል አካል ውስጥ መስኩ
አገሪቱ : የብላተር ፕሬስ ከተባለ ሲከፍት ሄዷል
በቅርቡ : ልቦለድ እገዛ ከ# ልጅ ለእናቱ
ካስተዋወቀችው : ከዛሬ የአንዲት ለየት ገዛና ቤት
በመቶ : መድበል ሚና የሆነ ነበር ለአባቱና
የምንዛሪ : ከሽብር ጅምር ለብሰው ዓ.ም. ላይም
ተመን : ወዳጆች የራሱን ለእናቱ ለአባቱና
ለውጥ : ንጉል ያልተለመደም በ# * ልጅ
አብሮ : የራስህ የሆነ ነበር ልጅ ለአባቱና
የመጣ : ማንነት አነጋጋሪ እየተጎዳ እየረቀፁ ቢሆኑም
ምንም : ላይ ሶሳይቲ ዛሬ ያኔ በሚገኝ
እንኳን : ኑዛዜ ጥበባዊ የ# ወትሮው ተልዕኮውም
የሚችሉትን : የሚሆን የሚባል የሚችለው ገዛና ገንዘብ
ከፍ : መንገዱን የቴሌቪዥን ያመሰጠረበት ነገሮች መስኩ
ያደረገ : እየታዩ ተቋማት የሚፈልግ ፍለጋዬ ቤልጄማዊው
አሁን : አንዱና ለአገሪቱ መኖሪያ በቡድሂዝምና በመቆጣጠር
ባለው : ልብ አዘጋጅም ነገር ለአባቱና
ነባራዊ : ከአባቱ ላይም * ልጅ ለእናቱ
ሁኔታ : በተጨማሪም አሜሪካዊ ቅኝ ፊላደልፊያ *
እዚህ : አጠገቤ ተግባር ፔንሲልቫኒያ የሚፈልገውን የገንዘብ
ግባ : እሰጣ መግዣ አገር ወጣ የመሆን
የሚባል : የሚሆን የሚችሉትን ገዛና የነበረችውን የሆነ
ከባንኮች : በእንግሊዝ ባጋጠማቸው ሲገባ የመሆን ትገዛ
እያገኙ : ማወቅና በመምራት ዳይሬክተር ነገር #ኛ
እንዳልሆነ : በዕድሜ ልቦለድ ምንዛሪውን ከቫይረሱ እንደነበረ
ተችሏል : ያደርጉባቸዋል አሰሱ ጠየቀ ተቀጠረ #ኛ
ከዚህም : ቢልዮን ቴክሳስ ሚና አባቱ ለአባቱና
በተጨማሪ : መሸሽ የፌስ ወደ ፊላደልፊያ ለእናቱ
ባንኮች : ከመቆም መያዝ መሆናቸው ለብሶ መሥራት
ባጋጠማቸው : የመጀመርያው የሰው ማሳወቅና የመሆን የፔንሲልቫኒያ
እጥረት : በተካሄደው የሚፈልገውን የእንግሊዝ ቤት ፊላደልፊያ
ሳቢያ : ባረባው #ዎቹ በአሁኑ ዶላር ተሾመ
አዳዲስ : ዓለም ተሳክቶለት ተነባቢነት ገዛና ተረጋገጠለት
ፋብሪካዎች : ሦተኛው ሥልቱ ሊያገኝ ዕርዳታ የገንዘብ
እያቋቋሙ : ካቶሊክ ቫሉታ ድጋፍ እንቅስቃሴም በሳይንስ
ያሉ : ግጥሞቹ ከቫይረሱ ሆኖም በጅምር ጋዜጣ
ባለሀብቶች : ስብከት ቢሊዮን የጻፋቸውና ገንዘብ አሜሪካን
ለጥሬ : ሐሳብ ጅምር መናገሩም ለብሰው በፖለቲካዊ
ዕቃ : ጊዜ ወረርሽኙ ፖሊስ ገዛና የነበረችውን
መግዣ : አገር ታላላቅ ፊላደልፊያ ልጅ ለእናቱ
የሚሆን : የሚባል የሚችሉትን ብርና የሚችለው የነበረችውን
ማግኘት : ኤጀንሲ ተጣፍኩኝ ተቀጥሮ አንድ ነበር
ባለመቻላቸው : ሊያካሂዱት በኦሬንታል እና እንዲይዙ በተያዘው
የፍራንኮ : ሆነን ሕግ እንዳለበትም ወራት ድሃ
ቫሉታ : በጥያቄ የነፃነት አርት እያቋቋሙ ባወጣው
መብት : በተለያዩ ጊኒ ምርምር ስለነበረ እራሱ
ተጠቅመው : ወረርሽኙ ለመፍጠር ፔንሲልቫኒያ መሥራት የሚፈልገውን
ለማስገባት : እጁን ሥልጠናውን በሁለቱም ሚና መስኩ
እየጠየቁ : የሥራው ገዛና መንግሥትን ነበር #ኛ
መሆናቸውን : አለማወቅ በሆኑ ሆኖም ፍላጎት ዕርዳታ
ታውቋል : ግንቦት ቆይቷል ዞሩ ጠየቀ በ#
ፍራንኮ : ጋዜጣ በማተሚያ ያህል ማተሚያ ልጅ
ለመጠቀም : ባወጣው ለመፍጠር በማድረጉም ፔንሲልቫኒያ የሚፈልገውን
የሚቀርቡ : ከተመረጡ ሆነ የሚፈልገውን የእንግሊዝ የነበረችውን
ጥያቄዎች : እንኳ የነበረውን በመሆኑ የድጋፍ የኢትዮጵያ
እየጨመሩ : ኮንቲኔንታል ማኅበር እንደነበረ ዕድል የፔንሲልቫኒያ
መምጣታቸውን : የንግድ ቀዬውን ከሦስት እንዳይዛመት ፍራንስ
ሪፖርተር : ተሾመ ቤንጃሚን ስለነበረም አባቱ ለአባቱና
ያነጋገራቸው : ከኢትዮጵያ በማድረጉም ለ# ጠየቀ ተቀጠረ
የመንግሥት : በጎደላቸው እግር ሳልሞት ሆነናል አብዮታውያንን
ኃላፊ : ጉዳይ ሴራሊዮን መልዕክት ዕድል ዋና
አረጋግጠዋል : ይኖርባቸዋል አጠያየቁ ገቡ ጥቅሶቻቸው ጠየቀ
በኩል : ወረርሽኙ ለብሶ በሁለቱም ዓመቱም የሚፈልገውን
ስታስበው : ተሳፋሪውን ራዲዮ አሜሪካዊ ፊላደልፊያ ድሃ
ኢትዮጵያ : በቡዳፔስትና እያሉ እንቀበላለን በብቃት በሌላ
ተቀምጦ : የሚገቡም አገሮች ለ# ጠየቀ ተቀጠረ
እኔ : እንጂ ለአንድ አሜሪካ ነገር አሜሪካን
የትግራይ : ልብ አዘጋጅም ነገር ለአባቱና
ነኝ : ሽር ከገባ ግዛት መንግሥትን ስለነበረም
አማራ : በምክትል ዳይሬክተር ተጓዥ መካከል ይጫወት
ብሎ : መቼም የኢትዮጵያና በመጪው በእነዚሁ ፖሊሱም
አፍ : በወረርሽኙ እንደዘገበው የዓለም በምዕራብ ለማቋቋም
ሞልቶ : እላፊ አባል አሜሪካ ነገር ስለፈለገ
መናገሩም : ሳንባ ለጥሬ መሠረት በቪዲዮ በፖለቲካዊ
አለማወቅ : ሊሆን እንዲቆዩ ጸሐፊዎችና በጅምር እግቡ
ይመስለኛል : ለወያላው እንዳለበትም የሚያደርገው ተቀባይነትና ተቀጥሮ
በሴት : ዕውቁ ቲሸርቱን የ# ድጋፍ ፈረንሳይ
አያቶቻችን : በምን ሦስተኛው ለማቋቋም ዓመቱ ድሃ
በራፍ : የፍራፍሬ የሴት ሥርጭት ነፃነት #ኛ
ማን : ፍጡሮች ሠራሽ ግዴታ አብዮታውያንን ዕድል
እንዳለፈ : እያሽከረከረ ሚካኤልን ከእነዚህም ሥራዎች ዙሪያ
ስንቶቻችን : በፊት ከተለመደው የተሰማው ወር ላይ
ነን : የላቸውም ሄዷል የሚል ለማድረስም ያህል
የምናውቀው : የተቀጠረው አሰሱ ገቡ ኒል በኋላም
የእኔን : ቆይታቸውን ከፊልም ለመፍጠር ነገሮች ግን
ኦሮሞነት : የነበሩበትን በእነዚሁ ጊኒ የሚፈልገውን የነበረችውን
እግዚአብሔርና : ለፊፋ ጓደኛው ተቀባይነትና የእንግሊዝ ቤት
የሴት : እናያለን መኪና ተጨማሪ አሠራሮች በራፍ
አያቶቼ : የተቃጠልነው ለ# በ# * ልጅ
ናቸው : ቆይታ ኃላፊ መሆናቸው መልዕክት እንደማይችል
የሚያውቁት : አይጎድለንም ገልጿል አሰሱ አጋጠመው የመሆን
የሁሉንም : መልካም ትምህርቱን ኒልን ዓላማውን ነገር
እንዲሁ : ታክሲዎች የኬፕቨርዴው ያገኛል አብዮታውያንን ስለነበረ
ጦር : እንቀበላለን ከሳምንታት ሰላም ዓመቱ አባቱ
ባለፈ : ገብረማርያም ከማንም የነበሩበትን ወረርሽኙ ሚና
ቁጥር : ስትይዝ በማድረጉም በአሜሪካ ዓመቱም በሚገኝ
በመዋለድ : ዲፕሎማቲክ ኦሮሞነት የነበረችውን ስለፈለገ የሆነ
በንግድ : አጠራር ሆነ የሚፈልገውን የራሱን በሚገኝ
በመገናኘት : የማያገናኘው እዚያ ብንጀመርም ልታደርገው ይፋ
ተቸግሮ : አይቀርም ስንቱ አብያተ የካቲት እስልምና
ከአገር : አገላለጹ ፍላጎት ታላላቅ እንደሚኖርበት የገንዘብ
ወጥቶ : ጓደኞችህን ተደርጓል ቤቶች አቋቋመ ተረጋገጠለት
ሌላ : ገዢው የመጀመሪያው የዕርዳታ ጓደኛው ማተሚያ
ቦታ : የራሱን በሚገኝ ፊላደልፊያ ድሃ *
በመኖር : እንደሚኖርበት ቤት ድሃ ነበር ልጅ
ይቀላቀላል : ጉዞ ይጠይቃሉ አጠናቋል አሰሱ ዞሩ
ዕውቁ : በሴት የ# ዓላማውን ወዲያውኑም ለአባቱና
ገጣሚና : የደቡብ ማቅረብና ሥልጠናዎችን ሻጭ መጠኑን
ጸሐፊ : መብራትና ጨርቅ መሠረት የሚገመተውን ከጊዜ
ጋዜጠኛና : አጃንስ ቤልጄማዊው ድጋፍ በሚገኝ ዓመቱ
የፍልስፍና : የመመረጥ ከእነዚህ በኋላም አሜሪካን ተቀጠረ
መምህር : ጠፊዎችና ነገረ ንግድ የሚወዳቸውን ቲ
ሰለሞን : መኖሪያ በቡድሂዝምና አሁን ከፊልም ቤት
ዴሬሳ : ዕድሜያቸው ደሬሳ ቴክኖሎጂ ማሳወቅና ከሚያዘጋጀው
ከሪፖርተር : በሙሉ ፈጽሞ የእንግሊዝ ፊላደልፊያ ድሃ
መጽሔት : እያበሳጨው ታይቶ የትውልድ እጅ አንድ
ቆይታ : እንዲነሱ ናቸው እንደሚችሉ ዕድል እንደሚኖርበት
የኢትዮጵያውያን : ዓመት ዛሬ መንግሥትን በ# ነበር
ኅብረ : ኦርቶዶክስና ነዋሪ ያኔ የራሱን ማተሚያ
ብሔራዊነት : የመሆን ለማቋቋም ፊላደልፊያ #ኛ ለእናቱ
የኢትዮጵያን : የሚጠራው ዕውቀትና የኢኮኖሚ ውስጥ በአሜሪካ
ሞዛይክነት : የኤርትራ ለመምራት መስኩ የገንዘብ ያኔ
ያመሰጠረበት : በጸሐፊነት ከፍ የሚችሉትን ኢትዮጵያዊ የፔንሲልቫኒያ
አገላለጹ : ቢሆን ከአገር አካባቢዎች ነበር ልጅ
በሥነ : ኤድያ መድበል በኋላ ዛሬ በ#
ጽሑፍና : ክፍለ ትይዩ መሠረት እንደጠየቀው በመመለስ
ግጥም : ሲጠፉ በኋላም የእንግሊዝ ስለነበረም ድሃ
ጥበብና : ከእነዚህም የመጀመርያው ተከትሎ ያስተምር ክሪቲካል
ቴክኖሎጂ : ጎልማሳ የገለጸች ቪዛው አገሮች እንደነበረ
ክህነቱ : አሁንም ቅኝ ፍራንክሊን ኮሌጅ ተቀባይነትና
ተጠባቢነቱ : አስቡት ጣሪያው ዩኒቨርሲቲ ድሃ ለእናቱ
ሥፍራ : ኧረ ብቻውን እንደሚሰጥ ከመደብር የእንግሊዝ
ነበረው : ይኼ አስታውቀዋል አዘጋጅነትና ይኖርባቸዋል ሄዷል
ሰሎሞን : ቀንሰው ማልማት ጓደኛን ሰላም ለማቋቋም
ደሬሳ : ትመስላለህ ቆይቷል ዴሬሳ አሳይቷል ዞሩ
ለአምስት : በተራኪነት በሌሎች ኢኮኖሚያቸው የገንዘብ ለእናቱ
አሠርታት : ጨርሰህ ድሃ ለአባቱና
ሥነ : ሲመለስ ለመጠቀም ባወጣው ያኔ በሚገኝ
ጥበባዊ : ጽሑፋዊና እንዳለፈ እንኳን ዓ.ም. ይጫወት
ጽሑፋዊና : ዓ.ም. በፖለቲካዊ ላይም በኋላም ፊላደልፊያ
ጋዜጣዊ : ማካሄድ ይጫወት በፖለቲካዊ ላይም ከፍተኛ
አበርክቶው : ፓርቲ ሮያል አሜሪካ እንደማይችል የሆነ
ትይዩ : ጳጳስ ፊፋ ጽሑፍና አገሮች ወደ
በተካነበት : መንደር ተቀጥረው ሚና የሆነ ነበር
የምሥራቅ : ሸኘን ፕሬዚዳንት በኦሬንታል ያመሰጠረበት ለማዋል
ኦሬንታል : ተሰብስቤ ሐሙስ ጸሐፊዎችና ተነባቢነት ነበር
ፍልስፍና : በጭፍን የቴሌቪዥን መስኩ #ኛ ለእናቱ
እና : ሊያካሂዱት የሚመጠጥ ባለመቻላቸው ካሜራ ቪክተር
በጠሊቅ : ልብ አዘጋጅም ግን ነገር ስለነበረም
ንባብ : መመዘኛ እልፊቱ አፍሪካ በቪዲዮ ፌቴክ
ከቀሰመው : መሆኑንና በካይሮ ከሆነና ወትሮው ተልዕኮውም
የምዕራባውያን : የተሰየሙ በመመለስ ወራት ለእናቱ ለአባቱና
አስተሳስሮ : የሚቀመጠውን የኢትዮጵያውያን ግዛት መንግሥትን ነበር
ሚኔሶታ : አቁሙ በራስ ሁኔታን ለመሳተፍ ትገዛ
በአይሁድ : ከበደ ዓመት ሰዎች # ያህል
በክርስትና : ድርጅቶች በተፈሪ እራሱ ያኔ *
በእስልምና : እንዳይጨምር ሊሸጥ እየተሳካ ዩኒቨርሲቲ የገንዘብ
በቡድሂዝምና : መኖሪያ አሁን ግንባር በኋላም ድሃ
በሌሎች : አታቃጥለኝ ዲክሽነሪ ለአምስት ኢኮኖሚያቸው የሚያደርገው
ሃይማኖቶች : ርቀት ጊዜ የመሆን የእንግሊዝ ተቀጠረ
የሃይማኖት : የምሥራቅ ያመሰጠረበት እንዲይዝ ለማዋል እንደ
ንፅፅር : ተጀምሯል ሾፌሩ ለሴፕ በጎደላቸው ሕይወቱ
ኮምፓራቲቭ : የሆቴሎች የደረሳቸው ይዣለሁ ድጋፍ አባል
ሪሊጂን : ማቃጠያ የባንክ እየረቀፁ ወራት ማተሚያ
ፕሮፌሰር : አንድ በ# ድሃ ለእናቱ ለአባቱና
ሲሠራ : ለመመረጥ ማጥናት እግቡ ነገር የሆነ
ቆይቷል : ሰኔ ዞሩ የሚያደርገው ጠየቀ #ኛ
የአዲስ : የሥራው ማተሚያ ድሃ * ነበር
አበባ : በእንቅብ ክህነቱ ቅኝ ፍራንክሊን ድሃ
ተማሪ : ሮቨር ከሚያዘጋጀው የሚነሳ ይጫወት አቋቋመ
ሳለ : ተቃዋሚዎች አል በጠሊቅ ይጫወት በኋላም
በቀደመው : እንዳልተንገላቱ ልታደርገው የእንግሊዝ ፊላደልፊያ #ኛ
ራዲዮ : ዜግነቱ የኢኮኖሚ ፊላደልፊያ ልጅ ለእናቱ
የእንግሊዝኛ : ቆይቶ ቴሌቪዥን ሲመለስ አያቶቻችን ራሱን
አንባቢ : ጭፍን ተቀምጦ በተጨማሪ የሚገቡም አገሮች
የተቀጠረው : የምናውቀው አስታወቀ ገልጿል ገቡ አጋጠመው
ጋዜጠኝነቱን : ሆቴሉ ይላል በብቃት በቪክተርና ዓላማውን
ያጠናከረው : ስብሰባ ማጠናቀቁ ዕፅ መጽሐፍ ተመሳሳይ
በራዲዮ : አመሻሽ ማለታቸው በሁለቱም ሚና የሆነ
ሬዲዮና : ሥልቱ እና በንግድ ምርምር የሆነውን
የቴሌቪዥን : ተነጥቆ ከፍ ሊሸጥ መስኩ የገንዘብ
ድርጅት : በአዘጋጅነትን ግለሰቦች በሳይንስ ዩኒቨርሲቲ ማተሚያ
ምክትል : ክሬቲቭ የተጠቁት በምዕራብ በሚገኝ በ#
ሥራ : አሉ ከቦሌ ማዕከልና ባነበበው ቀደም
አስኪያጅነት : እየተደራደረ ጸሐፊዎችና እንደሚኖርበት ተቀጥሮ ነበር
ድረስም : ደስታዋን ኒውስ ሊሆን መስኩ እግቡ
ደርሷል : ያውቃሉ አውግዘዋል ቀርተውበታል ለማድረስም ጠየቀ
በ#ዎቹ : በእነዚሁ ማይል ዓላማውን የሚፈልገውን ወዲያውኑም
አጋማሽ : ሚና ምርምር የሆነ በ# *
ይታተም : ከበደ በኢትዮጵያ ዓመት ለማድረስም ያህል
መጽሔትም : እየተወራጨ ሮያል የሆነ የራሱን #ኛ
አዘጋጅ : ያሉበትን ግለሰቦች ዓመት ጓደኞች ለ#
ሠርቷል : እሠራለሁ አይፈጠርም ገልጿል ገቡ የሚያደርገው
ቅድመ : ክርስቲያን አጠገብ አውጪዎችና እጅ መሥራት
አብዮት : ከተደረገ አሳትሟል ፍራንስ መተዋወቅ ላይም
በባህር : ምግብና መሪዎች ውጭ መጽሐፍ በሙሉ
ማዶ : ጋራዦቹ ተፎከካሪዎች ውስጥ የሚፈልገውን ቤት
ጥልቅ : በቴክኒካል በልቶ ከሐረር አሠርታት የኢትዮጵያውያን
አሳቢነት : የአውቶሞቢሉ አመንቴና መንግሥትን * ለአባቱና
ክሪቲካል : ሙሽራ ለዮርዳኖሳዊው ጠቅሶ ነፃነት ፍራንክሊን
ቲንኪንግ : አትደማመጡ እሳትና የካፍም አካልም እኔና
የፈጠራ : ሲያደርግ ሰላም ተነባቢነት አዘጋጅም ወራት
ጽሑፍ : እያበሳጨው ለመሳተፍ ድጋፍ እንደማይችል የሆነ
ክሬቲቭ : ምክትል ሥነ የተጠቁት በሚገኝ አባቱ
ራይቲንግ : ቆይታችሁ ጥበብ እንደሚያደርስ ባንክን ጓደኛው
ያስተምር : ጥበብና ስለፈለገ #ኛ ለአባቱና
በአዲስ : ቀጥሎም ከጊዜ ወዲያውኑም ለአባቱና
የመጀመርያውን : ረዳት ቫቲካን ተገቢነት እጥረት ቀናት
የግጥም : የሚችሉለት ኢትዮጵያን ነገር ድሃ #ኛ
መድበል : እንደተናገሩት ያላቸው በመቶ ሚና እየተሳካ
ልጅነት : ከጊምቢ ይዘዋወር በጅምር በ# ነበር
አሳትሟል : ጉዞ ይገርማል እሠራለሁ ይቀላቀላል ቪክተርና
የአገጣጠም : ኪሎ ከፊልም በማተሚያ ስለነበረም ለአባቱና
ሥልቱ : ልባቸው ማዕከላትን አቀፍ የኢትዮጵያ ዕፅ
ለየት : ይሰጥሃል የአንዲት ስብስቦችን ገዛና ቤት
በመሆኑ : ካልተሰረቀም የነበረውን የሚችሉትን የሚችለው ፖሊሶች
አነጋጋሪ : የዘለቀ የመጣ ከተማውን ቢሆኑም ድሃ
ከልጅነት : ቆይታቸውን ስለነበረም አባቱ #ኛ ለአባቱና
ሦስት : ተሞጋግሰው የፊፋው ይመራ ፖሊሶች ሚና
ጅምር : የምንዛሪ ለብሰው ላይም በመመለስ ወደ
ተውኔቶች : ጋዜጠኞች ሕንፃዎች የሊዝ አፍሪካን ጥያቄዎች
የአጫጭር : ሴራ ለሙስና ልምዱን እንደሚያደርስ ግንባር
ልቦለድ : የአየር በቅርቡ ሲጠጋው እራሱ በማተሚያ
ስብስቦችን : እሳት ለየት መመርያዎች እንደሚገመት ሊሸጥ
ግጥሞቹም : ዘገባዎች ያስተላልፍ የዘለቀ ቢያቋርጥም ይዘዋወር
ነበሩት : ለማድረስም ያህል ጠየቀ በ# ስለነበረም
ዘበት : ከመንፈቅ ዓመቱ ለአባቱና
እልፊቱ : ማረፉን ጅምር መናገሩም ላይም ወደ
ወለሎታት : ድጋፍ ተቀባይነትና ስለፈለገ ድሃ #ኛ
የተሰኘው : በስደት ትይዩ አሠራር በላይ ፈጽሞ
ሁለተኛው : ከሳምንታት እንደ ቤንጃሚን ዓመቱ አባቱ
መድበሉንም : ጥር የንግድ ነበሩት ለማድረስም ስለነበረም
በእንግሊዝኛና : የሚጠራው የሚሆኑት ፊፋን ቀን የኢትዮጵያን
በፈረንሣይኛ : ውኃ የታሪክ ሞዛይክነት ቦታ ቅኝ
የደረሳቸው : ሲላት እያቋቋሙ የሚል ዕርዳታ የገንዘብ
ግጥሞቹ : ከሦስት ከአንድ ከተላቀቀች አቋቋመ ጋዜጣ
በስመ : ማረጋገጫ አይቷል አገናኙን ገዛና በ#
አፍሪካን : የመገበያያ የኢትዮጵያ ጊኒ ስለኤሌክትሪክ ዛሬ
አርት : ቫሉታ እያቋቋሙ ጓደኛው በአሜሪካ የሚል
ጨምሮ : በሌሎች ለአምስት ሌላ መጽሐፍ ሆኖ
በተለያዩ : ፍራንሲስ መብት ጊኒ ኪሳራ ምርምር
ኅትመቶች : ዓመታትን ፍላጎት መንግሥትን ነበር ልጅ
ታትመውለታል : ቀርተውበታል ጠየቀ በ# * #ኛ
አቶ : ገንዘቡን ነገር ስለፈለገ ለአባቱና
ፋሺስት : እርግማኑን ስለመያዝ መመርያና ማሳወቅና ግለሰብ
ኢጣሊያ : የፍልስፍናና አውጪዎችና ድጋፍ ዋና እንደሚኖርበት
ኢትዮጵያን : እንደጠየቀው ድሃ ለአባቱና
በወረረበት : ብሮድካስቲንግ ሞዛይክነት አይፈቀድለትም ተጉዘው ሆኖም
ዘመን : መኪኖች ጠባብ የሚገቡም እራሱ ልጅ
በቀድሞ : በሚኔሶታ የፕሮግራም ክፉኛ በላይ ፊላደልፊያ
አጠራር : ከመቆም ሕንፃዎች በንግድ መሥራት የነበረችውን
በወለጋ : ሲወጣ የእንግሊዝ አሜሪካን የራሱን #ኛ
ጠቅላይ : እንደሚያሳየው ለጥሬ የሚያደርገው በመመለስ ወደ
ከጊምቢ : ይዘዋወር በጅምር በ# ነበር ልጅ
ከተማ : ተወኝ ያለው ሰዎች መንግሥትን *
ኪሎ : ከፊልም ፌቴክ በማተሚያ ስለነበረም ድሃ
ሜትር : የመመረጥ ባንክን ማጥናት ከፍተኛ በኋላም
ርቀት : ሃይማኖቶች ከተመረቀ ተቀጠረ ፊላደልፊያ #ኛ
በምትገኘው : ድረስም አሁንም ኒውስ ዕርዳታ የሆነ
ጩታ : ለማሻሻል ኤምባሲዎች ፖሊሲ ያለፈ የገንዘብ
መንደር : በተካነበት ነበር ልጅ #ኛ ለአባቱና
የተወለደው : ለሥልጣን # ላይም ድሃ *
ከእናቱ : ወጣት የሚሠሩ ባንክ ለምን ዛሬ
ወ/ሮ : በሚገኙ እንደሆኑ ልምዱን በሙሉ እግቡ
የሺመቤት : ምፀትና ለሙስና ግንባር አዘጋጅም በኋላም
አመንቴና : ምዘናው ለንግድና አሳቢነት የኢትዮጵያውያን ዓመት
ከአባቱ : ከቁም ጥቂቶች ዎልፍ ነባራዊ መመርያ
ዳንኪ : የአባትህን ዳይሬክተር ፍለጋዬ ነገር ስለፈለገ
ላንኪ : መምህርም በጅምር ማተሚያ ነበር ለአባቱና
በአራት : በአካል ፌቴክ ተሾመ ለአባቱና
የትውልድ : መሻሻልን ፈረንሳይ ዕድል እንደሚኖርበት እንደማይችል
ቀዬውን : ከትምህርት ከእናቱ አለበት አጋጠመው የማተሚያ
ለቆ : በሌሎችም ዕድል እንደማይችል የገንዘብ የነበረችውን
ዕድገቱን : ይለኛል ምክንያቱም ናይጄሪያና ሊሸጥ ከፍሎሪዳ
ሲያደርግ : ነጋዴ ከማለቃቸው ወራት ዓመቱ ድሃ
በተፈሪ : በክርስትና ቢሮዎች ዓውደ ቢሆንም መንግሥትን
መኰንንና : ተገድበው ቁጥር በማድረጉም የሚፈልገውን ለማቋቋም
በጄኔራል : ተፈጻሚነቱም ማሳወቅና አካል ውስጥ የፔንሲልቫኒያ
ዊንጌት : እንዲመለከቱት ነበሩት ያሉ # ለማድረስም
ቤቶች : አቋቋመ ያህል ማተሚያ ነበር #ኛ
ትምህርቱን : ልማት ይሞታል ጸሐፊዎችና እንደሚኖርበት መሥራት
አጠናቋል : ትመስላለህ ይቀላቀላል አሳይቷል አስታወቀ ዞሩ
የጀመረውን : ሳይቆጥሩ ቢታወቅም ተነባቢነት ወራት ዓመቱ
ቢያቋርጥም : ግጥሞቹም ማለፍ እየተደራደረ ጸሐፊዎችና እንደሚኖርበት
ሄዶ : ማግለላቸውን እግዚአብሔርና ባንክን እንዳለበትም ከፍተኛ
የባችለር : የጻፋቸውና የሆነ ወዲያውኑም አባቱ ነበር
ዲግሪውን : አፍሪካ ቫይረስ አድርጓል ማተሚያ በ#
በኦሬንታል : እስከ በተያዘው እንደነበረ በ# *
ፊሎሶፊና : ነፍሱ ዩኒቨርሲቲ ድሃ ለእናቱ ለአባቱና
አግኝቷል : ለጠፉ ላይ ሶሳይቲ ተቀጠረ በሚገኝ
በካሊፎርኒያ : ምክንያቱም ለዚህም ቢልዮን የኢቦላ ነገር
አማርኛ : ሞዛይክነት በመገናኘት የገንዘብ አሜሪካን ያኔ
ዎልፍ : ከአባቱ እኔና ትገዛ ልጅ ለእናቱ
ሌሰላው : ሆቴሎች ደብዳቤ አባል አሜሪካ ነገር
ዲክሽነሪ : በተራኪነት በሌሎች ለአምስት ኅብረ ኢኮኖሚያቸው
ያሳተመውን : የሚፈልጉ ተገቢነት ቅድመ የኢቦላ ሚና
መዝገበ : ከትምህርት በጎደላቸው የመንግሥት ቲሸርት ያለ
ቃላት : የጠበቁ ኃላፊ ሥልጠናውን ጸሐፊዎችና የሆነ
ካዘጋጁት : ተቀጠረ አንድ ለእናቱ ለአባቱና
ኢትዮጵያውያን : አለመቻላቸው ያስተላልፍ ዕድል * ልጅ
አንዱ : አላቸው ከእንግሊዝ በ# * ልጅ
ገጸ : ታክሲዋን ተቋማት በማድረጉም በሚገኝ ነበር
ታሪኩ : አጠገቧ ታሪካቸው አባል አሜሪካ ያኔ
እንደሚያሳየው : ጠቅላይ ለብሰው ላይም በመመለስ ትገዛ
የነበረውን : የሚችለው እንደሚገመት ሚና እየተሳካ ገዛና
ጥናት : እግረኛ ፔንሲልቫኒያ የሚፈልገውን የነበረችውን ፊላደልፊያ
ሲመለስ : ከማስተባበል ሥነ ባወጣው ራሱን በሚገኝ
የፕሮግራም : በቀድሞ ፊላደልፊያ ለአባቱና
ዳይሬክተር : ዳንኪ አማራ እያገኙ ተጓዥ ሮዚም
ራዲዮና : ኦስተን አብዮታውያንን የራሱን ማተሚያ በ#
ቴሌቪዥን : በጊዜና የእንግሊዝኛ ሳምንት ለጠፉ ለማቋቋም
በጋራ : ደረስኩብሽ ማግለላቸውን ማሪዋና ጓደኛው የገንዘብ
ይመራ : ስለታሪካዊው የነበረችውን አሜሪካን የሆነ የራሱን
ብሮድካስቲንግ : በወረረበት ዜና ሆኖም ቢታወቅም እንደነበረ
ሰርቪስን : ኦርቶዶክስና ያለፈ ግዛት ነበር ልጅ
ኢቢሲ : ታውቋል እንዲሆኑ በ# ለእናቱ ለአባቱና
በምክትል : ማዕረገ አማራ ተጓዥ ሲሆን መካከል
መርቷል : ጀመረች የአዲሶቹ በተራኪነት ተረዳ ተረጋገጠለት
በእነዚያ : የቤተ ናይጄሪያና ለዚህም በእነዚሁ ዓመቱም
የጋዜጠኝነት : ለአፍሪካ ማዕከላቱን ፌዴሬሽኖች ማኅበራዊ በመወከል
ሕይወቱ : የሚያጣሩበት ያደረገው እስከ ሰው የሚጠቁም
በጸሐፊነት : ኢትዮጵያዊ በተያዘው እየተሳካ ተነባቢነት መሣሪያ
በአዘጋጅነትን : ድርጅት መምህር በሳይንስ ዩኒቨርሲቲ ለ#
በተራኪነት : ዲክሽነሪ ለአምስት አይፈቅድም ይፈቀድላቸዋል ሄዷል
በመምራት : ተከትሎ ሊሸጥ ፍራንክሊን ዩኒቨርሲቲ ነገር
በኢትዮጵያ : ይታተም # በጅምር እንደነበረ ያህል
ታሪክ : የባንክ ማገዙንም የተገመተ የሥራው ማተሚያ
ጥበብ : ስትሸሽ ራይቲንግ ስታስበው እንደሚያደርስ አሜሪካዊ
ዙሪያ : ነፃ የፌስ ላይም * ለአባቱና
የደቡብ : ያሉበት ገጣሚና ማቅረብና ሥልጠናዎችን መጠን
የነፃነት : ከተለያዩ ቫሉታ ባወጣው ከተጎዱት በአሜሪካ
ተጋድሎ : የፀና ኮሌጅ ዋና መሣሪያ እንደማይችል
የሚመለከት : ዓውደ ብርም አፍሪካ ዛሬ የነበረችውን
ርዕሰ : የነገረ ፖሊሱም በአካል ለ# ወዲያውኑም
ጉዳዮችን : እንደሚያደርስ ነገሮች ግንባር #ኛ ለአባቱና
ይዳስስ : ሆነው ላንኪ ማተሚያ ልጅ ለእናቱ
በስደት : አሠራር በመመለስ ወደ ለእናቱ ለአባቱና
ኑሮውን : ትዳርን እንደሚጠቁሙት መሆናቸው ፔንሲልቫኒያ መሥራት
የጀመረው : ተከትሎ እንደተደረሰበት በመምራት በጄኔራል ተፈጻሚነቱም
ከዩኒቨርሲቲ : ከበደ ይታተም ያለው ዓመት ቢሆንም
መምህርነት : እያውለበለበ እንደነበረ ኮሌጅ በ# ድሃ
ፊልምና : መሆኑንና አህጉሮች የመዘገበው እየረቀፁ ተሳክቶለት
አዘጋጅነትና : ይኼ ነበረው ግን ያኔ ስለነበረም
በሌሎችም : ለቆ የገንዘብ የነበረችውን የራሱን ፊላደልፊያ
ሥራዎች : የተጣጣፈ ቫን ዩኒቨርሲቲ ለእናቱ ለአባቱና
የዘለቀ : ከተማውን እየረቀፁ እንደሚኖርበት ድሃ *
ከተደረገ : አብዮት በቁጥጥር ወራት ዓመቱ ድሃ
ከ#ዎቹ : ትምህርትህን በተለይ ባለፈ ቢልዮን ለመፍጠር
ጀምሮ : ኢንተርኮንቲኔንታል ተስፋዬ ፍራንክሊን ተቀባይነትና አዘጋጅም
በተደጋጋሚ : የሚሰጠው ያመለጠንን ብርሃነየሱስ ያስተምር ጥበብና
የዘለቀው : እየጠየቁ ቢሮዎች ኤምባሲዎች ተጉዘው የሥራው
ዕውቀትና : ቲቸር የኢትዮጵያን በላይ ወዳጆች በመመለስ
ልምዱን : አፍታ እግዚአብሔርና ባንክን በሙሉ እግቡ
መድረኮች : ካሜራ ቤት ዓመቱ ነበር #ኛ
ያስተላልፍ : ጨምረው እንደሚቀጥል ሆነው የዘለቀ ኢትዮጵያውያን
ከሰባት : ሆቴሉስ ተልዕኮውም ቀጥሎም ለአባቱና
ባደረበት : በማላዊ እንቅስቃሴም በሚገኝ ድሃ ነበር
ጽኑ : ከሦስት ነው ትምህርት ዛሬ ተረዳ
ሕመም : በትችት አዘዋዋሪዎችን አባል አሜሪካ አሜሪካን
ሕክምናውን : የአየር ለማሻሻል ሕንፃዎች ኤምባሲዎች መሠረት
ሲከታተል : የእቴጌ ሲታኘኩ ተፈጻሚነቱም ቤት ድሃ
ቆይቶ : ባንኮች የነበሩበትን በእጅ ራሱን ለማቋቋም
ሐሙስ : የራስህ ቃላት ቆይታ አካባቢዎች ነበር
ጥቅምት : ሆኗል ተችሏል ያደርጉባቸዋል ዞሩ ጠየቀ
ቀን : ገባ እንዲይዝ ቪክተር ፍራንክሊን ኮሌጅ
በሚኔሶታ : በ#ኛው የላዛሪስት ማረፉን የፌስ ላይም
መኖሪያ : በቡድሂዝምና አሁን ይጫወት በኋላም ድሃ
ቤቱ : የሆቴል ተደርጓል መርቷል በሌሎች ወሰነ
ማረፉን : ላይም ወደ ድሃ * ለአባቱና
ታናሽ : ተወልደው የኢንተር በሊቀ እምብፁዓን ጽሑፍ
ወንድሙ : እንደሚያደርስ ባነበበው አሜሪካዊ ግንባር አዘጋጅም
አምባሳደር : ተቃዋሚዎች የተሰጠ ወደ ድሃ ለእናቱ
ብርሃኔ : በምትገኘው መመርያዎች ተብሎ ስር ሆኖ
ለቪኦኤ : እንደሚችሉ ኒልን መልዕክት ዕድል ዋና
ገልጸዋል : በእነዚህ ይገኛል የሚያደርገው ተቀጥሮ ተቀጠረ
የሰሎሞን : ቢልዮን ከፍሎሪዳ ቆይታቸውን ግን አባቱ
አስከሬን : የንግድ መንደር ተቀጥሮ መንግሥትን *
በራሱ : ተጓዥ መካከል ፍራንክሊን ድሃ #ኛ
ኑዛዜ : ዶላር ሸርት መተዋወቅ ለመፍጠር ዓመቱ
በሚኔፖሊስ : ተገዝተው የቀበሌና ቤት ድሃ #ኛ
ማቃጠያ : ሪሊጂን የባንክ እንዳለበትም ወትሮው ኮሌጅ
ኅብረት : ፍራንሲስ መድበል አጋማሽ ናቸው ዓመት
ቅዳሜ : ከጎናቸው አባላት ስለ እንደሚኖርበት ቤት
እንዲቃጠል : እንደሆኑ ማጥናት እግቡ ፊላደልፊያ ድሃ
ተደርጓል : ተረጋገጠለት ጠየቀ #ኛ ለእናቱ ለአባቱና
ከአሜሪካዊቷ : በሽብር ጉዞአቸውን ጓደኛው ቀጥሎም በማተሚያ
ባለቤቱ : ይሆኑ ባሻገር ጋዜት ለእናቱ ለአባቱና
ጎጆ : ገዛና መንግሥትን የሆነ በ# *
መሥርቶ : ይጭናል ልጆችም የኢትዮጵያ ትንሽ ስለኤሌክትሪክ
የአንዲት : ለየት ካስተዋወቀችው ቪክተርና ገዛና #ኛ
አባት : ካጣችሁም በቅርቡ ፖሊሱም ስለኤሌክትሪክ ዛሬ
የልጅ : ተከታያቸው እግዚአብሔርና ከፍ ወረርሽኙ ነገሮች
ልጆችም : ጭማሪ እንደማይችል የሆነ ነበር ልጅ
አይቷል : ይስተዋላል አድርጓል ቀርተውበታል ጀመረ በ#
ነፍስ : አይቷል አዳዲስ አለ ይስተዋላል ቀርተውበታል
ኄር : እየታዩ ከተባለ በሳይንስ ወደ ድሃ
መንፈሳዊነት : በታች ከውጭ ባነበበው ወዲያውኑም አባቱ
ለሪፖርተር : አርት ሳምንት ትገዛ ለእናቱ ለአባቱና
እንዲህ : ገበያ ሁሉን አቡነ ኳስ አቀፍ
ያለውን : ነገር የሆነ #ኛ ለአባቱና
የአገራችንን : ከ# በጅምር ጋዜጣ በማተሚያ ማተሚያ
ማኅበራዊ : ዩኒቨርሲቲም የጋዜጠኝነት ወንጀለኛ አገናኙን መስኩ
ችግር : ሲያደርግ ከማለቃቸው ሰላም ወራት ተረጋገጠለት
ለመፍታት : ይነጫነጫል ስለታሪካዊው አልነበረም አንዲት ዲፕሎማቲክ
ሊጠቅመን : ራሳቸውን መሆናቸው ቤት በሚገኝ በ#
ብዬ : ሁሴን ጥረት ነገር ፊላደልፊያ #ኛ
አምናለሁ : አይደለም ታወቀ ቀርተውበታል ለማድረስም ጠየቀ
እንደሚታየኝ : ሁሉ አሜሪካን የራሱን ፊላደልፊያ ልጅ
ለኢትዮጵያውያን : ፅኑ ሞልታ በወረረበት አሁንም መስኩ
ኦርቶዶክስና : ኅብረ ብርም ዜና ያለፈ የሚጠቁም
እስልምና : የሚችሉትን የወጣው ብርና ፖሊሲ የነበረችውን
ሃይማኖት : እጅግ አይ የውጭ በአንድ አገሮች
ሆነው : ከጊምቢ በጅምር እንደነበረ ማተሚያ ልጅ
አይታዩኝም : አጠያየቁ ኒል ጠየቀ #ኛ ለእናቱ
ለእኔ : ያሉበት የሆኑ ደግሞ ማቅረብና ቤንጃሚን
ማንነት : የመጣ ተጓዥ እየተጎዳ እየረቀፁ እንደጠየቀው
እኛ : ሲያዳምጥ ካልሆነ ኢትዮጵያዊ ጥረት ቅኝ
የማንነት : የተመረጠችበት በመገናኘት መጽሐፍ የማተሚያ ትገዛ
መለያ : ቀረ እስልምና የውጭ የራሱን በ#
አለን : ጉዳይ ዕድል ዋና እንደማይችል ዕርዳታ
አይጎድለንም : የሚያውቁት ገልጿል አሰሱ አጠያየቁ አጋጠመው
ይጎድለናል : ጀመረ ተረዳ ተረጋገጠለት ጠየቀ ለእናቱ
የእምነት : እምብፁዓን ከተለያዩ ቁጥር በማድረጉም በአሜሪካ
ጉዳይ : አለን ኃላፊ ዕድል ዋና እንደማይችል
አይደለም : አምናለሁ ታወቀ አድርጓል ቀርተውበታል ለማድረስም
በእግዚአብሔር : ወዲያውኑም ለአባቱና
የማመንና : የተመረጠችበት መያዝ ሴኔጋል የራሱን *
ያለማመን : አለን ዕድል እንደማይችል ዕርዳታ የገንዘብ
መጨረሻው : ሸር ጥልቅ በቁጥጥር ፍራንክሊን ላይም
ራስን : ይወቀው የሚሠሩ ልጅ ለእናቱ ለአባቱና
ማወቅና : እያገኙ ሊሸጥ እየተሳካ ዩኒቨርሲቲ ነገር
መሆን : ሳይርበን ቡትቱ ተቀጥረው ባነበበው ቀደም
የሰው : ባጋጠማቸው ማሳወቅና ቪክተርና #ኛ ለእናቱ
አይፈጠርም : አገናኛቸው አቋቋመ በኋላም ተረጋገጠለት ጠየቀ
በቤተሰብ : ቃጠሎ የአቡነ ዓላማውን ግን አባቱ
ትወለዳለህ : ከቫይረሱ ያህል ጠየቀ ነበር ልጅ
የአባትህን : ዳንኪ እያገኙ እንዳይጨምር ነገር ድሃ
የእናትህን : ሲል አብረውት ነገሮች የመሆን የእንግሊዝ
ይዘህ : ጉዳይ ሆነው ዕድል ዋና እንደማይችል
በሌላ : በቡዳፔስትና ፖሊሱም በአካል የጋዜጣው ወዲያውኑም
አሳዳጊዎችህን : በፌስቡክ አሜሪካዊ ፊላደልፊያ ድሃ *
ወንድሞችህን : ወረድን ኃላፊ ለመሳተፍ ሴራሊዮን ሊሆን
ጓደኞችህን : ኖሮ ወጥቶ ይችላል ሆኖ መካከል
ሁሉ : እንደሚታየኝ ማሊ ሊያገኝ ገንዘብ አሜሪካን
ትመስላለህ : ደሬሳ አሳይቷል ዞሩ ጠየቀ ለእናቱ
መምህራንህን : ለአብነት ኪሎ በአሁኑ ከፊልም ማሳተም
ስለዚህ : የበኩሏን በኢኮኖሚው የራሱን በሚገኝ #ኛ
ከእነዚህ : የምናውቀው አሰሱ ኒል አጋጠመው በኋላም
ቡትቱ : ሺሕ ምክንያቱ እንደሚያደርስ ማሳተም እግቡ
ጨርቅ : ጸሐፊ ከሆነና ከማል ተቀጥሮ ተቀጠረ
ተሰብስቤ : እንዲይዙ ጸሐፊዎችና ዋና እንደሚኖርበት የሆነ
ተጣፍኩኝ : ኤጀንሲ ታትመውለታል ማግኘት አጠያየቁ ጠየቀ
ሳይሆን : ነገ አይገባም ግጥሞቹ እንዳይዛመት አጋጠመው
ሳልሞት : ልንደርስበት ምክንያት የመንግሥት አብዮታውያንን *
ምናልባት : ኩማና እየተሳካ ስለፈለገ በ# #ኛ
ሊፈጠር : አይሃለሁ የወደድነው ትገዛ ለእናቱ ለአባቱና
ወይ : ተቀብለዋል ከሦስት ነው ተቀጠረ ልጅ
ሁል : መሥራቷን ዕፅ ገንዘብ የራሱን በሚገኝ
የራስህ : ከሾፌሩ ሐሙስ አብሮ ያለፈ ሚና
ፈንታ : ተግባር ጥያቄዎች መብት አስፈላጊውን ጋዜጣ
ተግባር : አጠገቤ ፈንታ እዚህ ድረስ ጋዜጣ
ግዴታ : ለመድረስ አለመቻላቸው ማን አብዮታውያንን በ#
መንፈሳዊንት : በዚህ ከዚህም ግለሰቡ ቴክሳስ ማይል
በመጨረሻው : ይጎድለናል ለሪፖርተር ኄር በሳይንስ ለእናቱ
ከብትንትኑ : ወንበር ሊያካሂዱት እና ካሜራ ቪክተር
የተጣጣፈ : ሥራዎች ዩኒቨርሲቲ ከፍተኛ ተነባቢነት ለእናቱ
ተሰብስቦ : ኩላሊት ቆይታችሁ የሚገርመኝ ታላላቅ ማጥናት
ይሞታል : ትምህርቱን ኒልን እንደሚኖርበት መሥራት አንድ
ደግሞ : ለእኔ ዲ ቤንጃሚን ነገር ዓመቱ
በእምነት : አግባብ ያሉባቸው ስለኤሌክትሪክ የራሱን በ#
በጥረት : ኃላፊነት ቴክኖሎጂ አገሮች ለእናቱ ለአባቱና
የሚገኘው : የሚያውቁት አጋጠመው የመሆን በኋላም ጠየቀ
የዓለምን : በማለት አለን ዕድል እንደማይችል ዕርዳታ
እግር : እንዳይዛመት ሆነናል አብዮታውያንን ሁነኛ ተረዳ
ኳስ : ሲያዳምጥ ካሉት ማዕከልና ወጣ አሜሪካ
የሚመራው : ሬዲዮ ከማል ከጊዜ ተቀጥሮ ዓመቱ
ፊፋም : አሽከርካሪ ይወቀው አንዳንድ ተመን በአንድ
የዚህ : አዎ ጥናቶችንና እንደጠየቀው ወደ ድሃ
ተቋም : አለመቻላቸው ኢትዮጵያውያን እየተጎዳ በጅምር ዕድል
ነፀብራቅ : ባልነበረ የፊፋው ባለፈው ለጠፉ የ#
የሆነው : ማልማት የደቡብ ሰሎሞን ገጣሚና ውጭ
የአፍሪካ : ተሸላሚ ያደጉትና በወጣ ቢሆንም መንግሥትን
ኮንፌዴሬሽን : ለማዋል ጥሩ እንደ ዓመቱ በ#
ካፍ : የአገራችን ሮያል እንደማይችል የሆነ ነበር
በትችት : ሕመም ባወጣው ሻጭ ሮዚም ነገሮች
ሲብጠለጠሉ : ለብሰው ላይም በመመለስ ድሃ *
ዓመታትን : ፍላጎት ጸሐፊዎችና መሥራት መንግሥትን የሆነ
አስቆጥረዋል : ተሰምቷል ያገኛል ጀመረ ተረዳ ለእናቱ
የፊፋ : እነሆ መመርያውን በቪዲዮ ቤንጃሚን ሶሳይቲ
አመራር : ወጣት ለ# ነበር ልጅ ለእናቱ
አካልም : የማይሠራውን ቲኦሎጂ ኦል ቲንኪንግ የመዘገበው
የካፍ : መረጃ ሶሳይቲ በማተሚያ ስለነበረም *
ኃላፊዎች : የዕርዳታ ከ# ያኔ ልጅ ለእናቱ
በሙስናና : የነፃነት ቫሉታ እስከሚያገለግልበት በአሜሪካ አባል
ተያያዥ : ሰብዓዊ በጄኔራል ተፈጻሚነቱም ማሳወቅና #ኛ
ችግሮች : መመዘኛ ፈንታ ትንሽ ስለኤሌክትሪክ ሊያገኝ
ሲወቀሱ : በኢንተርናሽናል ኤድያ ከሐረር በ# *
በአመራር : ላይም ተቀጥሮ ድሃ * ለአባቱና
ብቃታቸውም : ወለሎታት ታይቶባቸው እንዲቆዩ ድሃ ለአባቱና
ደካማነትና : ከቁም ተቃጥለው መመርያ የሚያደርገው ጠየቀ
ተገቢነት : በልጃቸው ተጠናክሮ በካሜራቸው ፈረንሳይ ግንባር
በጎደላቸው : የመንግሥት አገሮች ከእንግሊዝ ስለነበረ *
አሠራሮች : በየቀለበት የሴት ተብሎ እንደሚገመት ምርምር
በመገናኛ : የሚያስመካበት ክብርና ካርዲናል ያስተምር እንዳይጨምር
ብዙኃን : የተጋለጠ ቴክኖሎጂ አገሮች ዩኒቨርሲቲ የገንዘብ
ሲታኘኩ : መንጎጨት ሲቀበሉ ሲከታተል ዕርዳታ የገንዘብ
ለአብነት : ከመንፈቅ የሴፕ ዘበት ከዚህም ተሾመ
ኳታር : ሙሽራ በተንሰራፋበት ኢቢሲ ለእናቱ ለአባቱና
እ : ይጠይቃሉ ያደርጉባቸዋል አሰሱ ዞሩ ጠየቀ
ኤ : ዳይሬክተር አማራ ተጓዥ መካከል ቀደም
አ : ሁላችን መንበር ለእኔ መተዋወቅ በኋላም
እንድታዘጋጅ : ወረርሽኙ የሚፈልገውን የእንግሊዝ ለማቋቋም አባቱ
የተመረጠችበት : የማንነት ኪሳራ የሆነውን የራሱን ፊላደልፊያ
ዋንጫ : ጥያቄዎች ሲወጣ ፊላደልፊያ * #ኛ
ዝግጅት : ተሳፋሪዎች ባነበበው ነገር አሜሪካን የሆነ
በሙስና : ግሪጎሪያን ፖሊሲ ዩኒቨርሲቲ የራሱን በሚገኝ
ተነጥቆ : ሊሸጥ መስኩ ተቀባይነትና የገንዘብ #ኛ
የተሰጠ : ነውና አምባሳደር በተጨማሪ በተጨማሪም ፍለጋዬ
መሆኑ : ጸሐፊዎችና እንደሚኖርበት ቤት ድሃ ነበር
እንደተደረሰበት : ተፈጻሚነቱም አካል ሊሸጥ ባነበበው ተቀባይነትና
እየተነገረ : ኒልን ዕድል ዕርዳታ የሆነ ፊላደልፊያ
ባለበት : መሹለክለኪያ ፅኑ የፀና ሴራሊዮን ቢሆንም
በዚህ : መንፈሳዊንት ግለሰቡ ቴክሳስ ማይል በሁለቱም
ወቅት : እግዚአብሔርና መተዋወቅ የሚያደርገው ወደ በኋላም
ፊፋ : ትይዩ ጽሑፍና ለጥሬ ወደ ለ#
ከማስተባበል : ሲመለስ ባወጣው በሚገኝ አባቱ #ኛ
ባሻገር : ባለቤቱ ከሪፖርተር እግዚአብሔርና ፈጽሞ ትገዛ
የኳታር : ሊታይ ፖሊሶች ሚና መንግሥትን የነበረችውን
አዘጋጅነት : በአኳኋኑ ፕሬዚዳንት በጸሐፊነት የነበረውን መድበል
የፀና : ነገርስ የበይ በወጣ ተጋድሎ የተወለደው
መሆኑን : ለማሳየት የዘለቀ ከአገር እየተደራደረ እየረቀፁ
አስታውቋል : ይኼን ዞሩ እንዲሆኑ ጠየቀ ትገዛ
እሰጣ : በካይሮ ግባ ፌስቡክ ፊላደልፊያ ልጅ
ገባ : ቀን እንዲይዝ መጠኑን ቪክተር ጓደኛን
እፎይ : የመመረጥ ነገ አዘጋጅም በኋላም ተቀጥሮ
ብለው : አሊ ያለው የሚገቡም ፍለጋዬ ያገኙት
ጥቂት : ዞሮ አባላት እጅ በማድረጉም የሚፈልገውን
ወራትን : ጴጥሮስ ማዕከላትን የሚጠበቁት ማረጋገጫ የፊፋው
ያዘገሙት : በሚከናወነው በወረርሽኙ ያጋለጠው ሰው ጓደኛን
የፊፋው : በእጃቸው ፖሊሶች በመወከል የነበረችውን በሚገኝ
ፕሬዚዳንት : እምነት አዘጋጅነት የምሥራቅ የውጭ ተነባቢነት
ሴፕ : ያደጉትና ተሿሚዎች ከማል የሥራው ተቀባይነትና
ብላተር : ስናሾፍ ተጉዘው አስገኝቷል በ# *
ተቋሙን : አላቸው በአንድ ልጅ ለአባቱና
ለአምስተኛ : በፈጠረህ ካስተዋወቀችው አካል ታይቶባቸው ድጋፍ
ለመምራት : ለአፍሪካ ለመሆን ሞዛይክነት የጉዞ መስኩ
ሞገዳዊ : ቢሆኑም ድሃ * ነበር ለእናቱ
አቋም : የምንሰማው ፍልስፍና ከቫይረሱ ከተላቀቀች ለማድረስም
ብቅ : ለማወቅ ከፍተኛ ዕርዳታ የገንዘብ ማተሚያ
ማለታቸው : አመሻሽ በራዲዮ በሁለቱም ሚና የሆነ
ሆኗል : ጥቅምት ተቀጠረ አንድ በ# ነበር
በግብፅ : አስነሳ ስሙልኝ ማሳወቅና ነፃነት የፔንሲልቫኒያ
ካይሮ : እየተደራደረ ዛሬ ያኔ ነበር ልጅ
ዓመታዊ : ፕሬዚዳንታዊ ደብዳቤ አስገኝቷል የማተሚያ ገንዘብ
ጠቅላላ : በሚኖረው ትገዛ ለእናቱ ለአባቱና
ጉባኤውን : አፍሪካን ከቀጣሪዎቻቸውና ለ# ቤት አንድ
ያደረገው : ሕይወቱ ንፅፅር ሰው ሁነኛ በመመለስ
በመጪው : ብሎ ወዲያውኑም ለአባቱና
ሰኔ : ዞሩ እንዲሆኑ ጠየቀ #ኛ ለእናቱ
መጀመርያ : ለየት ቪክተርና ነገሮች #ኛ ለእናቱ
በዙሪክ : አንዳንድ ካልጠፋ የማሻሻያ አፍሪካ ያለ
በሚከናወነው : በመስጠት ያዘገሙት መጠን ሰላም ተሳክቶለት
ፕሬዚዳንታዊ : ዓመታዊ ሥነ አስገኝቷል የሚል የማተሚያ
ምርጫ : ካሜሮናዊው የብላተር አገሪቱ ቲ ያኔ
ድምፁን : ጥንቃቄ ድጋፍ በሳይንስ ዓላማውን ሊያገኝ
ለሴፕ : ደረስኩብሽ ልንይዘው የካርዲናልነት የመንግሥት ማሪዋና
እንደሚሰጥ : ኧረ ከማንም ሥፍራ መሥራት ቤት
ማረጋገጫ : በስመ የነበረው ኮሌጅ መንግሥትን *
ሰጥቶ : ሰላማዊ ካሟላ የወጣው ገዛና መንግሥትን
ማጠናቀቁ : ስብሰባ ያጠናከረው ማሪዋና ተመሳሳይ የማተሚያ
ተጨማሪ : እናያለን ጭምር ጉዳይ የሴት ካልሆነ
መነጋገሪያ : ፕሮፌሰር ጓደኞች ለ# አንድ ነበር
ብሏል : ተቀጠረ ልጅ ለእናቱ ለአባቱና
ይኼው : በቡዳፔስትና በሌላ በአዲስ በአካል ቀጥሎም
ለፊፋ : ተከታያቸው እግዚአብሔርና ክፉኛ በሙሉ የእንግሊዝ
ፕሬዚዳንትነት : አማኝ አባላቱ ከማስተባበል ሲመለስ ክትትል
ብርቱ : ያቃተው ከ#ኛው አዘዋዋሪዎቹም ለማቋቋም ዓመቱ
ተፎከካሪዎች : የቀበሌና ጉባኤውን ማዶ ቤት አንድ
ይሆናሉ : በፕሬዚዳንትነት አርት ከተባለ ሲከፍት የሚያደርገው
የሚጠበቁት : ጴጥሮስ ወራትን ለኦሬንጅ ውስጥ ፔንሲልቫኒያ
ዮርዳኖሳዊው : ተሞጋግሰው ቪክተር ገዛና #ኛ ለእናቱ
ንጉል : ለውጥ እስከ የተለያዩ የሥራው *
አሊ : ብለው ያለው ያገኙት ዩኒቨርሲቲ መንግሥትን
ቢን : ለአንድ አዘጋጅም ነገር አባቱ #ኛ
ኦል : የናፈቅናት አል አካልም ከቀሰመው የመዘገበው
ሁሴን : ብዬ ኒልን ጥረት ነገር የሆነ
የካፍና : ሳያስተዛዝበን ሊፈጠር ትገዛ ወዲያውኑም ፊላደልፊያ
የብላተር : አገሪቱ የሥራው ያኔ * ነበር
እንዳልጣማቸው : እሰጣ ይዞ ፌስቡክ እራሱ ጋዜት
በመግለጽ : በፈገግታ ነፃነት የፔንሲልቫኒያ #ኛ ለእናቱ
ሰውዬም : የሚወዳቸውን አባል የሚል ያኔ በሚገኝ
ምስለኔዎቻቸውን : መምህር የማሻሻያ አብዮታውያንን ጀመረ የሚል
ተማምነው : ያዘገሙት በወረርሽኙ እንደዘገበው ለማቋቋም ተቀጠረ
ፕሬዚዳንትነትን : ማለት ምክትል አባል የሚል በሚገኝ
ሥልጣን : ቻንስለርም ከጊምቢ አገላለጹ አካባቢዎች በጅምር
ለመቆናጠጥ : ለካርዲናልነት መፀዳጃ ከሦስት ይደርሳል ትምህርት
ብቁ : እግዚአብሔርና መስኩ የራሱን #ኛ ለእናቱ
የሚያደርጋቸውን : ቤት ነበር #ኛ ለአባቱና
ሐሳብ : ለጥሬ መሠረት ሠራተኞች ለብሰው በፖለቲካዊ
ይፋ : ተብሎ ፖሊሲ ሮያል ሆነ እራሱ
ማድረጋቸውን : ፕሬዚዳንታዊ ሥነ የሚል የማተሚያ ያኔ
ጭምር : ዕድል እንደማይችል ዕርዳታ የሆነ ልጅ
አውግዘዋል : ደርሷል ታወቀ አጠያየቁ አቋቋመ ጠየቀ
ባልነበረ : ለጠፉ ስለ ቡክ ተሳክቶለት በማድረጉም
አኳኋን : ለትከሻ ፊፋን እንዲይዙ ዕድገት በሁለቱም
የካፍም : አትደማመጡ ቲንኪንግ በእጃቸው የመዘገበው የተለያዩ
ለመሆን : የብላተር ለመምራት ሄዷል መስኩ ዋና
የሚወዳደሩ : የተጣጣፈ ዩኒቨርሲቲ ከፍተኛ አዘጋጅም በመመለስ
ዕድሜያቸው : ዴሬሳ ታውቋል ጠየቀ በ# #ኛ
መስማማታቸው : ብርሃነየሱስን ለማወቅ በጅምር ማጥናት ማሳተም
ተሰምቷል : አስቆጥረዋል ካዘጋጁት ከማል ጀመረ ተረዳ
ካሜሮናዊው : በተራኪነት ለአምስት ኢኮኖሚያቸው ያኔ ማተሚያ
ኢሳ : እስኪያልቁ ለፊፋ ጓደኛው የእንግሊዝ የራሱን
ሐያቱም : አተረፈህ ግብዣ አብረውት በላይ ቀደም
በዚሁ : ጋዜጠኞች ስለኤሌክትሪክ የነበረችውን ልጅ ለአባቱና
በአዲሱ : ከመሆን የሚያደርጋቸውን ቤት ዓመቱ ድሃ
የሴፕ : ለአብነት የሰሎሞን ዶላር ተሾመ ቤንጃሚን
ከማንም : አዳራሽ ተጠቅመው ወረርሽኙ ከመደብር ለመፍጠር
ቀድመው : የሆነ ነበር #ኛ ለአባቱና
የተደሰቱ : ሲወቀሱ አያቶቼ የውጭ አገሮች ሶሳይቲ
ይገኛል : ገልጸዋል የሚያደርገው ተቀጥሮ ተቀጠረ በ#
መጋቢት : ሚያዝያ አባቱ #ኛ ለአባቱና
በካይሮ : እሰጣ ከቀሰመው ፌስቡክ ፊላደልፊያ ድሃ
በተደረገው : በተያዘው ቪክተር ስለፈለገ የራሱን #ኛ
ጉባኤ : ወርልድ ያላቸው የሚያደርጋቸውን ተውኔቶች አካል
የተገኙት : የተቀመጠው ከተላቀቀች ሁነኛ በማተሚያ ያህል
ብላተርና : በዓይን እርስ ለመምረጥም በሳይንስ ለ#
ሐያቱ : በካይሮ ወራትን ፌስቡክ ፊላደልፊያ ልጅ
ተሞጋግሰው : ዮርዳኖሳዊው እንዲይዝ ቪክተር ገዛና #ኛ
መድረክ : ምክትል ዛሬ ለ# ያኔ በሚገኝ
ለዮርዳኖሳዊው : ተከትሎ ብርሃነየሱስ ክሪቲካል ኒልን ነገር
አል : እንዳለመታደል በሚኔሶታ ሳለ በፌስቡክ ይጫወት
የተዋጠላቸው : አመሻሽ እንደሚያመለክተው የሚፈጸመው በራዲዮ መሻሻልን
አይመስልም : ሐምሌ ነበሩት ጋበዛቸው ለምን ለማድረስም
ስዊዘላንዳዊው : የነጋዴ ጥሩ ዓመቱ ስለነበረም አባቱ
ፊፋን : ልማት ትምህርቱን ውስጥ ፈረንሳይ መሥራት
በፕሬዚዳንትነት : አርት ሥነ ከተባለ በሳይንስ ያኔ
በድጋሚ : የታሪክ በንግድ ሲገባ ምርምር ሆነ
ከተመረጡ : የነበረችውን የራሱን በሚገኝ * ነበር
ኳስን : የተሰየመች ከጥቂት አካል # እንደነበረ
አደጋ : ሹመቱ የዓለምን ቪዛው ዕድል እንደማይችል
ሊወድቅ : አብሮ እንደሚገመት የሆነ በ# ለአባቱና
እንደሚችል : ብለው ቢሆንም ያገኙት በ# *
ይናገራሉ : ተሰምቷል ጀመረ ተቀጠረ ለእናቱ ለአባቱና
ዋነኛ : ጥሩ ዓመቱ ለአባቱና
ተፎካካሪ : ገንዘቡን ተጓዦች ሮዚም የፌስ የጋዜጣው
እንደሚቀርቡ : የመዘገበው ፌስቡክ ቀጥሎም ወዲያውኑም ፊላደልፊያ
የሚነገርላቸው : መጠኑን ቪክተር ተረጋገጠለት #ኛ ለእናቱ
ለሙስና : እንደሚያደርስ ግንባር ተቀባይነትና አሜሪካ ፊላደልፊያ
የተጋለጠ : ዕውቀትና ጽሑፍና ለጥሬ መሠረት እንደጠየቀው
በርካታ : መጠን ሰላም በመመለስ ወራት ለማቋቋም
የገቢ : ሥነ ላይ በሚገኝ ለአባቱና
ምንጭ : የባግዳዱ ገበያ ጊኒ ጓደኞች መሣሪያ
የሆኑ : መጠን ሰላም ወራት ለማቋቋም ዓመቱ
ትልልቅ : ፍራንቼስካና ሕይወቱ ንፅፅር ከ# የሚጠቁም
ስፖንሰር : ውስጥ ዓላማውን የሚፈልገውን የነበረችውን ፊላደልፊያ
አድራጊ : ሜንዴዝን የአጫጭር እግዚአብሔርና ተቀባይነትና ቤት
ድርጅቶች : በክርስትና የሚሠሩ ዜና እራሱ ነበር
ራሳቸውን : መሆናቸው ጊኒ አካሄድ ዋና የገንዘብ
ማግለላቸውን : ሄዶ እግዚአብሔርና ጓደኛው የሚያደርገው ትገዛ
ተናግረዋል : ሰኔ ዞሩ ወሰነ ጠየቀ #ኛ
ከውድቀት : ጋራዦቹ የሚፈልገውን በሚገኝ ፊላደልፊያ ዓመቱ
ለማዳን : ውጪ ክፉኛ ባንክን የእንግሊዝ ፊላደልፊያ
በተለይም : ለመዳር አስተዳደር በሌሎችም የሚጠቁም ዩኒቨርሲቲ
ከስድስቱ : ገዛና የሆነ ቤት በሚገኝ በ#
አህጉሮች : አደንዛዥ ተሳክቶለት ጀመረ ወራት ለእናቱ
ድምፅ : ከሦስት ዛሬ ለ# ያህል የገንዘብ
ፌዴሬሽኖች : እንፈጥራለን በሚገኘው ነጋዴዎቹ የ# ፈረንሳይ
ጉዳዩን : ሬዲዮ አገሪቱ እስከ የላቸውም ሁነኛ
በከፍተኛ : የተቀመጡ ጀመር መለያ ተጋድሎ በቅርቡ
ጥንቃቄ : ኢኮኖሚያዊ ድምፁን ዩኒቨርሲቲ የገንዘብ ድሃ
እንዲመለከቱት : መለኮት ዊንጌት ተማረከ ግንባር አቋቋመ
ጥሪ : የገለጸች ወደ በኋላም ተረዳ ድሃ
ማቅረባቸውን : የሆነ ነበር #ኛ ለአባቱና
ዘገባዎች : በመሆንም የዘለቀ ግጥሞቹም እንዲቆዩ ድሃ
አመልከተዋል : ነበሩት ለማድረስም ጠየቀ የእንግሊዝ ተቀጠረ
ነጋዴዎች : ሆኑ ዝግጅት የምታውቁ ባነበበው ቀደም
የብቃት : አሥራተ በሙሉ የእንግሊዝ ፊላደልፊያ #ኛ
መመዘኛ : ይነጫነጫል ፍራንሲስ ንባብ መሆናቸው የገንዘብ
መመርያና : ስለመያዝ ፋሺስት ሚኔሶታ ትገዛ ለማቋቋም
የሊዝ : ከመደብር የነበረችውን በሚገኝ #ኛ ለእናቱ
አዋጁ : ሲገኙ የሚጓዙ ማስተካከያ የጻፋቸውና በማተሚያ
እንዲሻሻል : አልሽ ብር ወጣ አሜሪካ አሜሪካን
ጠየቁ : ይደረጋል ተደንግጓል ጋበዛቸው ተረጋገጠለት ጠየቀ
ሚያዝያ : መጋቢት አባቱ #ኛ ለአባቱና
ባህል : ብርሃነየሱስ ስታስበው ባነበበው ተቀባይነትና ነገር
አዳራሽ : እስር ከማንም ተጠቅመው ወረርሽኙ መሥራት
በተካሄደው : በመሆኗ እጥረት የሚፈልገውን የገንዘብ የእንግሊዝ
ውይይት : ክህነትን ሕክምናውን በሌሎች የሚሠሩ ኤምባሲዎች
ሁለቱ : ስልክ ቀደም አሜሪካን የራሱን ስለነበረም
ሕጎች : የኢትዮጵያና የሚፈልገውን የገንዘብ ወዲያውኑም ቤት
ለንግድና : አመንቴና ነኝ መንግሥትን በ# *
ኢንቨስትመንት : አይፈቀድለትም የሚጠቁም ቢታወቅም ዩኒቨርሲቲ የሥራው
ማነቆ : ኢትዮጵያዊ ወንጀለኛ ኮሌጅ የፔንሲልቫኒያ የሚል
እንደሆኑ : እንዲቃጠል ማለፍ ታላላቅ ማጥናት እግቡ
ተጠቁሟል : አሰሱ አጋጠመው ተረዳ ትገዛ ተቀጠረ
ይህንን : የአገጣጠም ጉዞአቸውን ከፊልም ስለነበረም አባቱ
ስብሰባ : ያጠናከረው ማሪዋና መጽሐፍ ተመሳሳይ በአሜሪካ
የመሩት : በልጃቸው የሚሆኑት በሁለቱም ሚና ፔንሲልቫኒያ
አስተዳደር : ቱሪዝም ዩኒቨርሲቲ የገንዘብ ለእናቱ ለአባቱና
ከንቲባ : መመርያውን ከፍሎሪዳ አዘዋዋሪዎቹም ለመፍጠር ወዲያውኑም
ድሪባ : ይሆኑ በተጨማሪም አሜሪካዊ ትገዛ ፊላደልፊያ
ኩማና : እጁን ምናልባት የነበረውን ሚና እየተሳካ
የንግድ : የሆቴል መድበሉንም የኢትዮጵያውያን በመቆጣጠር ተማረከ
ሚኒስትሩ : መረጃ ወር እራሱ ወደ ልጅ
ከበደ : በአይሁድ ዓመት እንደነበረ በ# *
ጫኔ : የሆቴል በኋላም በማተሚያ ለማድረስም የገንዘብ
ያሉባቸው : ጋዜጠኞች ተመሥርተው በእምነት ፈንታ ተውኔቶች
ታይቶ : መጽሔት ሲከፍት አንድ በሚገኝ ድሃ
ማሻሻያ : ከቀጣሪዎቻቸውና መሆናቸው መንግሥትን በ# *
እንደሚደረግ : ቆይታ ፍላጎት የአሜሪካ መሣሪያ የሆነ
እንዳሉት : ልቦናውን ስብሰባ ሁለቱ እንዳይገቡ ጋር
በተለይ : የእኛ በአጠቃላይ እግዚአብሔርና እንዳለበትም ተቀባይነትና
ምዘናው : ኤድያ በ# * ነበር ልጅ
ሁኔታን : ሁኔታ ዜግነቱ አገር ግለሰብ አሜሪካዊ
ያገናዘበ : ዲግሪያቸውን ሊያሳስበኝ ብዬ መሻሻልን ዕድል
ምክንያቱም : በካሊፎርኒያ ዕድገቱን ለዚህም ቴክሳስ ዓላማውን
ጥንታዊ : ያፅናኑታል በአመራር ላይም ተቀባይነትና አዘጋጅም
በመሆኗ : በተካሄደው መኖሪያ ፔንሲልቫኒያ የሚፈልገውን የገንዘብ
ያሏት : ነጋዴዎቹ ጠቅሶ ሳምንት ነፃነት ፍራንክሊን
የመገበያያ : አፍሪካን ተውኔቶች እንደዘገበው በምዕራብ ስለኤሌክትሪክ
ሕንፃዎች : የሆኑትንና ተውኔቶች መሥራት የነበረችውን የራሱን
ደረጃቸውን : ከጀርባችን አቅጣጫ ኢኮኖሚያዊ ከተለያዩ ማግለላቸውን
የጠበቁ : ኃላፊ እንደማይችል የሆነ ነበር ልጅ
አይደሉም : አውግዘዋል አይቷል ይስተዋላል አድርጓል ቀርተውበታል
ሕንፃዎቹም : የእውነቴን የጋዜጣው ወዲያውኑም ለአባቱና
ሆኑ : ነጋዴዎች ድጋፍ ፍራንክሊን የራሱን #ኛ
የቀበሌና : ማደር አውጪዎችና ሊሸጥ ቤት ድሃ
ኤጀንሲ : ማግኘት ለብሰው ተቀጥሮ መንግሥትን *
ንብረቶች : ሲያስታጥቋችሁ አለመቻላቸው ኢትዮጵያውያን ላንኪ አነጋጋሪ
በብቃት : አልፎንስ የኢትዮጵያና የነገረ ይኼው በአካል
መመዘኛው : እንዳለው ገዛና መንግሥትን በ# *
በእነዚህ : ገልጸዋል ተጠቅመው ለብሰው የሚያደርገው ተቀጥሮ
የሆቴል : ጫኔ የንግድ ቤቱ አሁን ፍራንስ
ለማካሄድ : እያናገረ የሚፈልገውን ቤት አንድ ዓመቱ
የሚመጠጥ : ቀን እና ካሜራ መስኩ ወራት
መፀዳጃ : ሰደድ ትምህርት ጋዜጣ በማተሚያ ለ#
ይጠየቃል : ተቀጠረ አንድ ስለነበረም አባቱ ለእናቱ
የአትክልትና : ከሳምንታት ለማቋቋም ወዲያውኑም ዓመቱ አባቱ
የፍራፍሬ : ሌሎቻችን በራፍ ሥርጭት ፍለጋ ፍራንክሊን
ንግድ : መምህር ያሉ የሚወዳቸውን ቲ በሳይንስ
በሴራሚክ : ፍረዱኝ የሚጠራው ዓመቱም የሚፈልገውን የነበረችውን
ሊገነቡ : መሬት ምክንያቱ ሮያል አሜሪካ ሊያገኝ
ይገባል : ዕርዳታ የገንዘብ የራሱን ማተሚያ ነበር
ይላል : በእነዚሁ ዓላማውን የሚፈልገውን ወዲያውኑም በሚገኝ
እንዴት : ያለ በአንድ ስለኤሌክትሪክ እራሱ የራሱን
በማለት : የዓለምን መሥርቶ መደብር ዕድል እንደማይችል
ነጋዴ : ሲያደርግ ከማለቃቸው ወራት ዓመቱ ድሃ
ፎረም : ሀገረ የተውጣጡ ተመሳሳይ እራሱ የገንዘብ
አባላት : አባላቱ ጥቂት ቅዳሜ ኢጣሊያ አውጪዎችና
ይጠይቃሉ : ይቀላቀላል አሰሱ ዞሩ ተረዳ ጠየቀ
የሚገኙ : እንደሆኑ ቃላት ታላላቅ የገንዘብ ድሃ
ጋራዦች : በተሻኮቱ ሸር ብዙኃን እንደጠየቀው ብርሃኑ
ዓመታት : በእስልምና ማጥናት ማሳተም ነገር አሜሪካን
ያለፋቸው : በመሆንም የመጣ ታይቶባቸው እየረቀፁ ድሃ
ከጥቂት : ማተሚያ ድሃ ለአባቱና
ከጎናቸው : ቅዳሜ አገሪቱ በመቆጣጠር ስለ ከተባለ
ቢከፈት : ካጨዱና መመርያዎች በካሜራቸው ለመፍጠር ቤት
ከትምህርት : መዝገበ ቀዬውን ነው በኋላ ከአንድ
አጠገብ : ጤና ከተመረቀ ዓመቱም መሥራት ዓላማውን
አይገባም : የማይነጣጠል ከትምህርት ሳይሆን ከሦስት ይደርሳል
ጋራዦቹ : ቃጠሎ አጠገብ ከተመረቀ ዓላማውን የሚፈልገውን
እንዲነሱ : ቆይታ ናቸው ዕድል ዕርዳታ የሆነ
ይደረጋል : ጠየቁ ያገኛል ተረዳ ጠየቀ ለእናቱ
አግባብ : ከጎኑ በእምነት አሜሪካ ዓላማውን አሜሪካን
በአጠቃላይ : በተለይ ቤት በ# ድሃ #ኛ
ሊታይ : የኳታር ባንኮች ምርምር የነበረችውን የሆነ
እንደሚገባ : በመሆኑ ከተመረቀ ዓላማውን የነበረችውን ለማቋቋም
ነጋዴዎቹ : መውደም ያሏት ጠቅሶ ከማል በመወከል
ጠይቀዋል : የበቃው ከጀመሩ ቆይቷል ጠየቀ በ#
የነጋዴ : ከመንፈቅ ነጋዴ የሰሎሞን ከሳምንታት ቆይታቸውን
አባላቱ : አውጪዎችና ለጥያቄ በማድረጉም ሚና ቤት
ጥያቄ : ድረስ ጊኒ መልዕክት ሚና እየተሳካ
ከተሰብሳቢዎች : አህጉሮች ተሳክቶለት ማተሚያ * ልጅ
ማግኘቱን : አስገኝቷል በማተሚያ ያኔ ስለነበረም #ኛ
መረዳት : ከጎናቸው ሲከፍት እንደሚኖርበት ቤት አንድ
ችሏል : የሚገባው ተቀጠረ አንድ * ለእናቱ
የከተማ : ቢልዮን ተሾመ ተልዕኮውም ስለነበረም አባቱ
በሊዝ : በንቀት ይመራ በመሆኑ በመዋለድ ገንዘብ
ስለመያዝ : ስትሆን መመርያና ፋሺስት በእጅ ለመሳተፍ
አዋጅ : ፈቃድ የዕርዳታ ወጣ ተመሳሳይ አሜሪካ
የተጠየቀው : ሲያሳንፈው እያለ ጥያቄያቸው በሙስና ጣሪያው
በአክሲዮን : ተያይተው ለብሶ ፔንሲልቫኒያ ተቀጥሮ ለማቋቋም
ተደራጅተው : ሳይርበን ሆኑ ወንድሞችህን ቦታ ፖሊሲ
ያሉበትን : አዘጋጅ ዓመት # እንደነበረ ድሃ
አካባቢ : የምንኖር ማተሚያ ለእናቱ ለአባቱና
ማልማት : ቀንሰው ሰሎሞን ጓደኛን ለማቋቋም ፊላደልፊያ
የሚፈልጉ : ያሳተመውን መጽሔት ከመደብር እንደሚኖርበት ቤት
አለመቻላቸው : ኢትዮጵያውያን አነጋጋሪ ለውጥ አብዮታውያንን ዕድል
እነዚህ : ይህ ወዲያውኑም ፊላደልፊያ አባቱ ልጅ
በሚያካሂዱበት : ዶላር ተቀጥሮ ተቀጠረ ዓመቱ ስለነበረም
የቦታ : ብቁ የልጅ እዚህ ኤምባሲዎች ሆነ
ቢያቀርቡም : አላቸው ጉስቁልና አንዱ ያለ አብዮታውያንን
ምክንያት : ታስመስሉታላችሁ በጎደላቸው የውጭ የተገረመው አገሮች
ጥያቄያቸው : የገንዘብ የራሱን ቤት ለእናቱ ለአባቱና
መስተናገድ : ተብሎ መልዕክት ገዛና የሆነ በ#
የማይችል : ኢኮኖሚያቸው ዩኒቨርሲቲ የሥራው የገንዘብ ድሃ
ምሬታቸውን : ዩኒቨርሲቲ ከፍተኛ ለእናቱ ለአባቱና
በስብሰባው : ፋሺስት ትገዛ ተቀጠረ ለእናቱ ለአባቱና
መንግሥት : ሪሌሽን ጥቂቶች እግዚአብሔርና ሆነናል መጽሐፍ
የገበያ : ወዲያውኑም ለአባቱና
ማዕከላትን : ማዕከላቱን ወራትን መሥርቶ የኢትዮጵያ ጊኒ
ለመገንባት : ሊያሳስበኝ ጎረምሳ የመገንባቱን ሲታኘኩ መሻሻልን
አቅዷል : የቀለለው ያገኛል ተረዳ ጠየቀ ለእናቱ
ማዕከላቱን : ማዕከላትን የጋዜጠኝነት ኮሌጅ የሆነውን የሆነ
የመገንባቱን : አላልኩም ተነባቢነት ወራት * ለአባቱና
ኃላፊነት : በጥረት ለውጥ ኢኮኖሚያቸው በአንድ እንዲሆኑ
ለእኛ : አንገት የነበረውን ፖሊሶች የሆነውን ዓላማውን
ይስጠንና : ያለውን ሲሠራ ተፈጻሚነቱም ነገር አሜሪካን
ጤና : አጠገብ የሚገመተውን ከተመረቀ መሥራት የነበረችውን
ማዕከልና : ሥራ ወጣ በፌስቡክ አሜሪካን ፊላደልፊያ
መንገድ : መረጃዎች አኅጉሮች የተደሰቱ ባንክ አገሮች
ይገንባ : ጠባብ ፎረም በተራኪነት በመገናኘት ጋዜት
መሬት : ሊገነቡ አካል ብር ምንዛሪ ቀደም
ከጨረታ : ከተመረቀ የነበረችውን ተቀጠረ አንድ #ኛ
ውጪ : የታሪክ ለማዳን ክፉኛ ፊላደልፊያ *
የሚገኝበት : አዋጅ ጎረቤት ላይቤሪያና አሜሪካ ዓላማውን
ጠባብ : ተንቀሳቀሰች ዘመን በክርስትና የሚገቡም እራሱ
ሊያካሂዱት : ባለመቻላቸው በተያዘው ካሜራ መስኩ ማሳተም
የሚፈልጉትን : ኦርቶዶክስና ኅብረ ማሪዋና ተጉዘው ከእንግሊዝ
ልማት : ትምህርቱን እንደ ፈረንሳይ መሥራት ስለፈለገ
ማካሄድ : ጋዜጣዊ ሸርት የሚያደርገው ተቀጥሮ ተቀጠረ
ካለመቻላቸው : ከመሆን ባንክን ማሳተም የሆነ ቤት
ከዛሬ : ካስተዋወቀችው በነበረው መሥራት አንድ #ኛ
ነገ : ሳይሆን ከፍተኛ በኋላም ተቀጥሮ ተረጋገጠለት
እየተጉላሉ : ሲብጠለጠሉ ለብሰው በፖለቲካዊ ዩኒቨርሲቲ ለ#
አስረድተዋል : ገልጿል ያገኛል የሚያደርገው ጠየቀ ተቀጠረ
ያሉበት : ለእኔ የደቡብ መጠን የዓለም ቤንጃሚን
ክፍተቶች : ሁሉን ያልተረጋገጠው ሠርግ እኛ ፍለጋ
እየታዩ : ኄር ያደረገ ፕሬስ በሳይንስ ዩኒቨርሲቲ
ገልጸው : እራሱ ወደ * ልጅ ለአባቱና
ውሳኔ : ርቀት ሃይማኖቶች ብሔራዊነት ጊዜ ከተመረቀ
እንደሚደረስና : ሥልጣኔን የጻፋቸውና ሚና የሆነ ስለነበረም
የከተማው : ከሮም የካርዲናልነት ካቶሊካዊት ጨምሮ ለአምስት
ተጠናክሮ : ጥረትና ክርስቲያን ተገቢነት ያሳተመውን በካሜራቸው
እንደሚቀጥል : ጨምረው ይዘዋወር ከተማውን እንደነበረ ዕድል
አስታውቀዋል : ጥቅሶቻቸው ሄዷል ጠየቀ #ኛ ለእናቱ
በበኩላቸው : በመሆኗ ውጭ በሙሉ ጋዜት ፔንሲልቫኒያ
ጠቀሜታ : ከአንደኛው ከተለያዩ አዘዋዋሪ የተሰማው ሲከፍት
እንዳለው : ወንበር መመዘኛው ቪክተር ሚና ገዛና
መመርያውን : ሲነግሩህ ጳጳስነት የአገጣጠም ከዚህ በቪዲዮ
ለማሻሻል : ቦታ ኤምባሲዎች መያዝ ያለፈ የራሱን
መጀመሩን : የተቀመጠ እንደሚያደርስ ላይቤሪያና ባንክን ተመሳሳይ
ጨምረው : እንደሚቀጥል ያስተላልፍ ኢትዮጵያውያን ይዘዋወር ከተማውን
አመልክተዋል : ጠየቀ ተቀጠረ በ# * ልጅ
ካቶሊካዊት : ከሮም አዲሶቹን ተጉዘው ሆኖ መተዋወቅ
ቤተ : የኢትዮጵያን እጥረት ፈቃድ በሙሉ በላይ
ክርስቲያን : ቅድመ በካሜራቸው አንድ ድሃ ነበር
ሊቀ : ባይኑ እንዳይጨምር እንደሚያደርስ በካሜራቸው አሜሪካዊ
ጳጳሳትና : ከመጤፍ ዕውቁ በሴት ለመፍጠር የሚፈልገውን
ጳጳሳት : አሥራተ በሙሉ ጓደኛው የእንግሊዝ ፊላደልፊያ
ጉባዔ : ሙከራውን ጎጆ በ# * ነበር
ብፁዕ : ቤንጃሚን ወዲያውኑም ለአባቱና
አቡነ : አኅጉሮች ቪዛው ማሊ ሊያገኝ የገንዘብ
ብርሃነየሱስ : ነገር የሆነ ፊላደልፊያ ለአባቱና
ሱራፌል : አሉባልታ #ኛ ለእናቱ ለአባቱና
የካርዲናልነት : ደረስኩብሽ የከተማው ለሴፕ ማሪዋና ከእንግሊዝ
ማዕረግ : ኃላፊ እንደሚችሉ ዕድል ዕርዳታ የራሱን
አገኙ : ወሰነ ተረጋገጠለት ጠየቀ ተቀጠረ #ኛ
ብርሃነየሱስን : መስማማታቸው ማጥናት ማሳተም እግቡ ድሃ
ሊቃነ : የገንዘብ የራሱን ማተሚያ ለእናቱ ለአባቱና
ማዕረግና : የኪራይ ሆኖም በጅምር ማተሚያ በ#
አልባ : የራስህ መንደር በተካነበት የሆነ በ#
የመምረጥም : ተቻኩላ አንባቢ ጋዜጣዊ በላይ ወዳጆች
የመመረጥ : ሜትር የፍልስፍና በኋላም ተቀጥሮ ወራት
የሌላቸው : የቀበሌና ተፎከካሪዎች ቅድመ እየተሳካ ቤት
ሹመት : ከሮም እግዚአብሔርና ውጭ ጓደኛው ጋዜት
እሑድ : ይሁን በመስጠት ብቻ ሳምንት ጓደኛን
ረፋድ : ፀሐይን እየተወራጨ መድኃኒዓለም ተስፋዬ ቪክተርና
በቫቲካን : አባል አሜሪካ የሆነ በሚገኝ በ#
በመስጠት : በሚከናወነው ያዘገሙት ያጋለጠው ሳምንት ሰላም
ፍራንሲስ : መመዘኛ መሆናቸው ጊኒ ኪሳራ ምርምር
ቫቲካን : ከተማው መንፈሳዊንት የኢቦላን በእነዚሁ የኢቦላ
ሬዲዮ : ባልነበረ የሚመራው ተሳክቶለት ሁነኛ በሳይንስ
ታኅሣሥ : ታወቀ ቀርተውበታል ለማድረስም ነበር ልጅ
እንዳስታወቀው : መሻሻልን ሊሆን እግቡ ፊላደልፊያ ድሃ
የአዲሶቹ : አሰሱ ተረዳ ጠየቀ ተቀጠረ ለእናቱ
ካርዲናሎች : ጤና ከውጭ በአካል ተሾመ መሥራት
በዓለ : ሌግዠሪ የሽብር ነገ የሚፈልጉትን ከትምህርት
ሲመት : እንዳይጨምር ባነበበው ፈረንሳይ ነገሮች ነገር
የሚፈጸመው : አረጋግጠው እንዲቆዩ ከተማውን ዕድል እግቡ
የካቲት : ቦታ ተቸግሮ ኪሳራ ፍራንክሊን የራሱን
#ዎቹ : ተተኪ ተሾመ ተልዕኮውም ለአባቱና
ተሿሚዎች : መምህርነት የፌስ ከማል ላይም ኮሌጅ
ከሁሉም : ከ#ኛው ለኢትዮጵያ ለማዋል ጥሩ እንደ
ክፍለ : ጽሑፍና እንደጠየቀው ወደ ድሃ ለእናቱ
ከሚገኙ : ልንጓዝ የፌስ ላይም ጠየቀ ለእናቱ
የተውጣጡ : የኪራይ የገለጸች ፎረም ተመሳሳይ በጅምር
ስብጥሩም : የእኛ ተቀጥረው ነገሮች ተቀባይነትና የሆነ
የሮም : ልሙትላቸውና መቼስ ንባብ እየተደራደረ ዓመት
ካቶሊካዊ : ቲሸርት ስለነበረም * ነበር ልጅ
በዓለም : ሥነ ባወጣው በሚገኝ #ኛ ለእናቱ
ካሉት : መታደም ምርምር አሜሪካ የሆነ ፊላደልፊያ
አብያተ : መኪና ሾፌሩ ተቸግሮ ሊሸጥ ያለፈ
ክርስቲያናት : የምንሰማው ግለሰቦች ማድረጉ እንዳለበትም እንደነበረ
ያላትን : ትላለች ግጥሞቹ ዛሬ ጋዜጣ ተቀጥሮ
ትስስር : ራዲያተሩ ሰርቪስን ሞዛይክነት ሴራሊዮን እንደማይችል
የሚገልጽ : አመሲያ ኤጀንሲ በመገናኛ ማግኘት ለብሰው
አፍሪካዊ : ያውስ የካቲት መንፈሳዊነት አብረውት ማይል
ካርዲናል : በጸሐፊነት እንዳይጨምር አሁንም ፈረንሳይ ኮሌጅ
የሆኑት : ያገኙት ላይም * ለአባቱና
የኬፕቨርዴው : ታክሲዎች እንዲሁ ከሦስት ከአንድ አገሮች
ጳጳስ : ትይዩ ለ# ድሃ ለእናቱ ለአባቱና
ሲሆኑ : ካጣችሁም መመዘኛ አያቶቼ ከቀጣሪዎቻቸውና የኢትዮጵያ
ከተመረጡት : ሪሌሽን ጠቅላይ ለጥሬ የሚያደርገው ተቀጥሮ
አምስቱ : አጉል በበኩላቸው ጥያቄያቸው እጅ መስኩ
አረጋውያን : ማርያም ለሙስና የአጫጭር እንደሚያደርስ ግንባር
መካከልም : ሲለን ራሳቸውን የገንዘብ የራሱን ቤት
የሞዛምቢኩ : የሚወጡ በኋላም የእንግሊዝ አሜሪካን #ኛ
ይገኙበታል : ታወቀ ጠየቀ ተቀጠረ በ# ነበር
አዲሶቹ : እንዲሁም ከፍሎሪዳ ተሾመ ነገር ወዲያውኑም
አብዛኛዎች : ዕድሜያቸው ዴሬሳ ዞሩ እንዲሆኑ መካከል
በተሰጣቸው : ተፈጻሚነቱም ተቀባይነትና አንድ ድሃ #ኛ
በመንበረ : ተጠቅመው መሥራት የእንግሊዝ ቤት ፊላደልፊያ
ጴጥሮስ : የሚጠበቁት ወራትን ባንኮች በእጃቸው ለኦሬንጅ
የሚቀመጠውን : ምክር መንግሥትን በ# ነበር ለአባቱና
ፖፕ : ኅብረት በተለያዩ ዋና የሚል የሆነ
ለመምረጥም : የተጠቁት ግን በሚገኝ ለአባቱና
ለመመረጥ : ሲሠራ መሻሻልን ታላላቅ ማጥናት ዕርዳታ
ይችላሉ : ሆነዋል ተደርጓል መድበሉንም ስር ተረጋገጠለት
ከተለያዩ : የነፃነት ቫሉታ ባወጣው ራሱን ጋዜት
አገሮችና : ታክሲና በተከፈተ ውስጥና በሙስና የማመንና
አኅጉሮች : አቡነ ቪዛው አገሮች ሊያገኝ የራሱን
አዲሶቹን : እግዚአብሔርና መመርያዎች የሚጓዙ ቅኝ ተቀባይነትና
የቤተ : የአቡነ በእነዚያ በእነዚሁ ወዲያውኑም አባቱ
መሪዎች : ውጭ በሙሉ የገንዘብ የእንግሊዝ ቤት
በቅዱስ : የአንዲት ሥፍራ የድጋፍ የሚያደርገው የእንግሊዝ
አደባባይ : ተሞጋግሰው ግለሰቦቹ ሰው ገንዘብ የራሱን
ሲያደርጉ : ቡክ ላይ ስለኤሌክትሪክ በሚገኝ ስለነበረም
እንዳስታወቁት : ካሜራ ቪክተር የአሜሪካ ሚና የሆነ
ፍላጎታቸው : አገሮች ዩኒቨርሲቲ ወደ ለእናቱ ለአባቱና
የሚገኙት : መታደም ምርምር አሜሪካ የሆነ ፊላደልፊያ
ከሮም : ካቶሊካዊት የከተማው ሆኖ ተረጋገጠለት ያኔ
ያላቸው : መሬት መድበል አካል በነበረው ድረስ
የማይነጣጠል : አይገባም ለመቆናጠጥ ከሦስት ይደርሳል ከአንድ
ለማሳየት : መሆኑን ግዴታ እየተጎዳ አንድ ነበር
በአዲሶቹ : ለደካማ በጸሐፊነት ያመሰጠረበት በ# ነበር
አጋጣሚም : መከበሩ ሳቢያ ለብሰው ዓመቱ ድሃ
ለቫቲካን : ይፋ ተብሎ ሮያል ሆነ አሜሪካን
ህዳሴን : በበኩላቸው ሆኖም ቅኝ መስኩ ቤት
ለማምጣት : ጥቂቶች የምንኖር ደረስኩብሽ በጎደላቸው የመንግሥት
ሁሉም : ጎጆ ገዛና መንግሥትን በ# *
በዋዜማው : በንግድ ያጋለጠውን ወዳጆች መሥራት የራሱን
እንደሚመክሩ : ፌዴሬሽኖች ፊልምና ኒውስ ተሳክቶለት መስኩ
ሳይገልጹ : የተወለዱት መስማማታቸው ቢታወቅም ተነባቢነት ወራት
አላለፉም : ይገኙበታል ጠየቀ ተቀጠረ ነበር ልጅ
የአቡነ : የቤተ ማይል ወዲያውኑም አባቱ ለአባቱና
መሆንን : የሆኑት የተደሰቱ የውጭ ዩኒቨርሲቲ ወደ
ተከትሎ : በመምራት ሊሸጥ ነገር የሆነ #ኛ
ደስታዋን : መስኩ ፍራንክሊን ኮሌጅ የገንዘብ #ኛ
የገለጸች : አገሮች ዩኒቨርሲቲ ለ# የገንዘብ ለእናቱ
ክርስቲያኒቷ : ከሦስት ትምህርት ከተላቀቀች ለ# ተቀጠረ
ጽሕፈት : የማሻሻያ ማተሚያ በ# * ልጅ
አባ : ሲመለስ ሥነ ባወጣው ሳምንት ካሜራ
ተስፋዬ : እንደሚያደርስ ባነበበው ተቀባይነትና ነገር ፊላደልፊያ
ወልደማርያም : በማድረጉም ያኔ በሚገኝ ዓመቱ ነበር
እንደተናገሩት : መድበል በመቶ ሚና የሆነ ነበር
ሹመቱ : ሲላት አካል ግለሰቦች ዩኒቨርሲቲ እንደማይችል
ለአገሪቱ : ሰጥተን አሁን ሸርት የሚያደርገው በኋላም
ትልቅ : ተበታተንን የማይችል ንጉል መጨረሻው ዴሬሳ
ክብርና : ተቃጠለ ኤጀንሲ ሳቢያ ሸርት እንዳለበትም
ኩራት : ልንጓዝ ማረፉን በሚኔሶታ ሳለ አሠራር
መሆኑንና : የበቁት ፈረንሳይ መስኩ ኮሌጅ ነገር
ለኢትዮጵያ : ወንድ ከሁሉም ዕድገት ለማዋል ዓመቱ
መንፈሳዊና : ፕሬስ ፍለጋዬ ጥቅሶቻቸው በሳይንስ ዩኒቨርሲቲ
ኢኮኖሚያዊ : ጥንቃቄ ከተጎዱት ቫን ዋና የገንዘብ
አስተዋጽኦ : ታዳጊ ስለነበረ እራሱ ጠየቀ በ#
ብለዋል : አይገርማችሁም ኤ ወጥቶ ያደርጉባቸዋል አገናኛቸው
ጳጳሳቱ : ጥረትና ኢትዮጵያን ሳቢያ በሁለቱም ሚና
ለካርዲናልነት : ለመቆናጠጥ ጽኑ ከሦስት ትምህርት ከእንግሊዝ
የበቁት : መሆኑንና የ# ፈረንሳይ ዓመቱም ኮሌጅ
ለኢትዮጵያና : የመገበያያ እንደዘገበው ኦስተን አገሮች ዛሬ
ለአፍሪካ : የጋዜጠኝነት የጉዞ በመወከል መስኩ ሮያል
ባደረጉት : ያየነው ይጎድለናል ተጠባቢነቱ አደንዛዥ ተሳክቶለት
ሁለንተናዊ : የእኔ በሳይንስ ያኔ ለእናቱ ለአባቱና
ሰብዓዊ : ተያያዥ ያለውን በጄኔራል ማሳወቅና ክፉኛ
መሆኑንም : ኒልን ዋና ዕርዳታ የገንዘብ የሆነ
እምብፁዓን : የእምነት ታናሽ ጠቅሶ ለጥያቄ በአሜሪካ
ደምረው : ይዘጋጉታል ድረስም አዳዲስ ኒውስ ተሳክቶለት
ታሪካቸው : ታሪኩ ክሬቲቭ ስለኤሌክትሪክ ያኔ በሚገኝ
እንደሚያመለክተው : ታይቶባቸው እንዲቆዩ ከተማውን እግቡ ድሃ
የተወለዱት : ልታወጣው ኢንቨስትመንት ሲጣጣሩ ለማወቅ ፍላጎት
ሐምሌ : አይመስልም እ ተማረከ ለምን ለማድረስም
በሐረርጌ : የእንግሊዝ አሜሪካን ፊላደልፊያ ስለነበረም ድሃ
ከሐረር : ኤድያ ምዘናው ሲወቀሱ አያቶቼ ከእንግሊዝ
አቅራቢያ : ሠርቷቸው በየፌርማታው ታላላቅ መሥራት ፊላደልፊያ
ጨለቅለቃ : ቢሆን ኅትመቶች አገላለጹ ኢኮኖሚያቸው ዜና
የነገረ : ፖሊሱም በአካል ተሾመ ቤንጃሚን ቀጥሎም
መለኮት : እንዲመለከቱት ተማረከ አቋቋመ ለማድረስም ያህል
ቲኦሎጂ : አካልም ቲንኪንግ ይዞ ከማል ከጊዜ
ትምህርታቸውን : የምናነድ የማናጠፋውን ቡክ የሚል የማተሚያ
በአገር : እንከታተላለን የተጣጣፈ ሥራዎች ጽሑፋዊና ቫን
ውስጥና : አገሮችና የማመንና ተብሎ እራሱ መሣሪያ
በእንግሊዝ : አይሃለሁ ከባንኮች ዜግነቱ ለመሳተፍ ትገዛ
ሲያጠናቅቁ : እያለ ሴኔጋል ዕፅ በመወከል የራሱን
ከኢጣሊያ : ዓይኑ ቀረ መለያ በሌሎችም ቪዛው
ግሪጎሪያን : በሙስና የሚፈቀድላቸው ቅኝ ጋዜት ዕርዳታ
ዩኒቨርሲቲም : ወንፊት አውድማ ፈንታ ማኅበራዊ ማሪዋና
በሶሲዮሎጂ : መካከልም አማርኛ የደረሳቸው ዕርዳታ የገንዘብ
የማስትሬት : በማገልገል ከተመረጡ በድጋሚ ሆነ የሚፈልገውን
ዲግሪ : ከጊምቢ ይዘዋወር በጅምር እንደሚኖርበት ነበር
አግኝተዋል : የምንዘርፍ መርቷል ነዋሪ ጠየቀ *
በቤተ : እነዚህ ይህ በእነዚሁ ወዲያውኑም በሚገኝ
አገልግሎትም : ማገዙንም ሲጣጣሩ ሊሆን ፍላጎት ድሃ
ማዕረገ : በምክትል አማራ ተጓዥ ድሃ ለእናቱ
ክህነትን : ውይይት ሆኖ ትምህርት # ጋዜጣ
ሲቀበሉ : ሲታኘኩ ወ/ሮ እየረቀፁ ለማወቅ ዩኒቨርሲቲ
ረዳት : በርሳቸው በተካሄደው ፔንሲልቫኒያ የሚፈልገውን የገንዘብ
ጥር : ሆነዋል አምናለሁ ታወቀ ቀርተውበታል ለማድረስም
የመጀመርያው : ባጋጠማቸው ዓመቱም ዓላማውን ወዲያውኑም ፊላደልፊያ
ጳውሎስ : ገባ ጠቅሶ ኮሌጅ ነገር ፊላደልፊያ
ፃድዋ : ታዳጊ ፍራንስ እራሱ ለማድረስም *
ተተኪ : #ዎቹ ተሾመ ተልዕኮውም ለአባቱና
በመሆንም : ዘገባዎች የዘለቀ ግጥሞቹም እየረቀፁ ቢሆኑም
ሆነዋል : ጥር ቀርተውበታል ለማድረስም ጠየቀ በ#
ከሲመተ : በሴት ብሎ ቲሸርቱን የ# ተልዕኮውም
ጵጵስናቸው : ወራት ድሃ ለአባቱና
የላዛሪስት : በ#ኛው ማረፉን በሚኔሶታ ባንክን የፌስ
ማኅበር : ናቸው እየጨመሩ እንደሚችሉ ማሳተም እንደማይችል
የጂማ : ነጋዴዎች የፕሮግራም የምታውቁ ፊላደልፊያ ለእናቱ
ቦንጋ : ሚና አሜሪካ የሆነ #ኛ ለአባቱና
ሀገረ : ፎረም አምባሳደር የዕርዳታ ወደ የገንዘብ
ስብከት : ዕድሉን ወያላው ባለሀብቶች ማስተካከያ ቢሊዮን
አለቃ : መታደም ምርምር የሆነ ነበር ልጅ
በሚገኘው : መሆኑንና ፌዴሬሽኖች የ# ፈረንሳይ ኮሌጅ
የካፑቺን : አልተናገራትም የደቡብ ይዞ ከማል ከጊዜ
ፍራንቼስካና : የምናጠፋ ትልልቅ ሕይወቱ ሥልጠናዎችን ሰው
የፍልስፍናና : ድጋፍ አባል ዋና ግን ስለፈለገ
ነገረ : መምህር ነን አገሪቱ የላቸውም ድጋፍ
ከመሠረቱት : እጅ አንድ በሚገኝ ድሃ ነበር
አንዱና : አሁን በኋላም ወራት #ኛ ለእናቱ
መምህርም : ላንኪ በሆኑ አካባቢዎች ከተማውን ሆኖም
ነበሩ : አይቷል ይስተዋላል ለጠፉ ቀርተውበታል ከጊዜ
ከመንፈቅ : ከሳምንታት ዓመቱ ለአባቱና
በማላዊ : ኢጣሊያ አውጪዎችና በማድረጉም ስለፈለገ የሆነ
ሊሎንግዌ : አሜን በስደት አሠራር መመርያ እንደጠየቀው
የ#ቱ : ከሆነና መመርያ ከማል መስኩ ተቀባይነትና
ካቶሊክ : ያደረሰው ድጋፍ እንቅስቃሴም ቢታወቅም ዋና
አመሲያ : የሚገልጽ ኤጀንሲ ያገኙት ለብሰው ላይም
ሊቀመንበር : የማይችል በክርስትና ኢኮኖሚያቸው ጋበዛቸው መካከል
በመመረጥ : የሚገርመኝ አገር የኢኮኖሚ ታላላቅ ማጥናት
በማገልገል : ውሳኔ ሃይማኖቶች በእጅ የወጣው የሚፈልገውን
ሲገኙ : አዋጁ ባለሀብቶች ማስተካከያ ብሎም ቢሊዮን
ቻንስለርም : ሲያስታጥቋችሁ ሥልጣን በአይሁድ እየተጎዳ የሚፈልግ
የኢትዮጵያና : ካጠገቤ በብቃት ብሎ በእነዚሁ በቪክተርና
የኤርትራ : ሠርግ ሞዛይክነት መስኩ ሮያል ኮሌጅ
ምክር : የሚቀመጠውን አዘጋጅ በአይሁድ ዓመት ጓደኞች
ቤትንም : እውርን አለኝ ይጫወት ከፍተኛ ተቀጥሮ
በሊቀመንበርነት : ማለፍ ፍላጎት እንደሚኖርበት እግቡ ዕርዳታ
ይመራሉ : የቀለለው አቅዷል አሳይቷል ያገኛል አገሮች
ክርስቲያኒቱ : ቆይ መሆናቸው ጊኒ አፍሪካ የገንዘብ
የታሪክ : ጥያቄያቸው በድጋሚ ፖሊሲ አሁንም የገንዘብ
መረጃዎች : አኅጉሮች ለቆ የውጭ ማሊ ኦስተን
እንደሚጠቁሙት : ከተመረጡ መሆናቸው ምርምር የነበረችውን የሆነ
የካቶሊክ : ታሪክ ብሎም የተገመተ የሥራው መንግሥትን
እምነት : ሸኘን ፕሬዚዳንት እስከ ተነባቢነት *
በተንሰራፋበት : ኢቢሲ ወሰነ የተለያዩ እንዲሆኑ ላይም
ከ#ኛው : ከሁሉም ለማዋል ጥሩ ሁነኛ ዓመቱ
አንስቶ : መልፋቱ ሞልቷቸዋል ይናገራሉ ተደንግጓል ገልጿል
ያለፉ : ምክር ከእንግሊዝ በ# * ነበር
ከእነዚህም : እያሽከረከረ ዙሪያ ጥበብና እንዳለፈ ነፃ
የሚሆኑት : የመሩት በራዲዮ በሁለቱም ሚና ፊላደልፊያ
አልፎንስ : በብቃት በእነዚሁ በቪክተርና በአካል ዓላማውን
ሜንዴዝን : አድራጊ አርት እግዚአብሔርና ጓደኛው ተቀባይነትና
የፖርቱጋልና : በራዲዮ ሚና ዓመቱ ለአባቱና
የስፔን : ካሜሮናዊው የአዲስ ኅብረ የሻረ የሥራው
ጊዜያት : ማንኛውም ፖሊሲ የ# የሚፈልገውን የነበረችውን
ፓትርያርክ : ማስገቢያ ፍጥነት ከቫቲካን ተረጋገጠለት በ#
ነበራቸው : ታውቋል አሳይቷል ዞሩ ጠየቀ ተቀጠረ
በ#ኛው : የላዛሪስት በሚኔሶታ የፌስ ላይም ወደ
የመጀመርያ : ስትሸሽ ባነፈሰው ጠቅላላ አሜሪካን ፊላደልፊያ
መንበር : ሜትሮፖሊታንን በኋላም ጠየቀ ተቀጠረ ስለነበረም
በሊቀ : እያበሳጨው ታናሽ በጄኔራል ድጋፍ ስለፈለገ
ጳጳስነት : ታዲያ መመርያውን መተዋወቅ ለመፍጠር በኋላም
የተቀመጡት : ማዕረገ ላይም ድሃ ለአባቱና
አሥራተ : በሙሉ ጓደኛው የእንግሊዝ አሜሪካን ቤት
ማርያም : አረጋውያን መመርያዎች እንደሚያደርስ ተቀባይነትና ቤት
የምሩ : በኋላ መንግሥትን የነበረችውን ያኔ ስለነበረም
ተከታያቸው : የልጅ ጊዜ ሳምንት ነገሮች #ኛ
ተቀምጠው : ኮርስ እየረቀፁ ድሃ ለአባቱና
ግንቦት : ታውቋል ዞሩ ጠየቀ #ኛ ለእናቱ
ሜትሮፖሊታንን : መንበር በኋላም ጠየቀ ተቀጠረ ስለነበረም
መምራት : ይዘህ ሆነው ዕድል ዋና እንደማይችል
ከጀመሩ : ጠይቀዋል ቀርተውበታል የሚያደርገው ጠየቀ ተቀጠረ
ሞልቷቸዋል : ያደረጋል ገቡ ጠየቀ ተቀጠረ ለእናቱ
ከቫቲካን : ውጭ ጋዜት ተረጋገጠለት የገንዘብ የነበረችውን
ዲፕሎማቲክ : ስለታሪካዊው ይመራ በመዋለድ ኦሮሞነት የነበረችውን
ግንኙነት : በጥያቄ መካከልም ቦታ ዋና የራሱን
በሌጋሲዮን : በሙሉ ሊያገኝ የእንግሊዝ #ኛ ለእናቱ
ደረጃ : ዘርተን ከፊልም የሚያደርገው በማተሚያ ማተሚያ
የጀመረችው : አውግዘዋል ደርሷል ታወቀ አቋቋመ ያህል
ኤምባሲ : ጂቡቲ ፖሊስ ትንሽ ጋር አሜሪካ
ያደገው : አብዛኛዎች ከገባ ስለነበረም አባቱ #ኛ
ይታወቃል : ግንቦት አስታውቋል አሰሱ ዞሩ አጠያየቁ
እነሆ : ተሾመ ቤንጃሚን ወዲያውኑም ለአባቱና
ከቦሌ : ሳይመስለው ሥራ በፌስቡክ ፊላደልፊያ ለአባቱና
መድኃኒዓለም : ሲሆን አሜሪካዊ ግንባር አዘጋጅም ፊላደልፊያ
ካሳንቺስ : ያልተለመደም ያገኙት ነበር ልጅ ለአባቱና
ልንጓዝ : ከሚገኙ ጠቅላይ እኔና በመመለስ ለእናቱ
ታክሲያችን : በስብሰባው ግለሰብ የኢኮኖሚ ነፃነት ጋዜት
ሞልታ : ሴራሊዮን የአሜሪካ የሆነ የራሱን ነበር
እየተንቀሳቀስን : ዲፓርትመንት እኮ ያነጋገራቸው ፍለጋዬ በፖለቲካዊ
ድንገተኛ : ቀናት አሜሪካ ፊላደልፊያ #ኛ ለአባቱና
ሠርግ : ሁሉን መመስከር መስኩ ፍራንክሊን ዋና
አጃቢ : እንደሚመክሩ እንዳልጣማቸው የጋዜጠኝነት የተገመተ ጠቅሶ
መኪኖች : ዘመን እራሱ ልጅ ለእናቱ ለአባቱና
መንገዱን : ከፍ ተቀጥረው ገዛና የሆነ አባቱ
ይዘጋጉታል : ደምረው ሁነኛ ተነባቢነት እግቡ *
ሾፌሩ : የሚገጠሙ በ# * ነበር ለአባቱና
እኔን : ከተላቀቀች በ# ስለነበረም * ነበር
ካላስቀደማችሁኝ : የምታውቁ በላይ ፌስቡክ የመሆን የእንግሊዝ
አጉል : ሆነና አምስቱ ባለቤቱ ፔንሲልቫኒያ የገንዘብ
ግብግብ : ብር ጥረት አሜሪካ የሆነ ፊላደልፊያ
ይገጥማል : ብርም ኦስተን አገሮች ከእንግሊዝ በ#
የምለው : ማንነት መሻሻልን ኒልን ታላላቅ ነገር
ከተማው : ቫቲካን ቲሸርቱን ዓላማውን የሚፈልገውን የእንግሊዝ
ሽር : ተወኝ ነኝ በመቶ ከገባ የጻፋቸውና
ብትን : ብርሃኑ አንድ ድሃ ነበር ለአባቱና
ከሚል : የተማሩት መተዋወቅ በኋላም ተቀጥሮ ተቀጠረ
ባለ : ጣይቱ አማራ ለአንድ ነገር ድሃ
ሊሞዚን : ወዮላችሁ እዚህ ጓደኛው ሆነ የእንግሊዝ
ሙሽራ : ክሪቲካል ዕድገት ነፃነት ፍራንክሊን ትገዛ
የሚጠራ : መጠኑን ተነባቢነት ለማቋቋም ለእናቱ ለአባቱና
ይጥፋ : የሚገባው ጠየቀ ተቀጠረ * ልጅ
እያለ : በሙስና በንግድ ፖሊሲ የራሱን ለእናቱ
ወያላው : ፓርቲ ማስተካከያ ቢሊዮን አሜሪካ አሜሪካን
ዕድሉን : ፓርቲ ስብከት ማስተካከያ ትንሽ መደብር
ያማርራል : እንደተመኘ ፍለጋ እንደነበረ ዩኒቨርሲቲ አዘጋጅም
ከመሆን : ካለመቻላቸው ጉዳዮችን ነገሮች መስኩ ተቀባይነትና
ይልቅ : ግለሰቡ ናይጄሪያና የኢቦላ ቴክሳስ ስለፈለገ
በራስ : እንደሚያሳየው እግዚአብሔርና ትገዛ ድሃ *
ጥረትና : ተጠናክሮ ቅድመ ሳቢያ በአሁኑ ለዚህም
ድካም : አሜን ሆነን መመርያ ሆነናል እንዳለበትም
በልቶ : ጥንታዊ ሰዎች # ላይም ድሃ
ከመርካት : እንዳታደናቅፉ መሠረት ሠራተኞች ፔንሲልቫኒያ መሥራት
በሰው : በሙሉ በላይ የእንግሊዝ #ኛ ለእናቱ
ግብዣ : እስኪያልቁ ጳጳሳት ሐያቱም በሙሉ ለመፍጠር
መታደም : ካሉት ቀድመው ሚና የሆነ *
የሚያስመካበት : ባረባው በመገናኛ ሳቢያ ተጉዘው ላይም
ስለሆነ : ያፈሳል ጣሪያው ኒልን የፔንሲልቫኒያ ዕርዳታ
የወያላውን : ከማል ጀመረ ከጊዜ ተቀጥሮ ጠየቀ
ሮሮ : ያልፈጠርነውን የዓለም ተመሳሳይ ሊያገኝ የራሱን
ከመጤፍ : የበቁት መሆኑንና ከሆነና ባለፈው በካሜራቸው
ሳይቆጥሩ : ፓሪስ የጀመረውን ስለ ቢታወቅም ዓመቱ
ተሳፋሪዎች : ዝግጅት የአባትህን ነገር አሜሪካን ለአባቱና
እርስ : በሳይንስ ለ# ያኔ በሚገኝ ለእናቱ
በርሳቸው : ረዳት ራይቲንግ ራዲዮ አሜሪካዊ ፔንሲልቫኒያ
ያጉረመርማሉ : ረድፍ ወዳጆች ዓመቱም የነበረችውን በሚገኝ
ያደለው : ሰዓት ይመስል አስፈላጊውን ፖሊስ መልዕክት
ይጋባል : ካልጠፋ ወንጀለኛ ገንዘብ የሆነ በ#
ያላደለው : ያደረገው በወረርሽኙ ሰው ገንዘብ በ#
ካልጠፋ : ይጋባል በዙሪክ የፊፋው ጎረቤት ገንዘብ
ጉንፋን : አቀፍ ወጣ ዕርዳታ ፊላደልፊያ *
ይጋባበታል : ትምህርታቸውን አባል የፔንሲልቫኒያ የሚል ገንዘብ
አይ : ከገባ የውጭ በ# ስለነበረም *
አንቺ : ድርሻ ያማርራል ከተማ ሰዎች በጅምር
ምፀትና : የሺመቤት አሁን በኋላም ወራት ለማድረስም
ሸር : መጨረሻው አመንቴና የአወሮፓውያኑ ተጉዘው የሥራው
ረቂቅነቱ : ከመርካት መሠረት በቪዲዮ ተቀጥሮ ለ#
ስሙልኝ : በግብፅ ነፃነት ፍራንክሊን #ኛ ለእናቱ
ባይ : እንዳይጨምር ፈረንሳይ ነፃነት ፊላደልፊያ #ኛ
ብሶተኛ : አንጎል ሚና እየተሳካ የሆነ ቤት
ወጣት : አመራር ከእናቱ ለ# በ# ነበር
ሦተኛው : ፋብሪካዎች ሰው ተነባቢነት ሊያገኝ የእንግሊዝ
ረድፍ : ያጉረመርማሉ በስብሰባው ለፊፋ ሃይማኖቶች ወዳጆች
ይናገራል : የተቀመጠች ቆይቶ ፖሊሶች ገንዘብ አሜሪካን
ቆይ : ፈንታ የኢትዮጵያ ጋዜጣ ቤት ማተሚያ
በሽንጣም : የተሰየመች ላይቤሪያና ሰዎች ተመሳሳይ አሜሪካን
ለመዳር : በእንግሊዝ ሊፈጠር ዜግነቱ የኢኮኖሚ ዕድል
የሚያስቡትን : ካስተዋወቀችው ገዛና #ኛ ለእናቱ ለአባቱና
ስንቶች : ለመፍታት ማሊ መሣሪያ የነበረችውን አሜሪካን
ይሆኑ : ባለቤቱ በፌስቡክ ትገዛ ፊላደልፊያ ለእናቱ
የአብሮነታቸውን : አሉባልታ የእፍኙ ማነቆ በራፍ ብርና
ርዝማኔ : ፖሊስ አሜሪካ ገንዘብ የነበረችውን አሜሪካን
አረጋግጠው : የሚፈጸመው ታይቶባቸው እንዲቆዩ እግቡ የገንዘብ
የሚዘምቱት : ጋበዛቸው ሆኖ አቋቋመ ያህል ጠየቀ
ስትል : ከውጭ ቴክሳስ ተሾመ ለአባቱና
መጨረሻ : በአንድ ከ# እራሱ ልጅ ለአባቱና
ወንበር : እንዳለው ሚና እየተሳካ የሆነ ቤት
አንዲት : ካጣችሁም ስለኤሌክትሪክ ጋዜጣ በማተሚያ የነበረችውን
ጦረኛ : ድር አዲሶቹን ለማዳን በመገናኘት እንደሚያደርስ
መሳይ : ሳንገብርና በንቀት መንገድ በሊዝ በመሆኑ
ትዳርን : ለክፍል ኑሮውን በኩል መያዝ ዓመቱም
የጦርነት : አኅጉሮች የውጭ አገሮች የፔንሲልቫኒያ ዩኒቨርሲቲ
አውድማ : አቡነ ችግሮች ቪዛው ተመሳሳይ ዕድል
ልታደርገው : ለማዳን በመገናኘት ተብሎ ቀደም የእንግሊዝ
ይዳዳታል : በእጃቸው ማንኛውም ወንጀለኛ የ# እንቅስቃሴም
እይታና : እንዳይዛመት ሰው ቪክተር በ# #ኛ
ፍርድ : ራዲያተሩ ባለቤቱን ሞት ሾፌሩ በአዲሶቹ
እንደራስ : ታክሲዋን ቤልጄማዊው ግን ያኔ በ#
ነውና : የተሰጠ ሴኔጋል እራሱ ወደ ለእናቱ
አልሽ : እንዲሻሻል በመገናኘት ጥረት ቅኝ አሜሪካ
አልተናገራትም : የካፑቺን በኋላ ሶሳይቲ ከጊዜ የነበረችውን
በእንቅብ : ሊያካሂዱት በተደረገው አበባ እና የራሱን
የናፈቅናት : ኦል የመዘገበው ተሳክቶለት ዩኒቨርሲቲ ከፍተኛ
ዲሞክራሲ : ያየነው ያዘገሙት ሰው ቡክ በመወከል
የእፍኝ : ሰው ተነባቢነት መሣሪያ ለማቋቋም ለእናቱ
የእፍኙ : ምንዛሪውን አባል የሚል እንደማይችል #ኛ
መሥራቷን : ሁል ሁሉ ገንዘብ አሜሪካን የራሱን
የወደድነው : ስሙልኝ ሊፈጠር እግዚአብሔርና ትገዛ *
ይመስላል : ምክትል ቤልጄማዊው በሚገኝ ዓመቱ ለአባቱና
ዘመናዊና : አካሄድ ስለነበረ ገንዘብ በ# *
ቅንጡዎች : ስሙልኝ ተነጥቆ ፍራንክሊን የፔንሲልቫኒያ ተቀባይነትና
ተምመው : ትንኝ በሌሎችም በላይ ይጫወት ዩኒቨርሲቲ
እስኪያልቁ : ሠርቶ ግብዣ ኢሳ ለፊፋ ለመፍጠር
መታገስ : የጋዜጠኝነት የተገመተ ቅኝ የሥራው ማተሚያ
ያቃተው : ብርቱ ሰጥቶ አዳዲስ እንደዘገበው ዓለም
ሾፌራችን : ሌላው ስብከት በነበረው ቫይረስ ገንዘብ
ከአንደኛው : ሲከፍት እንቅስቃሴም ጋዜት በሚገኝ ለእናቱ
እላፊ : ሞልቶ ያደረሰው አባል ግን ነገር
ይነጋገራል : ተቋማት በሳይንስ ያኔ ለአባቱና
ታክሲ : ይፋ ሴኔጋል እራሱ ጋዜት አሜሪካን
አያጅብ : እንዳይጨምር ኒልን ፈረንሳይ ተነባቢነት አንድ
ግድ : አባላቱ ለየት ነበረው ባወጣው አውጪዎችና
የለም : ያትታሉ የንግድ በ# * ነበር
የኪራይ : ጀመር በዕድሜ ማዕረግና ከተማ መጠኑ
መኪና : አብያተ የሴት ዋና በ# *
መልሰህ : ሰላም የሚያደርገው ከፍተኛ በኋላም ወራት
ሠልፍ : ተጠቅመው ወረርሽኙ ለመፍጠር ፔንሲልቫኒያ የሚፈልገውን
ስትይዝ : ቁጥር ራሱን በማድረጉም ዓመቱም በሚገኝ
እንገናኛለን : የወጣው ብርና የነበረችውን የሆነ የራሱን
ከአጭር : በኢኮኖሚው ዕፅ ሊያገኝ ገንዘብ ዕርዳታ
ተድላ : ኤምባሲ ድረስ ትንሽ ጥረት እንደማይችል
የረጅም : የነበረችውን ተቀጠረ በሚገኝ አባቱ #ኛ
ጉስቁልና : ጎረቤት ወጣ ትንሽ ገንዘብ ወዲያውኑም
ሲያስመካው : የውጭ ሰው ነፃነት ስለነበረ ገንዘብ
እናያለን : ተጨማሪ የሴት ዕድል ዋና የሆነ
ትዕይንቱ : ጆሮው ሴኔጋል ማሊ ከተለመደው ሰው
ከዚህና : ከመጀመሩ ከኢጣሊያ በመወከል ሊያገኝ የገንዘብ
ከዚያ : ማቅረብና መጠን ጎረቤት ታላላቅ ሰላም
እየተሳፋ : ሌላውን ጉንፋን ወጣ ጥረት ዕርዳታ
በመገረም : ይጋባበታል ቪክተርና ቪክተር ቀርተውበታል #ኛ
ሰቀቀን : እንዲገኝ እንዲይዙ ፖስተር ማሳተም የሆነ
በፈገግታ : ነፃነት ትገዛ ለማቋቋም #ኛ ለእናቱ
ሐዘን : ታሪካቸው በእግዚአብሔር በመዋለድ ነኝ ቢሊዮን
ይሸምናል : በሚኖረው ላይቤሪያና የሚጠቁም ቅኝ ዩኒቨርሲቲ
የራቀንን : ሲያስመካው መረጃዎች የውጭ ዕድል ልጅ
ልንደርስበት : በሥፍራ ሳልሞት ለቆ ዕድል *
ያመለጠንን : ሕይወት ዝግጅት በተደጋጋሚ እያገኙ ቅኝ
ልንይዘው : ለሴፕ በጎደላቸው የመንግሥት ኢኮኖሚያቸው ኦስተን
አስበን : ታክሲና የነፍሴ የሚጠቁም ቅኝ ዩኒቨርሲቲ
ብንጀመርም : እዚያ አሁንም መሣሪያ የገንዘብ የሆነ
ሕይወት : ያመለጠንን በጸሐፊነት እንዳይጨምር መሣሪያ በ#
ናትና : ከመንፈቅ ሊያካሂዱት ከማለቃቸው ካሜራ ማጥናት
በየፌርማታው : ታላላቅ ከፍተኛ የገንዘብ ፊላደልፊያ ድሃ
ድር : ሱባዔ አዲሶቹን ቡትቱ አቀፍ የሚጓዙ
ታሪክና : የተቀመጠ ባነፈሰው ጀምሮ ሲሆን መደብር
ትውስታ : ብሔራዊ ሰው ተነባቢነት ለማቋቋም ፊላደልፊያ
እንፈጥራለን : መውደም ፌዴሬሽኖች የ# ፈረንሳይ በመወከል
ጎዳናውና : የምናጠፋ ለሪፖርተር የጉዞ ብቻ ጋዜት
ፍጡራን : በስልክ የፔንሲልቫኒያ መሣሪያ ማተሚያ በሚገኝ
በጊዜና : ቴሌቪዥን አርት ቫሉታ ያየ ሳምንት
በሥፍራ : ኪሳራ የሚጠቁም ዕድል የገንዘብ የራሱን
ተገድበው : መኰንንና ራሱን በማድረጉም በሚገኝ በ#
የሆኑትንና : ሕንፃዎች አፍሪካን ጊኒ የነበረችውን የራሱን
ያልሆኑትን : በስመ ፍለጋ የፔንሲልቫኒያ ማተሚያ #ኛ
የሚያጣሩበት : ሕይወቱ ቪዛው አገሮች የራሱን ለእናቱ
ወንፊት : ዩኒቨርሲቲም እዚህ የገንዘብ የነበረችውን ቤት
የሚመስለው : ስለታሪካዊው አካሄድ የነበረችውን የራሱን በሚገኝ
ያልተረጋገጠው : መሬት ብር ላይቤሪያና አባል አሜሪካ
ብዛቱ : አጋጠመው ጠየቀ ተቀጠረ ስለነበረም #ኛ
ጉዟችን : ሰዓት ሁኔታ ተብሎ ማሊ ወጣ
ተጀምሯል : የሚያጣሩበት ንፅፅር ከ# ተመሳሳይ አገሮች
ከሾፌሩ : የራስህ በተካነበት ሚና መንግሥትን በ#
ጀርባ : ተሳፋሪውን ተምመው እጥረት በላይ የእንግሊዝ
እናትና : ተጠቅመው ለመፍጠር ሆነ ጋዜጣ በማተሚያ
ጎረምሳ : ቀልቡን ቅንጡዎች ለመገንባት ያገናዘበ በመምራት
ልጃቸው : ለውጥ ያልተለመደም ነበር ልጅ #ኛ
አሉ : ሥራ ወጣ ማጥናት ፊላደልፊያ #ኛ
ዕድሜ : ያህል ጠየቀ ማተሚያ ስለነበረም ነበር
ምን : እንፈጥራለን መሆኑንና ባለፈው ፌስቡክ ፈረንሳይ
አለኝ : ለየው አስታወቀ ገልጿል ገቡ ተቀጠረ
ያውስ : በሉ እነዚህ በእነዚያ ግለሰቡ ከውጭ
ውጥንቅጡ : ተሳፋሪዎች ዝግጅት ሥራ ባነበበው ሮዚም
በወጣ : የምናየውና የፀና በወረረበት ዜና ቢታወቅም
ባህር : ወትሮው ተልዕኮውም ኮሌጅ ለአባቱና
ማዕበል : እንቀበላለን ሸምድዶ በወረርሽኙ እንደዘገበው ለማዋል
ባነፈሰው : ተሳፋሪውን ባለብርሃን በቀድሞ ክፉኛ በላይ
አቅጣጫ : አለበለዚያማ ጋዜት በሚገኝ ፊላደልፊያ ለእናቱ
እየተወራጨ : መጽሔትም ብር ቪክተር እንደማይችል የሆነ
እያየሁ : ተሸላሚ እንደበዛ ተመልካች በ# *
እሠራለሁ : ይገርማል ግንቦት አጠያየቁ የሚያደርገው ጠየቀ
አንተ : በቡዳፔስትና ይኼው ጉዞአቸውን በአካል ቀጥሎም
አለህ : እሰጣ የፕሮግራም ፊላደልፊያ ለእናቱ ለአባቱና
ትምህርትህን : ከ#ዎቹ ቢልዮን የኢቦላ አባቱ #ኛ
ጨርሰህ : አሜን ሆነን አሠርታት ለብሰው እንደጠየቀው
ስትሆን : ስለመያዝ ጊዜ የመሆን ፊላደልፊያ አባቱ
አይሃለሁ : በእንግሊዝ ለዮርዳኖሳዊው ሊፈጠር ለመሳተፍ ትገዛ
እያልኩ : ዓይኑን እንኳንም ተኮሳተረ ጂቡቲ ብሔራዊ
እንጂ : ሥራ በታች የነበሩት አብረውት የምታውቁ
ከእንግዲህ : ያሉበት ደግሞ ቤንጃሚን ወዲያውኑም ለአባቱና
የነፍሴ : አስበን የሚፈቀድላቸው ቅኝ አባል ሮያል
አልነበረም : ለመፍታት አሜሪካን ፊላደልፊያ ድሃ ልጅ
ሊያሳስበኝ : መሆኑንም ያገናዘበ መሻሻልን ኒልን ታላላቅ
የሚገባው : ይጥፋ አመልክተዋል ችሏል ጠየቀ ተቀጠረ
ሲነግሩህ : መመርያውን ይህንን የአገጣጠም ቆይታቸውን ከፊልም
ስማ : በበኩላቸው ውጭ ሊያገኝ የእንግሊዝ አሜሪካን
አታቃጥለኝ : በሌሎች ለአምስት ነው ያገኛል ተረዳ
ይሉታል : ክህነቱ አሁንም ወር ምርምር እራሱ
ጉርምስና : በአኳኋኑ መድበል የሴት መልዕክት መሣሪያ
ዓይነ : ኢትዮጵያውያን ኦስተን አገሮች እንደነበረ ለእናቱ
ልቦናውን : እንባ አውድማ እንዳሉት ስብሰባ ሁለቱ
ያጨለመበት : በመምራት አበርክቶው ሊሸጥ መስኩ ፍራንክሊን
ታዳጊ : አስተዋጽኦ በአንድ ስለነበረ እራሱ ለ#
በንቀት : በሊዝ ሊታይ በመሆኑ የሚባል የሚችሉትን
ያያል : ብዙኃን ኦስተን የገንዘብ ለእናቱ ለአባቱና
ከእነሱ : ፖሊስ ሶሳይቲ ገንዘብ የነበረችውን አሜሪካን
አጠገቤ : ተግባር እዚህ ትምህርት ፔንሲልቫኒያ የሚፈልገውን
የተቀመጠ : መጀመሩን ኳስ አቀፍ በጅምር ፍራንክሊን
ጎልማሳ : ቴክኖሎጂ ነባራዊ አገሮች ዩኒቨርሲቲ ለ#
ልብ : ያፅናኑታል ጥንታዊ የትግራይ ባለው ተሾመ
አመሻሽ : በራዲዮ በሁለቱም የሆነ ፊላደልፊያ ለአባቱና
እየታደለ : ካልተገፋፉ ዳንኪ ያደርጉባቸዋል ፍለጋዬ ላይም
እኮ : ይኼን የሚገቡም አጠያየቁ ትገዛ *
ስንቱ : ሁሉን ለቆ ተቸግሮ ቪዛው ዕድል
ቀረ : መለያ ራዲዮና ለቆ የራሱን ለእናቱ
ይለኛል : ዕድገቱን በሁለቱም ሚና እየተሳካ ዓላማውን
በዕድሜ : የኪራይ እንዳልሆነ ግለሰቦች ከ# ፌቴክ
አስታኮ : ይገኛል ገልጸዋል መተዋወቅ ወደ ተቀጥሮ
የመግባት : # ድሃ * ነበር ለእናቱ
ሙከራውን : በስመ የሻረ ብሎም በ# *
በዝምታ : ወንድ በመመለስ ዓመቱ ድሃ ለእናቱ
አከሽፍበታለሁ : እስኪያልቁ ተጠቅመው ፔንሲልቫኒያ የገንዘብ ፊላደልፊያ
ሴትዮዋ : ኮምፓራቲቭ በፊት መሻሻልን ጋዜት ድሃ
ሲሉ : ራቅነው ጥያቄያቸው እጥረት የሚፈልገውን የገንዘብ
ጆሯቸው : የሚያደርጋቸውን ነገሮች የሚፈልገውን ቤት አባቱ
የቆመ : የደሃና ሮጦ ተነጥቆ እግዚአብሔርና ሥርጭት
የተሰየሙ : የምዕራባውያን መጠን ሰላም በመመለስ ወራት
ስለታሪካዊው : ይመራ አፍሪካን የነበረችውን አሜሪካን የራሱን
የእቴጌ : ሲከታተል ተፈጻሚነቱም ቤት ድሃ #ኛ
ጣይቱ : ባለ አማራ ባለው ነገር ድሃ
ሆቴል : አፍሪካን ሲጠጋው የራሱን በ# ስለነበረም
ቃጠሎ : ጋራዦቹ አጠገብ ወረርሽኙ የሚፈልገውን ቤት
መጫወት : ሚና የሆነ ነበር ልጅ ለአባቱና
ጀምረዋል : በሊዝ ስለነበረ የራሱን ለእናቱ ለአባቱና
አንደኛው : ለደካማ አካል ዕድል እንደማይችል ነገር
እቴጌይቱ : ወር ወደ ያኔ የራሱን ድሃ
በቁማቸው : ዕጣ ሹመቱ ለኢትዮጵያውያን መስኩ ፍራንክሊን
ተቃጥለው : ከቁም መመርያ የሚያደርገው ተቀጥሮ *
ሞቱ : ከሚያዘጋጀው ወዳጆች የነበረችውን ስለፈለገ አንድ
እንዲችው : በቪዲዮ ለመፍጠር ተቀጥሮ ለ# ግን
ልባቸው : ውጪ የፕሮግራም ሥልቱ ያጠናከረው ወጣ
እየሩሳሌምን : ትንኝ እስኪያልቁ ዕውቀትና የኢትዮጵያን ወዳጆች
እንደተመኘ : ያማርራል እንደነበረ ፍራንክሊን ዩኒቨርሲቲ ተቀባይነትና
ለሥልጣን : ሊያርፍ የተወለደው መቀየሪያ የአወሮፓውያኑ #
በተሻኮቱ : ማድረጉ የአወሮፓውያኑ ኢኮኖሚያቸው እንደጠየቀው ዩኒቨርሲቲ
ሴራ : አሁን መተዋወቅ በኋላም ወራት ለማድረስም
በቁም : አዘጋጅም ለአባቱና
እስር : አዳራሽ ከተመረቀ መሥራት ዓላማውን የሚፈልገውን
እንዳልተንገላቱ : በቀደመው ጊዜ እንደሚያደርስ ነገሮች ግንባር
በስማቸው : ቃጠሎ ጊዜ በሚኖረው ፊላደልፊያ ዓመቱ
የሚጠራው : የኢትዮጵያን ውስጥ ዓመቱም መሥራት ዓላማውን
የአገራችን : ካፍ ሮያል አሜሪካ እንደማይችል የራሱን
የመጀመሪያው : መፀዳጃ ጋዜጣ በማተሚያ ማተሚያ ስለነበረም
ተቃጠለ : ክብርና ሸርት ተቀጥሮ በ# ነበር
መቼስ : ብርሃኑ መሥራት አንድ ድሃ ነበር
እሳትና : እኔና ለእናቱ ለአባቱና
ሞት : ተመልሶ ፍርድ የፍራፍሬ የፔንሲልቫኒያ ዋና
ማስጠንቀቂያ : በኋላ ሶሳይቲ ዛሬ ስለነበረም ነበር
መቼ : መሆኑ ልጆችም ጭማሪ ፍላጎት ጸሐፊዎችና
ያውቃሉ : ደርሷል ቀርተውበታል ጠየቀ ተቀጠረ በ#
ያደረጋል : ገቡ ተቀጠረ ለእናቱ ለአባቱና
ከጎኑ : አግባብ ማስተካከያ የጻፋቸውና አሜሪካ የሆነ
የተሰየመች : ኳስን ጥናቶችንና # ቀደም ሊያገኝ
ቀዘባ : አዛውንቷ በስመ የነበረው ብሎም ከእንግሊዝ
ተቀብላ : ነፍሱ እንዳለፈ ፍለጋዬ ይጫወት እየተሳካ
መብራትና : ጸሐፊ ባለፈው አንድ ድሃ ለእናቱ
ውኃስ : ጠበንጃ ለኢትዮጵያ ሁነኛ ወራት ዓመቱ
ሲጠፉ : አለኝ በኋላም ለማድረስም የእንግሊዝ ስለነበረም
ያሳውቃሉ : ይገርማል እሠራለሁ ግንቦት ይጠየቃል አሳትሟል
ትለዋለች : እነሆ ተሾመ ለአባቱና
ተቻኩላ : ልንጓዝ የመምረጥም በስደት አሠራር በመመለስ
የሚገርመኝ : ተሰብስቦ አገር ጋር ታላላቅ ፔንሲልቫኒያ
ሌላው : የት ገዛና ገንዘብ የነበረችውን አባቱ
ታሪካዊ : ሠልጥኗል ወጥታ ይደርሳል ከቫይረሱ በማተሚያ
ቅርስ : እንደሚያሳየው ጽሑፍና የምንዛሪ ለብሰው በመመለስ
በእሳት : በኩል ዕቃ ወረርሽኙ ለመፍጠር በሁለቱም
መውደም : እንፈጥራለን ነጋዴዎቹ ፌዴሬሽኖች ጠቅሶ የ#
ሳያንስ : ተሞጋግሰው ሰሎሞን ብሔራዊ በወረርሽኙ ጥሩ
በጭፍን : ፍልስፍና ኢትዮጵያዊ መስኩ በ# #ኛ
ጥላቻና : እርስ ሲከፍት በሳይንስ ዩኒቨርሲቲ የገንዘብ
አሉባልታ : የአብሮነታቸውን በመግለጽ #ኛ ለእናቱ ለአባቱና
ተመሥርተው : ያሉባቸው ስለኤሌክትሪክ የነበረችውን የሆነ የራሱን
የሚያጫርስ : ያውጣላችሁ የት መሬት አሜሪካ #ኛ
ሰደድ : መፀዳጃ ለመቆናጠጥ ትምህርት ለ# ያኔ
እሳት : ስብስቦችን የሆነ በ# ነበር #ኛ
የሚጭሩት : ልንጓዝ ኩራት ጠቅላይ ጅምር በተጨማሪ
አይገርማችሁም : ሠርተዋል ኖሮ ሠርቷል ይችላል አገናኛቸው
እጁን : ሌሎቻችን ኩማና ለማስገባት የሚችለው ሚና
አፉ : ፍጥነት የማንነት ዕፅ አጋጠመው ገንዘብ
ይጭናል : መሥርቶ ትንሽ ስለኤሌክትሪክ ማሳተም የሆነ
የነገር : አንዲት በማተሚያ ስለነበረም አባቱ ልጅ
የማድራት : ተቃጠለ ክብርና ምዘናው የኢትዮጵያውያን እየተሳካ
ክህሎት : ናቸው ጭማሪ ዋና የሆነ *
እውርን : ቤትንም ኩራት ላይም በኋላም ተረዳ
ባለብርሃን : ትስከር ባነፈሰው ዜግነቱ ክፉኛ ጠቅሶ
ከሚያደርግ : ተያያዥ ምናልባት በራሱ ሳቢያ ተቀባይነትና
አስደናቂ : ያለው ያገኙት ቅኝ መንግሥትን *
ተዓምር : አንዳንድ አካልም ይዞ ኦስተን ከማል
እኩል : ይጫወት በኋላም መሥራት ድሃ ለእናቱ
ያፈዘኛል : ተይ ካላችሁ ቀናት በላይ ጋር
በአኳኋኑ : ጉርምስና አዘጋጅነት በራፍ አስፈላጊውን ያልተለመደም
ይኼ : አገሪቱ የላቸውም ጥቅሶቻቸው ሄዷል ያኔ
ይገርማል : እሠራለሁ ይታወቃል አስታወቀ አሰሱ አጠያየቁ
ዘመኑ : ዕውቁ በሴት የእውነቴን የ# ወዲያውኑም
እንደሆነ : ያልፈጠርነውን በካይሮ የጋዜጠኝነት ጠቅሶ ወትሮው
የአጥፍቶ : ቀን ቢታወቅም ነገር የራሱን ለአባቱና
ጠፊዎችና : መምህር የሚወዳቸውን ቲ የሚያውቅ በ#
አሸባሪዎች : ሲከፍት በሳይንስ ያኔ ለእናቱ ለአባቱና
እንዳለመታደል : አል ጽሑፋዊና ገንዘቡን ተጓዦች አብረውት
ሆነና : አጉል ሲጣጣሩ ታላላቅ ፔንሲልቫኒያ የገንዘብ
ሥልጣኔን : እንደሚደረስና በካሊፎርኒያ በአሁኑ ከፊልም ዛሬ
ደረስኩብሽ : የካርዲናልነት ለሴፕ በጋራ ጠቅላይ ለአምስት
ሲላት : ሹመቱ መስኩ ዩኒቨርሲቲ የገንዘብ ድሃ
ገልቱነት : ያድናችሁ በእነዚህ ኤጀንሲ ገልጸዋል ተቀጥሮ
ተመልሶ : ሞት አኅጉሮች መለያ የውጭ ፍለጋ
አልቅሶ : ያውጣችሁ በራፍ ሲሆን ሊያገኝ የነበረችውን
ይወለዳል : በተጨማሪም ፊላደልፊያ * ልጅ #ኛ
የእኛ : በተለይ ዶላር ሊሸጥ እንዳለበትም የሆነ
ድርሻ : አንቺ ከገባ የውጭ ያልተለመደም አብዮታውያንን
ውኃ : በፈረንሣይኛ ቦታ መስኩ የራሱን ለእናቱ
ትላለች : ዛሬ ለ# የነበረችውን በ# ነበር
ሦስተኛው : አያቶቻችን ለማቋቋም ተቀጠረ ፊላደልፊያ ለእናቱ
የተቀመጠች : ይናገራል ጎረቤት ፖሊሶች ገንዘብ የሆነ
ወይዘሮ : ሰጥቶ ኦርቶዶክስና መያዝ መሣሪያ መንግሥትን
አንዴ : የአጫጭር ተቀባይነትና እግቡ ድሃ #ኛ
እስኪ : ከዩኒቨርሲቲ * ነበር ልጅ ለአባቱና
የአቶ : የአባትህን እያገኙ እንዳይጨምር ዕድገት አዘጋጅም
ሚካኤልን : እንዳለፈ ያገኙት ይጫወት ላይም ድሃ
በቃሉ : ሲገኙ በስመ አብሮ የነበረው ወንጀለኛ
ሸምድዶ : በወረርሽኙ ጥሩ እንደ ዓመቱ ለአባቱና
ለክፍል : የወጣው ማንኛውም የነበረችውን በሚገኝ ዓመቱ
ጓደኞቹ : እላፊ በትችት ባነበበው አዘጋጅም ነገር
የተወጣ : የተቀመጡ በአንድ ልጅ ለአባቱና
ያውጣ : ተማረከ አጋጠመው ለማድረስም ያህል ጠየቀ
ሒሳብ : አደጋ ካፍ እንዳልሆነ ሮያል እንደማይችል
ሳይስበው : ብር መደብር አሜሪካ ነገር አሜሪካን
ተኮሳተረ : እንኳንም ገንዘብ አሜሪካን የራሱን #ኛ
እናዓይኔን : እየረቀፁ ቫን ታላላቅ ፊላደልፊያ ድሃ
ልታወጣው : መምህርም የተወለዱት ወንድሞችህን አይፈቅድም ዜና
እናንተና : በእነዚሁ ማይል በአካል አሜሪካ ወዲያውኑም
ደርሳችሁ : የታሪክ መስኩ የገንዘብ የነበረችውን ድሃ
ሳንገብርና : መሳይ በሊዝ ኪሳራ ወዲያውኑም በ#
ሳይርበን : ተደራጅተው መሆን ለኢትዮጵያውያን ታይቶባቸው ሊሆን
የምንኖር : ለማምጣት የኬፕቨርዴው አካባቢ እግር ከአንድ
ታስመስሉታላችሁ : ምክንያት ማጠናቀቁ እግር የውጭ ማሊ
በልጃቸው : የመሩት ተገቢነት በሁለቱም ሚና እየተሳካ
የበገኑት : ሻይ ሸር የአወሮፓውያኑ ያለፈ ያገኙት
እናት : ሳልሞት ከእንግሊዝ ዩኒቨርሲቲ በ# *
አንባረቁበት : ከባንኮች የመሆን ፊላደልፊያ ለእናቱ ለአባቱና
ደንግጦ : በኢኮኖሚው ፖሊስ የነበረችውን #ኛ ለእናቱ
ተንደረደረ : ታክሲያችን የተጠየቀው ተመን የመሆን የእንግሊዝ
እዚያ : ብንጀመርም በመገናኘት አሁንም ጋዜት የገንዘብ
ስልክ : አለመመዘኑ ሁለቱ የምታውቁ ታላላቅ ቀደም
እያናገረ : ጳጳሳት እዚህ ጓደኛው የገንዘብ ትገዛ
ጠብቅ : ሰውነቱ ይፋ ተብሎ ዕፅ ሮያል
ይሰጥሃል : ገዛና በ# ነበር #ኛ ለአባቱና
ይለዋል : ኅትመቶች ቆይታ መሆናቸውን ይዘዋወር አካባቢዎች
በምልክት : አጋጠመው ለማድረስም ገንዘብ ጠየቀ ስለነበረም
ሁሌ : ዕውቀትና እንደጠየቀው ፍለጋ መስኩ እግቡ
ስደውልልህ : ከዚህ ይደርሳል አዘዋዋሪዎቹም በማተሚያ ተቀጠረ
ትለኛለህ : አማራ አዘጋጅም ወደ በኋላም ድሃ
ብቻውን : የብቃት ሃይማኖቶች ሥፍራ የእንግሊዝ ተቀጠረ
ሮጦ : ስብጥሩም ተነጥቆ መስኩ ተቀባይነትና ቤት
የሚሸለም : እንቢ ልጅ ለአባቱና
አትሌት : አስፈላጊውን ሲወጣ በኢኮኖሚው አካሄድ ፖሊስ
ያየህ : ማኔጅመንት በሰው በበኩላቸው የእንግሊዝ ቤት
ይመስል : ፖሊስ ስለኤሌክትሪክ ገንዘብ የነበረችውን አሜሪካን
የት : ሌላው ቦንጋ በራፍ የጻፋቸውና ገዛና
ለመድረስ : ግዴታ ከጊምቢ ልጅነት አገላለጹ አያቶቼ
በስልክ : ቆመች በእምነት ዕውቁ በሴት የ#
የሚነጋገረው : ያየ ያጋለጠው ሰላም በመመለስ ወራት
ተሳፋሪ : በፈረንሣይኛ ሞዛይክነት ማሪዋና ሆኖም ሮያል
ኤድያ : በ# * ነበር ለአባቱና
ተወኝ : ከተማ ዜና ያገኙት ሰዎች መንግሥትን
እባክህ : የሚጭሩት ጠቅላይ አገሮች በመመለስ ለ#
እኛን : ልቦና መሆን ነገር ድሃ ለአባቱና
የሰለቸን : ከቀረን ኒል የፌስ በኋላም ልጅ
ባለቤቱን : ሞት ሙሽራ ለውጥ ፍለጋ የፔንሲልቫኒያ
ሌላውን : ወጣ ጥረት የሆነ ፊላደልፊያ ድሃ
የማያካትት : ቀልቡን ሙሽራ ተከትሎ ለዮርዳኖሳዊው በመምራት
ሁላችን : እቴጌይቱ በተጨማሪ ወደ በኋላም አሜሪካን
ዘርተን : አንዴ ደረጃ እንደጠየቀው ተቀባይነትና እግቡ
ጥቂቶች : ከአባቱ የመንግሥት ነባራዊ መመርያ ሆነናል
ካጨዱና : ቢከፈት ጉዳዮችን በካሜራቸው በሁለቱም ነገሮች
የበይ : የሀብታም የፀና ከተማ አይፈቀድለትም ዜና
ተመልካች : ኤድያ ሲወቀሱ ተጉዘው በ# ነበር
ሆነን : አሜን ድካም እንዳለበትም ዩኒቨርሲቲ ተቀባይነትና
ከቀረን : የሰለቸን እንዳለመታደል ጽሑፋዊና ገንዘቡን በተጨማሪም
ዋጋ : እያሽከረከረ የምለው ያለፋቸው ጥበባዊ ዓ.ም.
አለው : አጋጠመው ሶሳይቲ ገንዘብ ጠየቀ ልጅ
ያለረፍት : የእነሱን ዳንኪ ለአንድ አዘጋጅም ነገር
ከሌት : ከማለቃቸው ወራት ዓመቱ ድሃ ለአባቱና
መልፋቱ : ያደረጋል አለኝ ገቡ ፈጽሞ ጠየቀ
አንዳንድ : ግቡ ተዓምር በዙሪክ ያለ በአንድ
ማለት : ፕሬዚዳንትነትን ሞልቶ አባል በሚገኝ ለአባቱና
ልመድና : በአጠቃላይ በራዲዮ ለጥያቄ በሁለቱም ሚና
ሻይ : የበገኑት የፀና ብዙኃን የተወለደው ያገኙት
ቡና : ጓደኞች ነበር ልጅ ለአባቱና
እንበል : ከእነዚህ የምናውቀው በኋላም ተቀጥሮ ተቀጠረ
ወዳጁን : ቢሸጡ ናይጄሪያና የ# ስለፈለገ የሆነ
ይመክራል : ብሔራዊ ወጣ ሰው የሆነውን ወዲያውኑም
ሲያሳንፈው : መለያ አፍሪካን አካሄድ መሣሪያ የራሱን
ይሁን : አይደል አጉኖታል ሳምንት ሰው በአሜሪካ
ሲያሳርፈው : የጉልት ርዝማኔ ተመሳሳይ አሜሪካን የሆነ
ይወቀው : ራስን ብርም እገዛ ያለ አብዮታውያንን
ሌሎቻችን : እጁን የፍራፍሬ ኩማና አጋማሽ የሴት
ለወያላው : ይመስለኛል መመርያ የሚያደርገው በኋላም ስለነበረም
ሰጥተን : ለአገሪቱ በመቆጣጠር ዶላር ሸርት የሚያደርገው
መልስ : ድካም እንደነበረ የሥራው ጀመረ ማተሚያ
እንቀበላለን : እያሉ ማዕበል አጋጣሚም ኢትዮጵያ እንደዘገበው
አፍታ : በሚገኙ የአጫጭር እንደሚያደርስ እግቡ ፊላደልፊያ
ሳይቆይ : ለእውነት እየታዩ ፍለጋዬ ከተባለ ቫን
ሰላማዊ : ሰጥቶ ብርም ማንኛውም መሣሪያ የነበረችውን
ያንዣበበት : ይደርሳል መተዋወቅ አጋጠመው ሶሳይቲ ስለነበረም
መሰለ : ቫይረስ ኮሌጅ በ# * ለእናቱ
ፍጥነት : ማስገቢያ የማንነት ይፈቀድላቸዋል መጽሐፍ በመወከል
የነበረን : የባችለር የሚሆን ብር ጎረቤት ገንዘብ
እጅግ : የውጭ የሚጠቁም አብዮታውያንን ሊያገኝ ለእናቱ
ዘመናዊ : ምንዛሪውን ምንዛሪ እንደማይችል የገንዘብ የሆነ
ሬንጅ : ለ ታውቋል ሥልጠናዎችን መጠኑን ሰላም
ሮቨር : ተቃዋሚዎች ያሉበትን ተማሪ ይጫወት ድሃ
መኪናን : ገልጸዋል ከ#ዎቹ የሚያደርገው ተቀጥሮ ግን
ስትሸሽ : ጥበብ ስታስበው ዜግነቱ የሚወጡ በፌስቡክ
እግረኛ : አጠገብ ፔንሲልቫኒያ መሥራት ዓላማውን የሚፈልገውን
ወጥታ : ይደርሳል ቲሸርት ሶሳይቲ ጋዜጣ በማተሚያ
ቆመች : በስልክ በእምነት ማኅበራዊ መሥርቶ ዕውቁ
የአውቶሞቢሉ : ያፅናኑታል ክብርና ነፃ ለብሰው ተሾመ
አሽከርካሪ : በአንድ ስለነበረ * ልጅ ለአባቱና
ትንኝ : እየሩሳሌምን ተምመው በሌሎችም የኢትዮጵያን ወዳጆች
ባይኑ : ብርሃነየሱስ ሊቀ እንዳይጨምር አሁንም ጥረት
የገባች : ቴክኖሎጂ አገሮች እንደነበረ ለእናቱ ለአባቱና
እንኳ : መሆናቸው ጊኒ አካሄድ ትንሽ የገንዘብ
ሳይመስለው : ከቦሌ ማዕከልና የምታውቁ ሮዚም ነገር
ሞባይሉን : አካሄድ መልዕክት ዕድል ሊያገኝ ዕርዳታ
ጆሮው : ትዕይንቱ የማንነት እስልምና ይኼን ሰው
ጣደ : ዓመታት ከቀሰመው ጥናቶችንና የሚፈቀድላቸው ሊሸጥ
ገላምጦን : በዳያስፖራ አጃንስ ቤልጄማዊው ለአባቱና
ተፈተለከ : እስከ ቢታወቅም ተነባቢነት ዋና በ#
የእኔ : ሁለንተናዊ በኋላም አሜሪካን ያኔ ስለነበረም
የማኅበራችን : አንድ ድሃ ነበር ለአባቱና
ታክሲዎች : የኬፕቨርዴው እንዲሁ ከሦስት ከተላቀቀች አብዮታውያንን
ቢሸጡ : በካሜራቸው በሁለቱም ሚና የሆነ ቤት
የማላሠራለትን : ከሽብር የምሩ የምንዛሪ ለብሰው በፖለቲካዊ
እያሽከረከረ : እንዳለፈ እየረቀፁ ይጫወት ላይም ዩኒቨርሲቲ
ከእኔ : ፌስቡክ ቀጥሎም ከጊዜ ማተሚያ #ኛ
ይጋፋል : ትወለዳለህ አይደለም አድርጓል ከተላቀቀች አቋቋመ
ፍረዱኝ : ዓመቱም ዓላማውን የሚፈልገውን የነበረችውን የራሱን
ይለን : የብላተር ለመምራት የማተሚያ ያኔ የሆነ
ጀመር : የኪራይ የውጭ ላይቤሪያና ከ# ፍለጋ
አዛውንቷ : ቀዘባ ምዘናው መንግሥትን * ነበር
ኧረ : እንደሚሰጥ ሥፍራ ከመደብር ውስጥ መሥራት
እሱ : አሰሱ ገቡ ጠየቀ ተቀጠረ ለእናቱ
አተረፈህ : አብረውት የመሆን ፊላደልፊያ #ኛ ለእናቱ
አለበለዚያማ : አቅጣጫ ሌሰላው ፊላደልፊያ #ኛ ለአባቱና
ሲያገኝ : ውስጥና የሚቀርቡ የምታውቁ በፌስቡክ መሣሪያ
ዓይኑ : ከኢጣሊያ አኅጉሮች በሌሎችም ራዲዮና ለቆ
ከሚገለጠው : አቡነ ስብሰባ ጎረቤት ሊያገኝ አሜሪካን
የሚጨልመው : ካፍ ሴራሊዮን ቅኝ መሣሪያ የሆነ
እንደበዛ : ተመልካች እያየሁ ሲወቀሱ በ# ነበር
እናውቃለን : ከሮም መቀየሪያ ቢታወቅም ተረጋገጠለት *
ልቦና : እኛን የአባትህን ነገር ድሃ ለአባቱና
ይስጠን : አትበሉ ኦል ቀጥሎም ከጊዜ ትገዛ
ያፅናኑታል : ነፍሱ የአውቶሞቢሉ ጥንታዊ ሳቢያ ይጫወት
ትከሻ : በ# * ነበር ልጅ ለእናቱ
ለትከሻ : መጠኑን ተነባቢነት ወራት ዓመቱ ድሃ
ካልተገፋፉ : የሆኑት ፍለጋዬ ያገኙት ዞሩ ላይም
መሆንና : የመመረጥ በፕሬዚዳንትነት እፎይ ተቀጥሮ በማተሚያ
ሠርቶ : የልጅ ልምዱን እግዚአብሔርና በሙሉ ጓደኛው
ማደር : ቅድመ ጸሐፊዎችና መሥራት አንድ ድሃ
ጡረታቸው : በረባ የኢትዮጵያውያን ዶላር በኋላ ተጉዘው
መከበሩ : አጋጣሚም ጥሩ ዓመቱ ድሃ ለአባቱና
ተሳፋሪውን : ባነፈሰው ስታስበው ሲል በላይ በፌስቡክ
እያበሳጨው : ጽሑፍ እንቅስቃሴም ስለፈለገ የሆነ በሚገኝ
ተንቀሳቀሰች : ጠባብ ኦርቶዶክስና የሚገቡም ኢኮኖሚያቸው ተረጋገጠለት
ጎዳናውስ : ፈረንሳይ ነገር ስለፈለገ አንድ ፊላደልፊያ
ገና : መሆኑንና ጠቅሶ ኮሌጅ የሆነ ፊላደልፊያ
ሳያስተዛዝበን : የካፍና ወረርሽኙ እንደሚያደርስ ባንክን ፊላደልፊያ
አይቀርም : መለያ እስልምና ተቸግሮ ማሳወቅና ኪሳራ
ከመጀመሩ : ገንዘብ የነበረችውን የራሱን #ኛ ለእናቱ
ወዲያው : በተጨማሪም ተብሎ አሜሪካዊ እራሱ ፊላደልፊያ
ጥጓን : ታክሲና የሚፈቀድላቸው መስኩ መሣሪያ ተረጋገጠለት
ይዛ : ምንዛሪውን የነበረችውን የሆነ ነበር #ኛ
ወያላውና : ሲያነበንብ ሰሎሞን ከሳምንታት ወይም ሰላም
በዓይን : ያለማዳመጥ ብላተርና አቅርቦታል ትምህርት ከተባለ
ተያይተው : በአክሲዮን ጋራዦቹ አጠገብ ዓ.ም. በማድረጉም
የቆምንበትን : በየቀለበት እጁን እንደሚችሉ ሴራሊዮን መንግሥትን
አውቀዋል : ፖሊሲ የገንዘብ የራሱን ለእናቱ ለአባቱና
ጋቢና : ከሆነና የ# ድጋፍ ፈረንሳይ ዓመቱም
የተቀመጡ : በከፍተኛ በአንድ ልጅ ለአባቱና
ሴትና : በእጃቸው አገናኙን የፔንሲልቫኒያ ገዛና መሣሪያ
ወንድ : ለኢትዮጵያ ለማዋል ጥሩ ዓመቱ *
ምንድነው : ሲከፍት በሳይንስ እንደሚኖርበት አንድ ድሃ
እያሉ : እንቀበላለን ኢትዮጵያ ከሳምንታት አጃንስ የዓለም
ሾፌሩን : ከሚገለጠው ወጣ እንዳይገቡ አሜሪካን ፊላደልፊያ
በጥያቄ : ከተለያዩ ቫሉታ በአሜሪካ እንቅስቃሴም ዩኒቨርሲቲ
ሲያዋክቡት : ያሉባቸው የሚያደርጋቸውን አስፈላጊውን አካል ፈቃድ
ራዲያተሩ : ፍርድ ትስስር ተነጥቆ ዋና በ#
ስለተቀደደ : የሻረ ኦስተን አድርጓል ጀመረ ለ#
ያፈሳል : ስለሆነ መሬት ነጋዴዎች የጀመረው ሲሆን
እናስቸግራችሁ : የወርልድ ቅድመ በመኖር አንድ ድሃ
ውረዱ : ክህነትን ተደርጓል ለአምስት ሆኖ ወደ
ያግባባቸዋል : ይገኛል እንደሚያሳየው መናገሩም ሕጋዊ የሚገመተውን
ትዕይንቱን : ነፍሱ አላልኩም ሆነን የሚወዳደሩ ፊሎሶፊና
በአትኩሮት : የፀና መጨረሻው ቴክኖሎጂ በአንድ የሚጠቁም
እንከታተላለን : የተጣጣፈ ሥራዎች ቫን ዩኒቨርሲቲ ትገዛ
ከመቅጽበት : በተጨማሪም ግለሰብ አሜሪካዊ ትገዛ ፊላደልፊያ
እንዳዩት : ከተለመደው ተነባቢነት ገንዘብ አሜሪካን *
ፅኑ : ለኢትዮጵያውያን ሴራሊዮን ቅኝ ምርምር ፍራንክሊን
ጠጪነቱን : በሳይንስ ከፍተኛ ለ# ያኔ በሚገኝ
መመስከር : ሠርግ ፍልስፍና ሞዛይክነት መስኩ ስለነበረ
የሚችሉለት : በመምራት ሊሸጥ ዩኒቨርሲቲ ተቀባይነትና ነገር
ምርቃትና : ፊላደልፊያ * ልጅ ለአባቱና
እርግማኑን : ፋሺስት ማሳወቅና ጠቅሶ በመወከል ነፃነት
እያዥጎደጎደ : በኦሬንታል እና ቢታወቅም የሥራው መንግሥትን
በተከፈተ : አምላክ እራሱ ወደ የማተሚያ ያኔ
መስኮት : ጥንቃቄ ከኢትዮጵያ በአሜሪካ የመሆን ትገዛ
አንገቱን : ሁለተኛ እስኪያልቁ ለፊፋ ተጠቅመው ክፉኛ
አስገባ : ዕጣ በፈረንሣይኛ ቦታ ቪዛው መስኩ
ወዮላችሁ : ተብሎ ማሪዋና እራሱ ጋዜት የገንዘብ
ግቡ : አንዳንድ ያለ በአንድ ሶሳይቲ የጋዜጣው
አንገት : ተድላ ችግሮች ቆይቶ ድረስ የኢትዮጵያ
ማስገቢያ : ፍጥነት ብርና ቪክተርና በመወከል #ኛ
ካጣችሁም : ሲሆኑ ስለኤሌክትሪክ ዛሬ ለ# ገንዘብ
ሱባዔ : ድር ምክንያቱ ይዣለሁ ቀደም ግንባር
እንቢ : ልጅ ለእናቱ ለአባቱና
ካላችሁ : ያፈዘኛል በላይ የእንግሊዝ ተቀጠረ #ኛ
ጉድጓድ : የሺመቤት እንደሚያደርስ ቅኝ ግንባር አዘጋጅም
ፀሐይን : ቀልቡን ባነበበው ሮዚም ነገር አባቱ
ያወጣ : የሚወዳቸውን ቲ ሄዷል የሥራው የሚል
አምላክ : በተከፈተ መጨረሻ ከ# እራሱ ወደ
ለእናንተ : ዜግነቱ ትገዛ ፊላደልፊያ ለአባቱና
የኮንዶሚኒየም : ፋሺስት ግለሰብ እኔና ለእናቱ ለአባቱና
ዕጣ : ጭምር ቦታ ኃላፊ እንደሚችሉ እንደማይችል
ያውጣላችሁ : የሚያጫርስ መንገዱን ጉዳዮችን ከፍ ነገሮች
ሙዱ : ዜና በጅምር እራሱ * ልጅ
ካልተሰረቀም : በመሆኑ የነበረችውን የሆነ ወዲያውኑም በ#
ያውጣችሁ : ሳይስበው አልቅሶ መሬት ብር መደብር
እንደዚህ : ወይም ባንክን ኒል አዘጋጅም በኋላም
ታክሲና : አስበን አገሮችና በሙስና ዝግጅት የሚፈቀድላቸው
ተቃዋሚዎች : ሳለ የዕርዳታ ወደ ድሃ ለአባቱና
ተራምዶ : ጽሑፋዊና አዲስ በፖለቲካዊ በኋላም ተቀጥሮ
ከመቆም : አጠራር ለመሳተፍ ማንኛውም ፍላጎት መሥራት
ይሰውራችሁ : አሜሪካዊ የመሆን ፊላደልፊያ #ኛ ለእናቱ
ዞሮ : ባወጣው እጅ በማድረጉም የሚፈልገውን በሚገኝ
በዳያስፖራ : ገላምጦን ፌቴክ ለአባቱና
ስናሾፍ : የካቶሊክ ብሎም የሥራው መንግሥትን በ#
ታክሲም : ችግር ሲያደርግ ለማዋል ጥሩ ሰላም
አልፎላት : አሜሪካዊ ግንባር ፊላደልፊያ #ኛ ለእናቱ
በየመንገዱ : በመጨረሻው ቲንኪንግ ተረዳ ጠየቀ ለእናቱ
መንጎጨት : ማጥናት ማሳተም ዕርዳታ የገንዘብ ቤት
ጀመረች : መርቷል ተረዳ ጠየቀ ተቀጠረ ለእናቱ
ቆይታችሁ : ኩላሊት ራይቲንግ የሚወጡ እንደሚያደርስ ባንክን
በየቀለበት : ኩማና የሴት የሚችለው መንግሥትን *
መንገዱ : ኤድያ በ# ስለነበረም * ለአባቱና
ባንኮኒ : ሆኖ ሆኖም # ግዛት ይጫወት
ካልተሠራ : ክርስቲያናት እንዳለበትም ይጫወት ድሃ ነበር
ብላችሁ : በኋላም ወራት ድሃ ለእናቱ ለአባቱና
እንዳታደናቅፉ : ከመርካት ጅምር ለጥሬ የምንዛሪ መሠረት
አላቸው : አንዱ ከእንግሊዝ በ# * ልጅ
ቀልቡን : ፀሐይን የማያካትት በመግለጽ ባጋጠማቸው ነፃነት
መለሰና : ካላስቀደማችሁኝ ተሳትፎ የእንግሊዝ አሜሪካን ፊላደልፊያ
ያቆምነው : ያደርጉባቸዋል አጠያየቁ ገቡ ተማረከ ጠየቀ
አዎ : ተተኪ ፌቴክ ለአባቱና
ሱፐር : የማሻሻያ የሥራው ማተሚያ ልጅ ለእናቱ
ማርኬት : ዞሮ አደባባይ ተማምነው ጥቂት የእንግሊዝኛ
ለ : ሬንጅ ደሬሳ ሁነኛ ወራት ዓመቱ
መባዘን : ከማል የሚያደርገው ላይም በመመለስ ተቀጥሮ
አቁሙ : ለመሳተፍ ዕድገት ጠቅሶ የገንዘብ ትገዛ
የደነገጠችው : ሄዷል ተረጋገጠለት ያኔ በሚገኝ #ኛ
ደጃፍ : ነፃነት #ኛ ለእናቱ ለአባቱና
አያችሁ : ነበርም ሁላችን በሚኔሶታ የነበሩት የፌስ
የእነሱን : ያለረፍት አል ፍለጋዬ አዘጋጅም በኋላም
ሁሉን : አለን የሴት በራፍ ቪዛው ፍለጋ
ስንኮርጅ : በአንድ የፌስ እራሱ ልጅ ለአባቱና
እነሱ : አውቀዋል ፖሊሲ የራሱን ለእናቱ ለአባቱና
የእኛን : በተካሄደው እጥረት ቀናት ተጓዦች የእንግሊዝ
የጉልት : ሲያሳርፈው አበርክቶው ሮያል አሜሪካ እንደማይችል
ገበያ : ሁሉን በየቀለበት መኪና ምንጭ አለን
አልኮርጅም : ምዘናው መንግሥትን * ነበር ለአባቱና
ሲያንጣጣው : ፈቃድ ወደ የገንዘብ ድሃ ልጅ
መሹለክለኪያ : ባለበት ፍልስፍና ከፍ ቢሮዎች ተብሎ
ባላጡ : ኢኮኖሚያቸው ዩኒቨርሲቲ የሥራው ነበር #ኛ
ነበርም : አያችሁ ከቀረን በተጨማሪም የፌስ በፖለቲካዊ
ለካ : በራሱ በተደጋጋሚ የትውልድ ፈረንሳይ ግንባር
ቅርብ : የሚፈቀድለት ሴኔጋል ወር እራሱ መሣሪያ
ልሙትላቸውና : የሮም በአሁኑ እንደጠየቀው ብርሃኑ አንድ
ከቁም : ከአባቱ መመርያ ሆነናል ከማል *
ያድናችሁ : ገልቱነት ተቀጥሮ ተቀጠረ * ነበር
ከምትሞቱ : ቀዘባዋ ነፃ ለብሰው ዓ.ም. በፖለቲካዊ
ለእውነት : ኄር ለሚመለከተው ፍለጋዬ በሳይንስ ወደ
ጠቅላችሁ : ጭፍን ገዢው ጫኔ ግጥም ፈጽሞ
ሙቱ : የነበሩበትን ሲወጣ የእንግሊዝ ፊላደልፊያ #ኛ
ታዲያ : ምፀትና ጳጳስነት አሁን መተዋወቅ በኋላም
ተቃውማችሁ : የአወሮፓውያኑ በ# * ነበር ለእናቱ
አላልኩም : አመሲያ የመገንባቱን አሊ እንዳለፈ ተነባቢነት
ያልኩት : ለሽልማት ባለ መምህርም ማጥናት አዘጋጅም
እሺ : እነሆ በአካል ወዲያውኑም ስለነበረም ልጅ
በሉ : በዚህ ማይል አሜሪካ አባቱ #ኛ
ገዢው : ጭፍን ጠቅላችሁ ጫኔ ሜትር ሌላ
ፓርቲ : ወያላው አበርክቶው ማስተካከያ የጻፋቸውና አሜሪካ
ያለማዳመጥ : በዓይን ብላተርና ይገኛል ከተባለ የሚያደርገው
አታዳብሩ : ያለፋቸው የመጣ ተጓዥ እየተጎዳ ተነባቢነት
አሜን : ድካም ጥንታዊ መመርያ ተቀባይነትና ድሃ
ጭፍን : ጠቅላችሁ ወደ በኋላም የእንግሊዝ አሜሪካን
አማኝ : ማለት ፕሬዚዳንትነት አዘዋዋሪዎችን አባል የሚል
በረባ : መንግሥትን * ነበር ልጅ ለአባቱና
ባረባው : ክብርና ሳቢያ ለብሰው እንዳለበትም ይጫወት
አትበሉ : ይስጠን የሰለቸን ጽሑፋዊና ነባራዊ ፍለጋዬ
ቦምብና : ምን እንፈጥራለን ፈረንሳይ ቀደም በመመለስ
ጠበንጃ : ስሙልኝ ተያያዥ ዕድገት ሳምንት ተቀባይነትና
ሲያስታጥቋችሁ : ንብረቶች ይዳስስ ላንኪ አካባቢዎች ሆኖም
ሲያነበንብ : ወያላውና የተገኙት የፈጠራ አብዮት ፍራንስ
ታክሲዋን : ለሚመለከተው ተቋማት ፕሬስ በሳይንስ ግን
አስነሳ : በግብፅ ማሳወቅና ነፃነት #ኛ ለእናቱ
ዘወር : በምልክት የንግድ ሳይሆን እንዳይዛመት አጋጠመው
በል : ጣሪያው ሲሆን ቀደም ድሃ #ኛ
ሲያባርረው : እንዳለን ዓመቱም የነበረችውን ወዲያውኑም ፊላደልፊያ
እያውለበለበ : መምህርነት ተልዕኮውም እንደነበረ ለአባቱና
ሸኘን : እምነት ተነባቢነት በ# * ለአባቱና
ነፍሱ : ያፅናኑታል የአውቶሞቢሉ ዳንኪ ይጫወት ላይም
ትስከር : ጉበት አስነሳ ሰብዓዊ በግብፅ ማሳወቅና
አልያም : ቅርስ ሐሳብ ትይዩ እኔና በፖለቲካዊ
ሰውነቱ : ጠብቅ በመገናኘት ተብሎ እንዳይገቡ መጽሐፍ
በመጠጥ : በመምራት ፍራንክሊን ዩኒቨርሲቲ ፊላደልፊያ በ#
ሳናረጋግጥ : የማላሠራለትን ሰጥቶ ያኔ ወዲያውኑም ልጅ
ራቅነው : ፖሊሲ መሣሪያ የገንዘብ የራሱን በሚገኝ
የማያገናኘው : በመገናኘት መመርያዎች ተብሎ ቅኝ ብዙ
ዓይነት : የማትሠራው አካል ዕርዳታ ነበር #ኛ
መቼም : በእነዚሁ በቪክተርና የምታውቁ የጋዜጣው ዓላማውን
መዳረሻችን : የዕርዳታ ወጣ በማተሚያ አሜሪካን ስለነበረም
ተቃርበናል : ፍርድ ዋና * ለአባቱና
አትደማመጡ : ቲንኪንግ የመዘገበው ለእናቱ ለአባቱና
ሊለን : ካላችሁ ብቻ ጓደኛን የእንግሊዝ #ኛ
ፈልጎ : አዋጁ የ# ማተሚያ #ኛ ለአባቱና
ከፍቶ : የመገበያያ ሰጥቶ ይመራ ሦስት አፍ
አጉኖታል : ይሁን ቀን ሕይወቱ ተቸግሮ ግለሰቦቹ
በፈረንሳይ : አቡነ በወለጋ የተሰኘው ተመሳሳይ ሊያገኝ
ስለደረሰው : ለመምራት እያቋቋሙ ሄዷል የሚል ጋዜት
የሽብር : ከትምህርት ሄዶ ተብሎ በሚኖረው ማሪዋና
ጥቃት : ኧረ አዳራሽ እንደሚሰጥ ሥፍራ ከመደብር
ጋዜጠኞች : ያሉባቸው ተውኔቶች የነበሩበትን ስለኤሌክትሪክ የነበረችውን
እየተቀባበሉ : ከጀርባችን አውድማ የኤርትራ ትስስር ስብሰባ
ያትታሉ : የለም ሲወቀሱ በኢትዮጵያ ይታተም በ#
ቀንሰው : ሰሎሞን ለማቋቋም ዓመቱ ልጅ #ኛ
በፈጠረህ : ለአምስተኛ ተጓዥ ታይቶባቸው ኒውስ ፈረንሳይ
ራሱ : ሰዎች በጅምር በ# * ነበር
ከሽብር : ቀዘባዋ የምንዛሪ ለብሰው ላይም ወዲያውኑም
ለየው : አስታወቀ ገልጿል ገቡ ተቀጠረ አባቱ
ካጠገቤ : የኢትዮጵያና በብቃት በእነዚሁ የሚፈልገውን ወዲያውኑም
የተቀመጠው : የተገኙት በኦሬንታል ሁነኛ ወራት ዓመቱ
ይነጫነጫል : መመዘኛ ለመፍታት አፍሪካን መሆናቸው ጊኒ
ከጀርባችን : እየተቀባበሉ ያጠናከረው ሞዛይክነት ሮያል እንደማይችል
የተሰየመችው : ይበላለጥ ከባንኮች ተብሎ የተገረመው ቫን
የበኩሏን : በኢኮኖሚው የራሱን #ኛ ለእናቱ ለአባቱና
የደሃና : ሥርጭት አገናኙን መስኩ ፍራንክሊን በ#
የሀብታም : የበይ ተወኝ እንደተመኘ አንቺ በከፍተኛ
አለመመዘኑ : ስልክ በታች ጋር ቀደም ነገር
ሲገርመን : ትገዛ ፊላደልፊያ ለእናቱ ለአባቱና
ለአደጉ : የነበረውን የሚችለው የሆነ በ# ነበር
ለደካማ : አለን በመምራት ያመሰጠረበት ኢትዮጵያዊ አካል
እንባ : አቡነ ስብሰባ ተመሳሳይ የገንዘብ አሜሪካን
የሚሰጠው : እንዳይጨምር ባነበበው ነገር ስለፈለገ ፊላደልፊያ
የአየር : ለማሻሻል ሕክምናውን ልቦለድ የዕርዳታ ሲጠጋው
ሰዓት : ይፋ ተብሎ ዕርዳታ አሜሪካን የሆነ
ይበላለጥ : የተሰየመችው ከባንኮች መሣሪያ የገንዘብ ትገዛ
ያዘ : የሚሆን ገዛና የሆነ * ነበር
ምነው : ተጓዦች የምታውቁ ታላላቅ መሣሪያ የነበረችውን
በሽብር : የኢቦላን ጓደኛው የሚፈልገውን ወዲያውኑም ቤት
ባግዳድ : እንደሆነ ዓመቱ ለአባቱና
የምትጠፋ : ባለመቻላቸው ዓለም በምዕራብ ስለ ተሳክቶለት
ፓሪስ : ስለ ወራት ዓመቱ ድሃ ለአባቱና
ከምትጠፋው : ሳይቆይ ተገድበው የእውነቴን የተገረመው ላይ
ምኗ : ብርና #ኛ ለእናቱ ለአባቱና
ይሆን : ዓ.ም. ታላላቅ ይጫወት የገንዘብ አሜሪካን
ሲመዘን : ጭምር ይዘህ ጉዳይ ዕድል እንደማይችል
የቀለለው : አቅዷል አሳይቷል ያገኛል ጠየቀ ተቀጠረ
ወይስ : ወግ ማይል ወዲያውኑም አባቱ #ኛ
የባግዳዱ : የፍራፍሬ ምንጭ በእምነት እንዲህ ምንዛሪ
ቻይና : ፔንሲልቫኒያ የሚፈልገውን የገንዘብ ቤት ፊላደልፊያ
ሠራሽ : ማን መጠኑ የፔንሲልቫኒያ ዕርዳታ ለእናቱ
የማትሠራው : ሊገነቡ አካል ምክንያቱ መስኩ ዕርዳታ
ተይ : ያፈዘኛል የብቃት ሐያቱም የእንግሊዝ #ኛ
በጫማ : በተካነበት ሚና እየተሳካ መንግሥትን የሆነ
የተቃጠልነው : ኦስተን ለ# የገንዘብ የነበረችውን ያኔ
አንሶ : ወንጀለኛ አገናኙን የሚል ዕርዳታ ማተሚያ
በነፍስ : ተቋሙን መሥርቶ በሥነ ኪሳራ መንግሥትን
እንቃጠል : ጥንቃቄ መሻሻልን ኒልን ታላላቅ ድጋፍ
እንዴ : እሱ ጋበዛቸው ጋዜት ተረጋገጠለት ጠየቀ
አጠገቧ : ከጎኑ ታሪኩ ማስተካከያ የጻፋቸውና አሜሪካ
ይስቃል : ሲመት ጊዜ ነፃነት ሚና #ኛ
ውይ : አላቸው ተቋሙን አፍሪካ በአንድ ልጅ
እንኳንም : ተኮሳተረ ገንዘብ አሜሪካን የራሱን ስለነበረም
አንዳንዱን : በመምራት ፍራንክሊን ዋና እግቡ ነገር
ነገርስ : የፀና ብዙኃን ወር መካከል አገሮች
አይሥራው : ያፅናኑታል ይጫወት ላይም ድሃ ለአባቱና
አስቡት : ተጓዥ እየተጎዳ መካከል ዩኒቨርሲቲ ከፍተኛ
ሳንባ : ከመርካት በቪዲዮ ቀጥሎም ለ# አንድ
ኩላሊት : ቆይታችሁ ባንክን በፌስቡክ በኋላም ፊላደልፊያ
ጉበት : ትስከር ሲሆን ባነበበው ሮዚም #ኛ
አንጎል : የቆምንበትን ብሶተኛ አመንቴና ከጊምቢ መንግሥትን
ወዘተ : ሊያርፍ ጥናቶችንና # ቢታወቅም እንደነበረ
ሠርቷቸው : አቅራቢያ ራዲዮ ፔንሲልቫኒያ የሚፈልገውን ፊላደልፊያ
ተገዝተው : ስሙልኝ በሚኔፖሊስ ነፃነት መስኩ እንደሚኖርበት
የሚገጠሙ : ሾፌሩ ለውጥ ኢትዮጵያዊ ዓመት በ#
ቢሆን : አገላለጹ እገዛ እየተደራደረ አካባቢዎች ነበር
ኖሮ : ጓደኞችህን ይችላል አገናኛቸው አድርጓል የሚያደርገው
ቀዘባዋ : ከሽብር የምንዛሪ ለብሰው በፖለቲካዊ ላይም
የማይሠራውን : የናፈቅናት ኦል አካልም የመዘገበው ተሳክቶለት
እያጠፋው : የበቁት መሆኑንና የ# ፌስቡክ ፈረንሳይ
አይደል : ብሔራዊ አደገኛ ሰው ላይ በአሜሪካ
ፍዳችንን : በእጃቸው ወንጀለኛ አዘዋዋሪ ፌስቡክ በመወከል
ያየነው : ዲሞክራሲ ሬዲዮ ጉዳዩን ሥልጠናዎችን ቡክ
ያልፈጠርነውን : እንደሆነ ሮሮ ብሔራዊ በተያዘው አደንዛዥ
የምናጠፋ : ፍራንቼስካና ትምህርታቸውን ሕይወቱ ሰው ቪክተር
የማናጠፋውን : የምናነድ ትምህርታቸውን ብርም ብሔራዊ የማተሚያ
የምናነድ : የማናጠፋውን ትምህርታቸውን ፕሬዚዳንታዊ ደብዳቤ ከኢትዮጵያ
ያልደከምንበትን : ተሰብስቤ ባለመቻላቸው እንዲይዙ ተነባቢነት ዋና
የምንዘርፍ : አግኝተዋል ኃላፊነት ተጠቁሟል ነዋሪ ይኼን
ስንባል : ከሽብር ጽሑፋዊና የምንዛሪ ላይም ትገዛ
ያለነው : ለትከሻ ጥበብ ሲያደርግ መጠኑን ለማቋቋም
ፍጡሮች : ማን መጠኑ ዕድል ልጅ ለእናቱ
ተሳፈሪ : ወጣት አመራር አፍሪካ ሲጠጋው ለ#
ተወርውሮ : አባላቱ ኢጣሊያ አውጪዎችና በካሜራቸው ነገሮች
ሊያርፍ : ወዘተ ለሥልጣን # ቢታወቅም ድሃ
አልቀረው : ታላላቅ ከፍተኛ ፊላደልፊያ ለእናቱ ለአባቱና
ጥግ : ፍጥነት ፖሊሲ ጋዜት መሣሪያ የነበረችውን
ሲለን : መካከልም መመዘኛ መልዕክት እንደሚኖርበት የገንዘብ
ከመቼውም : ካልተሰረቀም ዕቃ በእጅ ፖሊስ ገንዘብ
ሠልጥኗል : ታሪካዊ ከቫይረሱ ጋዜጣ በማተሚያ ያህል
በሚባልበት : ትገዛ ልጅ ለእናቱ ለአባቱና
እያደር : ሲያዳምጥ ታሪኩ ወጣ አሜሪካን ወዲያውኑም
የምናየውና : በወጣ ኳስን ጥናቶችንና እንደነበረ ሮያል
የምንሰማው : ክርስቲያናት አቋም ግለሰቦች ሆኖም ማተሚያ
ሬት : እግረኛ ከተመረቀ ዓ.ም. የጋዜጣው ተቀጠረ
እንዳለን : አጠገብ ከተመረቀ ዓመቱም ዓላማውን የነበረችውን
እያወጋን : ዜግነቱ ወር መጽሐፍ ትገዛ ፊላደልፊያ
ወረድን : ወንድሞችህን ሴራሊዮን መልዕክት መሣሪያ እንደማይችል
ወግ : ወይስ ማይል ተሳትፎ ቀጥሎም አባቱ
ሲያዳምጥ : ኳስ እኛ መደብር ምርምር አሜሪካ
የነበረ : ሰደድ መፀዳጃ ፈንታ ዓውደ ትምህርት
ዝምተኛ : ሱባዔ ድር ዕድሉን አዲሶቹን በጸሐፊነት
እባካችሁ : ጥያቄዎች ኪሳራ ምርምር ስለኤሌክትሪክ የነበረችውን
አቃጥላችሁ : ራዲዮ ክፉኛ በላይ በፌስቡክ ፊላደልፊያ
አታቃጥሉን : ውስጥና ግለሰብ ምርምር የነበረችውን ትገዛ
ዓይኑን : ሰዓት ወጣ ፖሊስ አሜሪካን ፊላደልፊያ
ሲያጉረጠርጥ : ለደካማ ሞት ፍርድ መለያ እኛ
ይኼኔ : እንደበዛ ተመልካች መነጋገሪያ ለምን ጓደኞች
መሸሽ : ገልጸው በተጨማሪ በታች እራሱ ወደ
ብለን : የመሩት በሁለቱም ሚና ስለፈለገ የሆነ
ወደየጉዳያችን : በመሆንም ግጥሞቹም መመንዘር ድሃ ለአባቱና
ተበታተንን : ንጉል መርቷል ለአምስት ለውጥ ሄዷል
መልካም : የሁሉንም ኒልን ሮዚም ጥረት ፈረንሳይ
ጉዞ : ይቀላቀላል ቪክተርና ጠየቀ #ኛ ለእናቱ
ዜናዊ : ኩራት ላይም በኋላም ድሃ ለእናቱ
መስፍን : የፍልስፍና የሚወጡ ጋር ቀደም በኋላም
የኢንተር : ታናሽ አገሪቱ ሲከፍት ሄዷል በማድረጉም
ኮንቲኔንታል : የዓለምን እየጨመሩ ሥርጭት እንደነበረ ዕድል
አስኪያጅአቶ : የ# ተልዕኮውም ስለፈለገ አንድ ለአባቱና
ተወልደው : ተከትሎ ጽሑፍ ክሪቲካል ዕድገት ድጋፍ
ያደጉትና : የበገኑት የአፍሪካ የሥራው መንግሥትን *
ሁለተኛ : አንገቱን ለፊፋ ትገዛ #ኛ ለእናቱ
የተማሩት : ያድናችሁ ተቀጥሮ ተቀጠረ ዓመቱ *
በሽሬ : አንጎል ክህሎት መኪና ናቸው ዋና
እንደስላሴ : አነጋጋሪ የመጣ አንድ ነበር ለእናቱ
በቴክኒካል : በሆቴልና ጥልቅ በአይሁድ የኢትዮጵያውያን ፍራንስ
ቲቸር : ቱሪዝም ዕውቀትና ጽሑፍና እኔና እንደጠየቀው
ኤዱኬሽን : ቢሸጡ በካሜራቸው ለመፍጠር ነገሮች ሚና
የሁለት : በልቶ ድካም እንደነበረ ፍራንክሊን ተቀባይነትና
ኮርስ : ተቀምጠው ያለፋቸው እየረቀፁ ቢሆኑም ድሃ
ተከታትለዋል : ገቡ አሜሪካዊ ተረዳ ተቀጠረ ለእናቱ
ሐንጋሪ : መጨረሻ በዙሪክ ከ# እንደነበረ ወደ
አቅንተው : ከሪፖርተር ገጣሚና መጽሐፍ ፈጽሞ ወትሮው
በቡዳፔስት : የሚችሉለት ዩኒቨርሲቲ ተቀባይነትና ነገር ድሃ
በሆቴልና : በቴክኒካል ዛሬ ተቀጥሮ መንግሥትን በ#
ቱሪዝም : ቲቸር አስተዳደር ዕውቀትና ያጋለጠውን ውስጥ
ማኔጅመንት : መሥራት የሚፈልገውን የገንዘብ ቤት ፊላደልፊያ
የመጀመሪያ : መስኩ ፍራንክሊን እግቡ የገንዘብ #ኛ
በኢንተርናሽናል : ኤድያ ግዛት በ# * ነበር
ሪሌሽን : ጠቅላይ ነባራዊ አገሮች በመመለስ ወደ
ዲግሪያቸውን : ያገናዘበ ዕድል እንደማይችል የሆነ ፊላደልፊያ
ተሻግረው : ነጋዴዎቹ ጅምር የኢትዮጵያን ክፉኛ በመመለስ
ከሜሪላንድ : አለቃ መንግሥትን የሆነ * ነበር
በቢዝነስ : ይነጫነጫል አኅጉሮች ሊያገኝ የገንዘብ አሜሪካን
አድሚንስትሬሽን : በሰው መሪዎች እግዚአብሔርና በሙሉ መስኩ
የማስተርስ : አካል ምክንያቱ መስኩ #ኛ ለእናቱ
ተቀብለዋል : ይስተዋላል ነው አድርጓል ቀርተውበታል ጠየቀ
በቡዳፔስትና : ይኼው በሌላ በአካል ቀጥሎም የጋዜጣው
በሚገኙ : አፍታ ልምዱን የአጫጭር እግቡ ፊላደልፊያ
ሆቴሎች : ሌሰላው ደብዳቤ ተቋማት ሮዚም የመሆን
ምግብና : በባህር በሙሉ በላይ የእንግሊዝ #ኛ
መጠጥ : ፕሬዚዳንት እስከ ዕድገት ዋና *
ዲፓርትመንት : ሶሳይቲ ጠየቀ የነበረችውን በ# ስለነበረም
ሠርተዋል : አይገርማችሁም ይችላል አገናኛቸው አቋቋመ በኋላም
ሆቴሉ : ጋዜጠኝነቱን በእነዚሁ በአካል ፔንሲልቫኒያ ዓላማውን
የወርልድ : እናስቸግራችሁ እንደሚሰጥ ያሳተመውን ቅድመ በመኖር
ሌግዠሪ : በዓለ የሆቴል ውይይት መመርያ ማሪዋና
አዋርድ : ተያይተው ሸርት ጸሐፊዎችና ለመፍጠር የሚፈልገውን
ተሸላሚ : እያየሁ በወጣ የአፍሪካ ከዩኒቨርሲቲ #
ከአቶ : ኦስተን ወዳጆች የነበረችውን ልጅ ለእናቱ
ታደሰ : ድረስ ማስተካከያ ፖሊስ ትምህርት ጋዜጣ
ገብረማርያም : ባለፈ ተጠቅመው የነበሩበትን ሚና ቤት
ኢንተርኮንቲኔንታል : ባነበበው ፍለጋ ጥረት ነገር ፊላደልፊያ
የሆቴሎች : ኮምፓራቲቭ ድጋፍ አባል ዓላማውን ነገር
ውድድር : በ# * ነበር #ኛ ለአባቱና
አብስራችኋል : ደሬሳ አሳይቷል ይችላል ዞሩ #ኛ
ሽልማቱን : የአቡነ ማይል ወዲያውኑም ፊላደልፊያ አባቱ
የሰጠው : ሙሽራ የሚፈጸመው ዕድገት ፍራንክሊን ትገዛ
የትኛው : በጥረት ቴክኖሎጂ ኦስተን ወዳጆች አገሮች
ሆቴሉስ : ከሰባት ተልዕኮውም ለአባቱና
በምን : አያቶቻችን ወራት ዓመቱ ድሃ ለአባቱና
መሥፈርት : የተዋጠላቸው እንደሚያደርስ ተቀባይነትና ፊላደልፊያ #ኛ
ለሽልማት : ብዬ ማጥናት ማሳተም ዕርዳታ ፊላደልፊያ
የበቃው : ጠይቀዋል በመቆጣጠር ጠየቀ ተቀጠረ አንድ
ሆቴልን : የማያገናኘው በመገናኘት አቀፍ ምርምር የገንዘብ
የሸለመው : ዕውቀትና ያጋለጠውን በላይ ወዳጆች የገንዘብ
ወርልድ : አካል አገናኙን እንደማይችል ዕርዳታ የነበረችውን
