ጳጳስ : በመሆንም ዓ.ም. ቀን # ጥር
ጥር : እናገኛለን ነን እሠራለሁ ግንቦት ሰኔ
# : ባለአምስት አላልኩም የተቀመጠ በልቶ በፊት
ቀን : ያደገው የጀመረችው ከጀመሩ ዓ.ም. #
ዓ.ም. : እሺ አዎ ተተኪ ቀን ጥር
የአዲስ : የገባች ልብ በአዲስ በፊት ሰኔ
አበባ : ኢትዮጵያ ቀን ጳጳስ
ሲሆኑ : የሆነ ቆይ ብትን ቤተ ኢትዮጵያውያን
የመጀመርያው : ተከታያቸው በ#ኛው ቀን ጥር ጳጳስ
የኢትዮጵያ : ከምትጠፋው ያወጣ ተወኝ ልጅ ወያላው
ካርዲናል : ሊሞላት ምነው ወንድ ተቀምጠው የተቀመጡት
ጳውሎስ : ጵጵስናቸው ከሲመተ በመሆንም ዓ.ም. ቀን
ፃድዋ : አለቃ ሆነዋል ዓ.ም. ጥር ጳጳስ
ተተኪ : አዎ የተቀመጡት ዓ.ም. ቀን ጥር
በመሆንም : በፊት ዓ.ም. ጳጳስ
ሰኔ : ግንቦት በሊቀመንበርነት በፊት ጥር ጳጳስ
ሊቀ : ዘመናዊ ሜትሮፖሊታንን መንበር ጵጵስናቸው ቀን
ጳጳሳት : እንዳታደናቅፉ ዓ.ም. ቀን ጳጳስ
ሆነዋል : ነው ከጀመሩ ቀን ጥር ጳጳስ
* : የሚል ተተኪ ካርዲናል ቀን #
ከሲመተ : የመታጠቢያ እያሉ ጵጵስናቸው ጳውሎስ ዓ.ም.
ጵጵስናቸው : ተቀምጠው በመሆንም ተተኪ ዓ.ም. ቀን
በፊት : ሲቀረው ሠራሽ ለመድረስ መሆኑ አፍሪካ
በ# : አስመስለው አንድ ያደገው ቀን #
የላዛሪስት : ተቀምጠው በ#ኛው ከተማ የጂማ ተተኪ
ማኅበር : ውይ በል ከጎኑ ሞት እምነት
እንዲሁም : ገጽ እናስቸግራችሁ ያለው ሾፌራችን ወጣት
የጂማ : ተቀምጠው የተቀመጡት የላዛሪስት በመሆንም ተተኪ
ቦንጋ : ከገባበት ታሪካዊ ወያላው ከተማው ቀን
ሀገረ : መንግሥቱና ካልተሠራ ከመርካት ከሚል በመሆንም
ስብከት : ይለኛል ዓ.ም. ቀን ጥር ጳጳስ
ጠቅላይ : በመሆንም ቀን # ጳጳስ
አለቃ : አንጎል ሆነዋል ዓ.ም. ቀን ጳጳስ
የነበሩት : እናስቸግራችሁ ጦረኛ ኢትዮጵያ አሥራተ ኢትዮጵያውያን
ብርሃነየሱስ : ክርስቲያን በመሆንም ካርዲናል ዓ.ም. ጥር
በአዲስ : እናንተና ስትል የኢትዮጵያና ዓ.ም. ቀን
በሚገኘው : በአጠቃላይ እርስ ግብዣ የምለው ክፍለ
የካፑቺን : መመራታቸው ተፈተለከ ከሲመተ ሰኔ ጳውሎስ
ፍራንቼስካና : ከእንግዲህ ተጀምሯል የሚጠራ በመሆንም ተተኪ
የፍልስፍናና : የሀብታም በዓይን ሠርግ ሆነዋል ጥር
ነገረ : በግል ያሉ ሥልጣን ዓ.ም. ቀን
መለኮት : የጀመረችው ዓ.ም. ቀን ጥር ጳጳስ
ተቋም : እንግዳ ከፍተኛ ያፈዘኛል ያደረጋል በመሆንም
ከመሠረቱት : አልፎንስ በፊት በመሆንም ዓ.ም. ቀን
አንዱና : ብዙ መካከል በተንሰራፋበት ቀን #
መምህርም : ማሳያ ወክዬአቸው ተቃዋሚዎች በመሆንም ዓ.ም.
ነበሩ : እናገኛለን ነው ያደገው በተንሰራፋበት ሆነዋል
ከመንፈቅ : በዚህም አዎ ጵጵስናቸው ዓ.ም. ቀን
በማላዊ : አራት የሚገኘው ከምትሞቱ ከጀመሩ ከእነዚህም
ሊሎንግዌ : አመለካከት ልሙትላቸውና ተቃጥለው ዘመን ዓ.ም.
ከተማ : ይህም ማንና ሙሽራ ተቀምጠው የላዛሪስት
በተካሄደው : መልፋቱ መድኃኒዓለም ካርዲናል ቀን ጳጳስ
የ#ቱ : ሲገኙ በመሆንም # ጥር ጳጳስ
የምሥራቅ : በሉ ከእነዚህም ቀን ጥር ጳጳስ
አፍሪካ : ለመድረስ በፊት በመሆንም ዓ.ም. ቀን
ካቶሊክ : በቡዳፔስት እንደስላሴ ጎዳናውስ የሚል በመሆንም
ኅብረት : በተሞላበት ሰጥተን ሆነዋል በመሆንም ዓ.ም.
አመሲያ : ፈገግታ አትበሉ ተተኪ ቀን #
ሊቀመንበር : ጣይቱ የሚመስለው ያለው የጦርነት ከተማ
ሆነው : ሳያገኙ እንደሚንከባከቡ እስኪ በመሆንም ዓ.ም.
በመመረጥ : እየተሳፋ ተቋም ዓ.ም. ቀን ጥር
በማገልገል : ከተማው ሰኔ ተተኪ ጥር ጳጳስ
ላይ : እናሟላለን የሚሰጠው ከጀመሩ አመሲያ ሆነዋል
ሲገኙ : ፈልጎ የ#ቱ ተተኪ ቀን #
ዩኒቨርሲቲ : ሊሞዚን ዓመት አልፎንስ በተካሄደው ከመሠረቱት
ቻንስለርም : አፍሪካ በፊት በመሆንም ዓ.ም. ጥር
ናቸው : ነን ነው ሆነዋል ጥር ጳጳስ
የኢትዮጵያና : ከምትኖርበት አካባቢውን አቶ እናንተና በአዲስ
የኤርትራ : ተበታተንን ሊቀ ቀን # ጳጳስ
ምክር : ሆነዋል ዓ.ም. ጥር ጳጳስ
ቤትንም : በርስ ያፈዘኛል እንዳልተንገላቱ ተቋም ተተኪ
በሊቀመንበርነት : እናሟላለን በፊት ሰኔ በመሆንም ዓ.ም.
ይመራሉ : መልፋቱ ነው ሰኔ ዓ.ም. ቀን
የቤተ : ሁለት ይኼው መቼም ትምህርትህን በልቶ
ክርስቲያኒቱ : ከዚህም በዚህም ቆይ እኔን ኤምባሲ
የታሪክ : አጉል የላዛሪስት አበባ የአዲስ ዓ.ም.
መረጃዎች : ተጠናክሮ ተዘጋጅቶ እርግማኑን ተሳፋሪውን ከዚህና
እንደሚጠቁሙት : አጋማሽ ስብከት በመሆንም የመጀመርያው ቀን
በኢትዮጵያ : ጉስቁልና እኔን ኤምባሲ ቀን ጳጳስ
የካቶሊክ : ዲፓርትመንት ፓትርያርክ በፊት በመሆንም የአዲስ
እምነት : ኬፕታውን ዋና መልስ ማኅበር በመሆንም
በተንሰራፋበት : ትሥላለች ጣይቱ ነው ነበሩ ቀን
ከ#ኛው : ነበርም ሸምድዶ እነሆ ያደገው ቀን
ክፍለ : ፍረዱኝ የሚጠራው በመሆንም ጳጳስ
ዘመን : ኤፎር ሬስቶራንቶች ጥሩ በመሆንም ዓ.ም.
አንስቶ : በቅቷል ጀመር ታሪካዊ ይታወቃል የመጀመርያ
ያለፉ : እንዳለው በመሆንም ጳጳስ
ሲሆን : ተረፈ አጋማሽ ጊዜያት የመጀመርያው አበባ
ከእነዚህም : አይሃለሁ ተከታያቸው ነበራቸው ሰኔ ቀን
መካከል : እንዳታደናቅፉ ሙሽራ ክርስቲያን ከመሠረቱት ሰኔ
ከ# : ውስጥና ጡረታቸው ተቀምጠው ጵጵስናቸው በመሆንም
በታች : ሞልቷቸዋል ካርዲናል ዓ.ም. ቀን ጳጳስ
የሚሆኑት : የሚችሉ ይህም ሞት ነገር ከመርካት
ኢትዮጵያውያን : ሞት ሰዎች ሙሽራ ሲሆኑ #
አልፎንስ : ይህም ሳይመስለው ከመሠረቱት ተተኪ ዓ.ም.
ሜንዴዝን : የሚገነባው መምራት በሊቀመንበርነት ቦንጋ ጥር
ጨምሮ : በቅቷል ብንጀመርም በአዲስ ዓ.ም. ቀን
ሦስት : ጡረታቸው እሳትና ከ# በመሆንም ዓ.ም.
የፖርቱጋልና : በመሆንም ተተኪ ካርዲናል ዓ.ም. ቀን
የስፔን : ሆቴሉስ ሲያስታጥቋችሁ ታክሲዎች ተተኪ ዓ.ም.
ሊቃነ : ኮንቲኔንታል ከመንፈቅ ሊቀ ጳውሎስ ቀን
በተለያዩ : ሥርዓት የቀረው ስንቱ አይሃለሁ የወያላውን
ጊዜያት : ሲሆን የመጀመርያው ዓ.ም. ቀን ጳጳስ
ፓትርያርክ : ኤሌክትሪክ በመገረም የኪራይ ከሚል ብትን
የሚል : የታየው * ካርዲናል ዓ.ም. ቀን
ሥልጣን : ትላለች ተቀምጠው ዓ.ም. ቀን ጥር
ነበራቸው : እንሰጣለን እሠራለሁ ይታወቃል ግንቦት ሰኔ
በ#ኛው : የላዛሪስት ቀን # ጥር ጳጳስ
የመጀመርያ : ሞልቷቸዋል አንስቶ ቦንጋ ሰኔ ጥር
አጋማሽ : ተረፈ እንደሚጠቁሙት ስብከት ማኅበር ሲሆኑ
ካቶሊካዊት : ማኔጀር ሆነዋል ቀን ጳጳስ
ቤተ : እናንተና ባይ በመሆንም ሲሆኑ አበባ
ክርስቲያን : ብርሃነየሱስ በመሆንም ካርዲናል ዓ.ም. ጥር
መንበር : ሜትሮፖሊታንን ዓ.ም. ጳጳስ
በሊቀ : ሲኤንቢሲና የስፔን ከመሠረቱት ከሲመተ ሊቀ
ጳጳስነት : ሁኔታ እውርን እርስ ጳጳስ
እስከ : እንግዳው እንደስላሴ ቃጠሎ የረጅም በፊት
የተቀመጡት : ተቀምጠው ተተኪ ካርዲናል ዓ.ም. ቀን
አቡነ : ለበለጠ ሐፒ የጉልት ጳጳሳት ዓ.ም.
አሥራተ : ሳይመስለው በየፌርማታው የምለው የነበሩት በመሆንም
ማርያም : ይፈጥራል መስለው እየታደለ ብርሃነየሱስ ተተኪ
የምሩ : ጡረታቸው ነኝ ረቂቅነቱ ያለፉ ዓ.ም.
ተከታያቸው : የመጀመርያው ቀን ጥር ጳጳስ
ደግሞ : ትሥላለች መውደም ይልቅ የኢትዮጵያና በማገልገል
ተቀምጠው : የላዛሪስት በመሆንም ተተኪ ዓ.ም. ቀን
ነበር : የሚዘምቱት እኔ ነው ይታወቃል ያደገው
በቫቲካን : በል እናስቸግራችሁ ማኅበር ተተኪ ዓ.ም.
በሆኑ : የሚያሟላቸውን ከ# በፊት ሰኔ ካርዲናል
ግንቦት : ሰኔ ጥር ጳጳስ
ዓመት : ድርሻ አገር ሙሽራ የምለው በፊት
የሆኑት : ተቃዋሚዎች ልንጓዝ የተቀመጡት መምህርም የጂማ
ሜትሮፖሊታንን : መንበር ዓ.ም. ጳጳስ
መምራት : ሜንዴዝን በፊት ሆነዋል ዓ.ም. ጥር
ከጀመሩ : ቀን ጥር ጳጳስ
ዓመታት : የተሰየመች ጵጵስናቸው ቀን # ጥር
ሞልቷቸዋል : ተቋቋመ ጉዞ በታች የላዛሪስት ሰኔ
ኢትዮጵያ : አበባ ቀን ጳጳስ
ከቫቲካን : በርስ እኔን ታክሲያችን በመሆንም ጳጳስ
ጋር : ያህል ነው ጥር ጳጳስ
ዲፕሎማቲክ : ይጋፋል ልጃቸው ስንቶች በሆኑ አፍሪካ
ግንኙነት : ዋና መኪናን የስፔን ተተኪ ሲሆኑ
በሌጋሲዮን : ርዝማኔ ዕድሉን በኢትዮጵያ እንዲሁም ጳጳስ
ደረጃ : እንደሚገባና እየታደለ በፊት ሰኔ በመሆንም
የጀመረችው : ቀን ጥር ጳጳስ
ወደ : መልፋቱ የላዛሪስት ጵጵስናቸው ሊቀ ቀን
ኤምባሲ : ተድላ ሦተኛው አበባ ዓ.ም. ቀን
ያደገው : ቀን ጥር ጳጳስ
ቆይታ : ያወካት ያመሳስሉታል ልጃቸው በሊቀመንበርነት በመሆንም
በኋላ : ሲቀረው በፊት ሰኔ ተተኪ ካርዲናል
መሆኑ : በፊት በመሆንም ዓ.ም. ቀን #
ይታወቃል : እሠራለሁ አለኝ ሰኔ ቀን ጥር
እነሆ : ትለዋለች የምለው ዓ.ም. ቀን ጥር
ከቦሌ : እናመጣልዎታለን ዜናዊ ጭፍን ይሸምናል ትዕይንቱ
መድኃኒዓለም : ይሰውራችሁ መልፋቱ ነው በፊት ሆነዋል
ካሳንቺስ : የተቀበለው ከተማ ተተኪ ዓ.ም. ቀን
ልንጓዝ : የተቋሙ በፊት በመሆንም ቀን ጥር
ነው : ያሳውቃሉ ሆነዋል ቀን ጥር ጳጳስ
ታክሲያችን : ያቆምነው የሚጠራ ቤተ በመሆንም ዓ.ም.
ሞልታ : ጥጓን እስኪ አመሻሽ ሽር አለቃ
እየተንቀሳቀስን : ሊሞላት ካሬ በፊት በመሆንም ዓ.ም.
ድንገተኛ : ትላለችሁ ያልኩት ሁላችን ከእነሱ የሚል
ሠርግ : ቅንጡዎች መሆኑ ቦንጋ በፊት በመሆንም
አጃቢ : ከተባሉት ከእኔ ከእነሱ ካልጠፋ የ#ቱ
መኪኖች : ያንዣበበት ሆነዋል ቀን ጳጳስ
መንገዱን : ይታወቃል ስብከት ሰኔ ዓ.ም. ቀን
ይዘጋጉታል : ያለነው ይታወቃል ግንቦት ሰኔ ዓ.ም.
ሾፌሩ : እጅግ ፍርድ በፊት ተተኪ ጥር
እኔን : ካጨዱና አይደለም ድካም ዓ.ም. ቀን
ካላስቀደማችሁኝ : ካላችሁ ማስገቢያ የሚገርመኝ ጣይቱ አይሃለሁ
አጉል : ከፍተኛ በሽብር ብሎ በሆኑ የታሪክ
ግብግብ : የሚገርመኝ እንዳልተንገላቱ የምለው ስብከት ቀን
ይገጥማል : ከተመራ አሸናፊ በሉ አለው ያደረጋል
እኔ : ዓመቷ ትለዋለች ነበር መምህርም በመሆንም
የምለው : ቱሪስት የሚገርመኝ አንቺ ጥረትና በፊት
ከዚህ : ይህም ተሸላሚ ያውስ በታች ብርሃነየሱስ
ሁሉ : ባሮች ቅርንጫፎች ሲያስታጥቋችሁ መልስ በመሆንም
ከተማው : ጣራው ቁርስ ተስማሚ አዋርድ በዚህ
ሽር : ቀን ጥር ጳጳስ
ብትን : አዎ ጥረትና ከተማው ጥር ጳጳስ
ከሚል : ያደረጋል አለህ በሊቀመንበርነት ቀን ጳጳስ
ባለ : ጥግ አመሻሽ እየተንቀሳቀስን በመሆንም ዓ.ም.
ሊሞዚን : የመግባት ግብዣ በሊቀመንበርነት ጳጳሳት ቀን
ሙሽራ : ሞት ይታወቃል ከተማ ሰኔ በመሆንም
አንድ : አስመስለው የተሰየመች ያደገው በ# በፊት
የሚጠራ : ከተማው በሊቀመንበርነት በፊት በመሆንም ዓ.ም.
ይጥፋ : አድርጐታል ሆኗል ይታወቃል ነበሩ ሆነዋል
እያለ : ጠብቁን ቦምብና አፍታ ወጣት የነበሩት
ወያላው : ታሪካዊ ተተኪ ቀን ጥር ጳጳስ
ዕድሉን : እንዲሁም በመሆንም አበባ ጳጳስ
ያማርራል : ቅርብ ድርሻ በፊት ቀን ጥር
ሰው : ውይ ተቃርበናል ከዚህ ማኅበር የላዛሪስት
ከመሆን : ከተማው ዘመን ተተኪ ቀን #
ይልቅ : ዓመቷ ተተኪ ዓ.ም. ቀን ጥር
መተዋወቅ : የሚነጋገረው ሴራ እነሆ ተተኪ ዓ.ም.
በራስ : ታክሲያችን በመሆንም ቀን ጳጳስ
ጥረትና : በል ብትን የምለው ያደገው በፊት
ድካም : ሆቴላችን አሉባልታ በሽንጣም እኔን ሆነዋል
በልቶ : የማድራት ዘመን ቀን # ጥር
ከመርካት : እንዳታደናቅፉ ይመስል በሊቀመንበርነት ሀገረ በፊት
በሰው : የሚገነባው ካላችሁ አለህ ጵጵስናቸው በመሆንም
ግብዣ : ሊሞዚን ዓ.ም. ቀን ጳጳስ
መታደም : መምጣታቸውን አልኮርጅም ጉስቁልና መሥራቷን ያደገው
የሚያስመካበት : በሞላችው ተስማሚ ፍረዱኝ ተተኪ ካርዲናል
ስለሆነ : ስልክ ካላስቀደማችሁኝ መምህርም ሀገረ በፊት
የወያላውን : የተገነዘቡት ከእነዚህም ነበሩ ቀን ጥር
ሮሮ : መኝታ ኤምባሲ አበባ ዓ.ም. ቀን
ከመጤፍ : የተዘረዘሩት የኢትዮጵያና እንዲሁም ከሲመተ በመሆንም
ሳይቆጥሩ : ሁለት ተቀምጠው ሜንዴዝን የላዛሪስት ተተኪ
ተሳፋሪዎች : ተተኪ ካርዲናል ዓ.ም. ቀን ጳጳስ
እርስ : በአጠቃላይ ጆሯቸው ዓ.ም. ቀን ጳጳስ
በርሳቸው : በርስ እናትና ያደለው ቤትንም አመሲያ
ያጉረመርማሉ : ጥቂት የሚጠራው ረድፍ ዘመን ክፍለ
ያደለው : አትሌት የሚሸለም ታክሲ ይጥፋ ያደገው
ይጋባል : ከኤክስፐርቶቹ ዘመኑ እቴጌይቱ ቀን ጥር
ያላደለው : ሸምድዶ ከእንግዲህ ከተማው በማገልገል አበባ
ካልጠፋ : በሚታይበት ይህም የረጅም ከተማ ቦንጋ
ነገር : በግራ ጣይቱ ሽር ቀን ጥር
ጉንፋን : ቆይቶ ግብግብ ስብከት በፊት ሰኔ
ይጋባበታል : እንቃጠል አማኝ ልጃቸው ብርሃነየሱስ በፊት
አይ : ቀን # ጥር ጳጳስ
አንቺ : ባህር የምለው ቀን # ጥር
ዓለም : ተቀምጠው ጵጵስናቸው በመሆንም ቀን ጳጳስ
ምፀትና : ተቋቋመ ተቀምጠው በመሆንም ካርዲናል ዓ.ም.
ሸር : የተለየ ያደረጋል በመሆንም ጥር ጳጳስ
ረቂቅነቱ : በመሄድ አዎ አንተ ብትን ተተኪ
ስሙልኝ : ከመድረሱ ከሚል በኋላ በፊት በመሆንም
ባይ : ሽልማት ልጃቸው ቤተ ሜንዴዝን *
ብሶተኛ : ይለኛል በፊት # ጥር ጳጳስ
ወጣት : የአየር ለመድረስ አትሌት ማን መሆኑ
ሦተኛው : ሦስተኛው የነገር ኤምባሲ በመሆንም ዓ.ም.
ረድፍ : ድንጋይ ቦታ በፈጠረህ አፉ ቤተ
ይናገራል : የተቀመጠች ይጭናል ከተማው ዓ.ም. ቀን
ቆይ : አትሌት በአኳኋኑ አለህ ከተማው ዓ.ም.
ግን : ያለውም የሚጠራ ይዘጋጉታል ከተማ ዓ.ም.
በሽንጣም : አልፎንስ በፊት ተተኪ ቀን ጳጳስ
ለመዳር : እንደሚመስል ሙሽራ ከተማው የምለው ይታወቃል
የሚያስቡትን : መማማር ከተማው በማገልገል ነበሩ ተተኪ
ያህል : ተገምግሞና እሠራለሁ ዓ.ም. ቀን ጥር
ስንቶች : ባዩት ቆይ ከተማው እየተንቀሳቀስን ካርዲናል
ይሆኑ : አይሃለሁ በፈገግታ እንገናኛለን በመሆንም ተተኪ
የአብሮነታቸውን : ተጠያቂነት በሚታይበት የረጅም ከሚል ይታወቃል
ጊዜ : ማሳያ ጠቅላችሁ ተቃዋሚዎች መምህርም የመጀመርያው
ርዝማኔ : በሌጋሲዮን በኢትዮጵያ እንዲሁም ቀን ጳጳስ
አረጋግጠው : ሙሽራ በኋላ በፊት በመሆንም ተተኪ
የሚዘምቱት : ለምንድነው ይጋፋል ጣይቱ ያያል ነበር
ስትል : የጥሪው እሺ ትለዋለች ዓ.ም. ቀን
መጨረሻ : ዘወር በመሆንም ተተኪ ቀን ጳጳስ
ወንበር : ግን ይዘጋጉታል ስብከት ቀን ጥር
አንዲት : ያለውም ሒሳብ መጨረሻ ዓ.ም. ቀን
ጦረኛ : ጭፍን ያንዣበበት ማለት ኢትዮጵያ በመሆንም
መሳይ : የመረጃ ያስገኛል እይታ ትለኛለህ ዓይነ
ትዳርን : የተቀመጠች አንዲት አለቃ የላዛሪስት ቀን
የጦርነት : ክፍተት ሠራሽ የገባች በሽንጣም ሙሽራ
አውድማ : ጳጳሳት ዓ.ም. ቀን ጳጳስ
ልታደርገው : ሕጎች ከጎኑ ተድላ ለመዳር ኤምባሲ
ይዳዳታል : ከተማው በ# በመሆንም ዓ.ም. ጥር
እይታና : ለበለጠ የሚሞላበት እያወጋን ኢትዮጵያውያን ቀን
ፍርድ : ሞት ሙሽራ ብርሃነየሱስ በፊት በመሆንም
እንደራስ : ካሬ ጥር ጳጳስ
ነውና : የተመረኮዘ ጭፍን እሺ የሰለቸን አለህ
ለምን : መስለው ያያል ይጥፋ ነው ያደገው
እንዲህ : ገጽ አጠናቅቆ በሽብር አበባ ቀን
አልሽ : ቱሪስት አለህ ከሚል ይታወቃል መምህርም
አልተናገራትም : ዙሪያ ሜትሮፖሊታንን መንበር በአዲስ ዓ.ም.
በእንቅብ : የሚጠራ ከመሠረቱት ቀን ጳጳስ
የናፈቅናት : ችሎታ ተዓምር ሲገኙ ብርሃነየሱስ ሰኔ
ዲሞክራሲ : አልተናገራትም ስንቶች ይጋባበታል የሚጠራ ቻንስለርም
የእፍኝ : ታዋቂ ሲያሳንፈው ስንቶች የሚጠራ በመሆንም
የእፍኙ : ጀመር ባይኑ የአብሮነታቸውን ያማርራል በፊት
መሥራቷን : እያደር የተቀመጠች ርዝማኔ ተሳፋሪዎች ይልቅ
የወደድነው : በመሥፈርት በርስ መዋኛ ሠርቶ በፈገግታ
ይመስላል : ተፈተለከ እንቀበላለን ይዘጋጉታል ከሲመተ ዓ.ም.
ዘመናዊና : ገጽ ታስመስሉታላችሁ ከእነሱ ከመጤፍ ብርሃነየሱስ
ቅንጡዎች : ሠርግ ተቀምጠው ተቋም በመሆንም ቀን
ተምመው : መሆናቸውም በመሆንም ዓ.ም. ቀን ጳጳስ
እስኪያልቁ : ማስጠንቀቂያ ተቃጥለው ዘመን በመመረጥ ተቋም
መታገስ : ፖርትሬት በፈጠረህ ያፈዘኛል እየታደለ በተንሰራፋበት
ያቃተው : ተፈተለከ ይዘጋጉታል የምሩ ያለፉ በመሆንም
ሾፌራችን : የተገነዘቡት እንዲሁም ቀን ጥር ጳጳስ
ከአንደኛው : በጥያቄ በየፌርማታው መምራት በመሆንም ጥር
አፍ : ልጃቸው ከተማ የላዛሪስት ቀን ጥር
እላፊ : የሚሰጠው ጓደኞቹ ታሪክና ሜንዴዝን በመሆንም
ይነጋገራል : ለእውነት በየመንገዱ ታሪካዊ እየታደለ ብርሃነየሱስ
ታክሲ : ጠብቅ የሚመስለው ሕይወት ያደለው ሠርግ
አያጅብ : ይፈጥራል መስለው እያሽከረከረ ሮጦ ስትል
ያለው : ዓይነቱ አዎ እርግማኑን እናንተና ሊቀመንበር
ማን : ለመድረስ አገር በፊት በመሆንም #
ግድ : ለምሳሌ ተያይተው ስንቶች የሚያስቡትን መንገዱን
የለም : እንዳታደናቅፉ ካጨዱና ከመርካት ከሚል እነሆ
ይኼን : ተከታትለዋል ጥቂቶች የጀመረችው ቀን ጥር
የኪራይ : ድርሻ የምለው በፊት በመሆንም ተተኪ
መኪና : ከመሰብሰቢያ በሽሬ ውይ ሁሉን አትሌት
መልሰህ : ልደት ጉዞ የሚጠራ ከተማው በመሆንም
ሠልፍ : በመቅሰም እይታ እንዳታደናቅፉ አከሽፍበታለሁ ስብከት
ስትይዝ : አቃጥላችሁ ስማ ስትሆን ረቂቅነቱ ብትን
እንገናኛለን : አይሃለሁ ያውስ ይናገራል መንገዱን ከእነዚህም
ከአጭር : የሚገርመኝ ጣይቱ ልቦናውን የምለው ታክሲያችን
ተድላ : ኤምባሲ በኢትዮጵያ ዓ.ም. ቀን #
የረጅም : ከመቼውም ካላችሁ የአብሮነታቸውን ከተማው በፊት
ጉስቁልና : እንኳ በኢትዮጵያ በሊቀመንበርነት በመሆንም ቀን
ሲያስመካው : ተመልሶ በሽንጣም ነው ከቦሌ አልፎንስ
እናያለን : የትኛው ዘወር የእቴጌ ሽር ኢትዮጵያውያን
ትዕይንቱ : እንዳደረጉላቸው ጆሮው የምለው ከቦሌ በሊቀመንበርነት
ከዚህና : ማኅበራት አያችሁ ይለኛል ያጨለመበት ከዚህ
ከዚያ : ለመምጣት እሳትና ጣይቱ መምህርም በፊት
እየተሳፋ : ዘወር እሺ ዓ.ም. ቀን ጳጳስ
በመገረም : ወረቀት ከተማው ፓትርያርክ በፊት በመሆንም
ሰቀቀን : ከታች እንስት እንዳታደናቅፉ የነበረን ከመንፈቅ
በፈገግታ : ጆሮው አይሃለሁ በዚህ ከሚል ከተማው
ሐዘን : አለባቸው ፋሲሊቲ ተስማሚ ስደውልልህ ይጭናል
ይሸምናል : ይገርማል ያደረጋል መንገዱን ይታወቃል በመሆንም
የራቀንን : ትርፋማ የሆነ ባለቤቱን ቤተ ሲሆኑ
ልንደርስበት : እጥፍ ውጤት መልስ ባለቤቱን በፈገግታ
ያመለጠንን : ተሳፋሪዎች ሙሽራ በኋላ በፊት ተተኪ
ልንይዘው : ሳናረጋግጥ ታዳጊ ሀገረ ቀን ጳጳስ
አስበን : ክትትል የሚያደርገው በመሠራቱ ያጨለመበት እያልኩ
መንገድ : ጠብቀው ከመሆን ተቋም ጠቅላይ በመሆንም
ብንጀመርም : ሆቴሉን ያለነው መንገዱን በኋላ ዓ.ም.
ሕይወት : እንቃጠል ሰኔ በመሆንም ጥር ጳጳስ
ናትና : አለህ የሚጠራ ከቦሌ መምህርም ተተኪ
በየፌርማታው : አንዳንዱን ታሪክና ከተማው በመሆንም ቀን
አዲስ : አስቡት እንደዚህ የሰለቸን እየታደለ ዓ.ም.
ድር : እጥፍ ያደገው በሊቀመንበርነት ቀን ጥር
ታሪክና : የሚሰጠው በየፌርማታው ፍርድ መድኃኒዓለም መምህርም
ትውስታ : ልባቸው እየተሳፋ አበባ ዓ.ም. ጳጳስ
እንፈጥራለን : ከሆኑ ትለኛለህ የረጅም ያጉረመርማሉ ደግሞ
ጎዳናውና : አሽከርካሪ ጣይቱ ይዘጋጉታል ዓ.ም. ቀን
ፍጡራን : ቆመች እርስ አጃቢ መለኮት ከሲመተ
በጊዜና : በዓይን ያያል ጥር ጳጳስ
በሥፍራ : የእኔ የበይ አልሽ ሰኔ ዓ.ም.
ተገድበው : የማኅበራዊ ስድስት መስለው ፍረዱኝ ሳንገብርና
የሆኑትንና : የሚጠራው ያጉረመርማሉ ክፍለ መለኮት በመሆንም
ያልሆኑትን : መምጣታቸውን ወይስ ቢሸጡ እናት ፍርድ
የሚያጣሩበት : አፍሪካ በፊት ቀን # ጳጳስ
ወንፊት : እንኳ አትሌት ቆይ ክርስቲያኒቱ እንዲሁም
የሚመስለው : ትምህርት ጣይቱ ሊቀመንበር ከመሠረቱት ሰኔ
ያልተረጋገጠው : ሆቴላችን መለሰና በየፌርማታው ይጋባበታል ካላስቀደማችሁኝ
ብዛቱ : አይደሉም አፉ አይገርማችሁም የሚዘምቱት ይታወቃል
ጉዟችን : አምስት ይሰውራችሁ እየተሳፋ አበባ ጳጳስ
ተጀምሯል : ከአራት ስላጠረን የተቀመጠው በኢትዮጵያ ክርስቲያኒቱ
ከሾፌሩ : አዛውንቷ ሕይወት ስብከት ሰኔ በመሆንም
ጀርባ : ይላል ተቋም በመሆንም ሲሆኑ የአዲስ
እናትና : ቆይቶ በርሳቸው ክርስቲያኒቱ ቦንጋ ጳጳስ
ጎረምሳ : እናመጣልዎታለን በደህና በኋላ በፊት ቀን
ልጃቸው : አዛውንቷ ይጋፋል እየታደለ አፍ የሚያስቡትን
አሉ : ጀመረች እሠራለሁ አለኝ ይታወቃል ሰኔ
በዚህ : ቁርስ አዎ ከተማው ቀን #
ዕድሜ : ፍረዱኝ የሚያስመካበት አበባ ዓ.ም. ቀን
ምን : የማኅበራዊና የመረጃ እየተቀባበሉ መንገዱን ነው
አለኝ : ያደረጋል ይታወቃል ቀን ጥር ጳጳስ
ያውስ : ይህም ከዚህ አልፎንስ ዓ.ም. ቀን
ውጥንቅጡ : ቅርብ ፀሐይን አበባ ቀን #
በወጣ : ሲያጉረጠርጥ ሲያስታጥቋችሁ አለው የተቀመጠ ከተማው
እንደ : ሳያውጁ ያህሉን ዙሪያ ከተማው መድኃኒዓለም
ባህር : አንቺ መንበር በፊት # ጥር
ማዕበል : የሚነጋገረው የሚጭሩት ከመርካት ጥር ጳጳስ
ባነፈሰው : ተቋም የጂማ በመሆንም ዓ.ም. ቀን
አቅጣጫ : ግልጽ እንቃጠል ያጨለመበት ብርሃነየሱስ በፊት
እየተወራጨ : ድረስ እንዴ ሕይወት ይልቅ ሆነዋል
እያየሁ : ይኼኔ ባረባው ተመልካች እስኪ እየታደለ
እሠራለሁ : ይታወቃል ግንቦት ሰኔ ጥር ጳጳስ
አንተ : አዎ ያየህ በዚህ ከዚህ ተተኪ
አለህ : ዜናዊ እሺ አልሽ ከሚል ብርሃነየሱስ
ብዬ : ሪፖርተር * ተተኪ ዓ.ም. ቀን
አይደለም : አድርጐታል ነው ይታወቃል ዓ.ም. ቀን
ትምህርትህን : በጎዳናው አንዳንዱን አንተ ቦንጋ ተተኪ
ጨርሰህ : ካሬ እየታደለ በሊቀመንበርነት ሰኔ በመሆንም
ስትሆን : ይበላለጥ ስትይዝ ከመሆን ጠቅላይ በመሆንም
አይሃለሁ : እንገናኛለን በሊቀመንበርነት በፊት ሰኔ በመሆንም
እያልኩ : ባለቤቱን ጣይቱ ያውስ አልሽ ኤምባሲ
እንጂ : ሁሌ ሌላው በመሆንም ጳጳስ
ከእንግዲህ : በያዘችው የሚጠራ ከተማው በመሆንም ተተኪ
የነፍሴ : ቅርብ የበይ ተሳፋሪዎች ከተማ የላዛሪስት
አልነበረም : ታዋቂ በተለይ እናትና በርሳቸው በሊቀመንበርነት
ሊያሳስበኝ : ተብሎ መጠን እናመጣልዎታለን በሊቀመንበርነት #
የሚገባው : አድርጐታል ይችላሉ ይታወቃል ሆነዋል ሰኔ
ሲነግሩህ : ሰጥተን አንዱ ትላለች ያውስ ዓ.ም.
ስማ : በነፍስ ስትይዝ ብትን ተቋም በመሆንም
አታቃጥለኝ : አራት ሴራ እናትና በመሆንም ተተኪ
ይሉታል : ሲሉ የተቀመጠ ቦንጋ ጳጳስ
ጉርምስና : በአኳኋኑ ስንቶች እርስ አፍሪካ በፊት
ዓይነ : መሳይ በሽንጣም ድካም ቤተ አልፎንስ
ልቦናውን : ተጠያቂነት በደህና ከአጭር ኤምባሲ በሆኑ
ያጨለመበት : ጉዞ ያህል ተቋም ሰኔ ዓ.ም.
ታዳጊ : ፎርም ቀዘባ ጣይቱ አፍሪካ ሰኔ
በንቀት : ዓመቷ ይህም ማንና ብለው ከቀረን
ያያል : ነን ይጋፋል ይጥፋ በማገልገል ጥር
ከእነሱ : ባዩት ብለን በሽብር ከሾፌሩ የሚያስቡትን
አጠገቤ : ካጠገቤ ቆይ ዓ.ም. ቀን ጳጳስ
የተቀመጠ : አንጎል # ጳጳስ
ጎልማሳ : ዲግሪያቸውን በዕድሜ ሙሽራ መካከል የላዛሪስት
ልብ : ከምትኖርበት ጣይቱ በዕድሜ በመሆንም ቀን
አመሻሽ : ተገምግሞና ሙሽራ በመሆንም ዓ.ም. ቀን
እየታደለ : ዘርግተን ጣይቱ ሰኔ ጥር ጳጳስ
እኮ : እየጠበቅን የሚያዝ አስታኮ በፊት ሰኔ
ስንቱ : አይሃለሁ ተከታያቸው በተለያዩ ከእነዚህም በፊት
ሳይሆን : ተረፈ የሚሆኑት እንደሚጠቁሙት ስብከት በመሆንም
አገር : ለመድረስ አፍሪካ በፊት በመሆንም ዓ.ም.
ቀረ : ነኝ ተከታያቸው ከእነዚህም ቀን #
ይለኛል : ካጨዱና ስብከት ተተኪ ዓ.ም. ቀን
በዕድሜ : በመሆንም ዓ.ም. ቀን ጥር ጳጳስ
አስታኮ : የተቀመጠችው አልሽ ቆይ ሰኔ ዓ.ም.
መንግሥት : ከሌሎች የዓለም ፍጡሮች የሰለቸን ተተኪ
የመግባት : ሊሞዚን በሊቀመንበርነት በፊት ሆነዋል ቀን
ሙከራውን : ተሥለው እየተቀባበሉ ሌላው ቀን #
በዝምታ : መልሰህ በልቶ ላይ መምህርም ተቋም
አከሽፍበታለሁ : ሠልፍ አልሽ ሰኔ ካርዲናል ዓ.ም.
ሴትዮዋ : አቃጥላችሁ ስማ ስትይዝ ማኅበር *
ሲሉ : ይሉታል ጎረምሳ ወጣት ጳጳስ
ጆሯቸው : እርስ የምለው ዓ.ም. ቀን ጳጳስ
የቆመ : እናትና ቦንጋ ቀን ጥር ጳጳስ
የተሰየሙ : ተንደረደረ ሳይቆጥሩ ሲሆኑ ቀን ጳጳስ
ስለታሪካዊው : በነፍስ አስገባ እንዳለመታደል በዕድሜ ያደለው
የእቴጌ : በሽብር የሚዘምቱት ታክሲያችን ጵጵስናቸው በመሆንም
ጣይቱ : አዎ ያለረፍት ነገር ከተማው በፊት
ሆቴል : ማሳያ በላይ ካሬ አፍሪካ በፊት
ቃጠሎ : ከዚህም ከተማው እስከ ክርስቲያኒቱ በሊቀመንበርነት
መጫወት : የማላሠራለትን ቆይቶ በሊቀመንበርነት ቦንጋ ሰኔ
ጀምረዋል : ሙሽራ መካከል በመሆንም ተተኪ ቀን
አንደኛው : ለሚያርፉት ሞቱ ቤተ እንዲሁም ቀን
እቴጌይቱ : አመለካከት እንግዳ እናመጣልዎታለን ካልተሠራ ታክሲና
በቁማቸው : እንዳለባቸው ተብሎ ወይስ እንባ ልሙትላቸውና
ተቃጥለው : ያድናችሁ እንዳታደናቅፉ ዘመን ሊሎንግዌ ዓ.ም.
ሞቱ : ተኮሳተረ መቼስ አንደኛው መካከል ዘመን
እንዲችው : ያድናችሁ የለም በሽንጣም ከሚል መንገዱን
ልባቸው : የሚጠራው አለህ በየፌርማታው መምህርም በመሆንም
እየሩሳሌምን : አሜን ተኮሳተረ እስር አመሻሽ ሁሉ
እንደተመኘ : ሲያነበንብ እንዲሁም አበባ ዓ.ም. ቀን
ለሥልጣን : እያዥጎደጎደ በልቶ ይመራሉ መምህርም ሰኔ
በተሻኮቱ : ሬስቶራንቶች የዚህ ከተማው ግንቦት ተቋም
ሰዎች : በሚታይበት አጠናቅቆ በከፍተኛ ካላችሁ ኢትዮጵያውያን
ሴራ : ቁጭ ገልቱነት መተዋወቅ ተተኪ ዓ.ም.
በቁም : ትላለችሁ አንቺ * # ጥር
እስር : ፍረዱኝ አመሻሽ አልፎንስ ቀን ጳጳስ
እንዳልተንገላቱ : የሚገርመኝ ታክሲያችን ቀን ጥር ጳጳስ
ዛሬ : እንድንቀበል ኖሮ ካጣችሁም ይዛ አንዱ
በስማቸው : ሆኖ እንባ ካጠገቤ ልጅ ሲሆኑ
የሚጠራው : ክፍለ ጳጳስ
የአገራችን : ወርልድ ተገዝተው በል ፓርቲ ያደገው
የመጀመሪያው : ታክሲዎች አዲስ ዓ.ም. ቀን ጳጳስ
ተቃጠለ : ሰጥተን እንዲችው ሜትሮፖሊታንን መንበር በሊቀመንበርነት
መቼስ : ለመሆን ጣይቱ በመሆንም # ጥር
እሳትና : እንግዳ የሸለመው ቅርብ ፀሐይን በፊት
ሞት : ሙሽራ ከተማ ሰኔ # ጥር
ቅድመ : ልሙትላቸውና አዎ ረቂቅነቱ በመሆንም ካርዲናል
ማስጠንቀቂያ : እናሟላለን እንዳታደናቅፉ ወጥታ ይመስል ከሚል
መቼ : ላጋጠማቸው የሚሸለም ጥላቻና ስትል በሊቀመንበርነት
ያውቃሉ : ይገኙበታል እሠራለሁ ይታወቃል ከጀመሩ ነበሩ
ያደረጋል : ይገርማል አለኝ ይታወቃል ቀን ጥር
ይላል : ጀርባ ተቋም በአዲስ ዓ.ም. ቀን
ከጎኑ : ሾፌሩን ይመስል ሌላው ዓ.ም. ቀን
የተሰየመች : ሲያዳምጥ ዓመታት በፊት በመሆንም ዓ.ም.
ቀዘባ : ነጋሽ ውይ ምንድነው በአኳኋኑ ታሪካዊ
ተቀብላ : እኔ መምራት ነበር የፍልስፍናና ሆነዋል
እንኳን : ኧረ አይሃለሁ በሊቀመንበርነት በፊት በመሆንም
መብራትና : ካሬ ሳንባ እንዳታደናቅፉ አንዳንድ የኢትዮጵያና
ውኃስ : ካልተገፋፉ የሚጠራ ይዘጋጉታል ይታወቃል በመሆንም
ሲጠፉ : ማስጠንቀቂያ አለኝ የተቀመጡት የላዛሪስት ሆነዋል
ያሳውቃሉ : ነው ቀን # ጳጳስ
ትለዋለች : እነሆ ዓ.ም. ቀን ጥር ጳጳስ
ተቻኩላ : አያችሁ እባክህ የሚጠራው አስታኮ የጂማ
የሚገርመኝ : መለሰና እንዳልተንገላቱ የምለው ግብግብ ታክሲያችን
ሌላው : አትሌት ከተማው የምለው ቀን #
የዚህ : ፖርትሬት ከተማው ዘመን ዓ.ም. ጥር
ታሪካዊ : ሁለት ቱሪስቶች ወያላው ቦንጋ ተተኪ
ቅርስ : አሜን በመሆንም ቀን ጥር ጳጳስ
በእሳት : መማማር ይለኛል እየታደለ ግብዣ ይልቅ
መውደም : ደግሞ በመሆንም ጳጳስ
ሳያንስ : የአፍሪካ ነኝ ሒሳብ የሚያስመካበት መተዋወቅ
በጭፍን : ነውና ብትን ከእነዚህም በፊት ሆነዋል
ጥላቻና : መለኪያዎች ካልተሠራ የሚሸለም ከሚል በፊት
አሉባልታ : ስፋታቸው ያስገኛል ድካም ከተማው ነው
ተመሥርተው : የሚያደርገው ስደውልልህ ያደረጋል መምህርም ዓ.ም.
የሚያጫርስ : እያውለበለበ ካላችሁ ስብከት በመሆንም ቀን
ሰደድ : ለሌላ እነሱ ተንደረደረ የአዲስ ቀን
እሳት : በሕገ በተለያዩ ላይ ቀን #
የሚጭሩት : አለህ ነውና ከመርካት ጳጳስ
አይገርማችሁም : ትላለችሁ ሠርተዋል ጉዞ ኖሮ ጣይቱ
ብሎ : መቼም ይላል ከመንፈቅ ዓ.ም. ጳጳስ
እጁን : እየታደለ ማን በ# ተተኪ ጥር
አፉ : ቁርስ አለህ በዚህ አልሽ ይናገራል
ይጭናል : ሲለን ይናገራል ከመርካት ከተማው ዓ.ም.
የሰው : የቀረው ተከታያቸው ከእነዚህም ቀን #
ልጅ : ሳንባ በልቶ ኤምባሲ ሲሆኑ ዓ.ም.
የነገር : ሦተኛው ቀን ጳጳስ
የማድራት : በልቶ ቀን # ጥር ጳጳስ
ክህሎት : ሞት ይልቅ የላዛሪስት ዓ.ም. ቀን
እውርን : የተማሩት ጳጳስነት መምህርም ጳጳስ
ባለብርሃን : በእሳት ባይ ቤተ * አበባ
ከሚያደርግ : ከመሠረቱት በመሆንም ቀን ጳጳስ
አስደናቂ : የሀብታም አንድ ከ# ከተማ ቀን
ተዓምር : ጅምሮች ማትረፉ ሜትሮፖሊታንን መንበር መምህርም
እኩል : አተረፈህ እባክህ ቤተ በመሆንም ተተኪ
ያፈዘኛል : የሚገርመኝ ከተማው በሊቀመንበርነት ተቋም ቀን
በአኳኋኑ : ጣራው ድርሻ ቆይ ከተማው የምለው
ይኼ : ፈጥሯል ሆነዋል ጥር ጳጳስ
ይገርማል : ያደረጋል ይታወቃል ቀን ጥር ጳጳስ
ዘመኑ : ከዚህ ቀን # ጥር ጳጳስ
እንደሆነ : ሥራውን ባለቤቱን የሚጠራ የመጀመርያው ቀን
የአጥፍቶ : ፅኑ በጭፍን የሚጠራ ይዘጋጉታል ጳውሎስ
ጠፊዎችና : የነበረውን የሆነ ድርሻ ጥላቻና ሠርግ
አሸባሪዎች : እንዳዩት በማላዊ የላዛሪስት ጳጳሳት በመሆንም
ሆኗል : የሚሆኑ ይጥፋ ሰኔ ጥር ጳጳስ
እንዳለመታደል : አለኝ አንዲት መጨረሻ ተቋም ቀን
ሆነና : ይጭናል መታገስ ከመርካት የምለው በሊቀመንበርነት
ሥልጣኔን : በተለየ የነገር ከተማው በሊቀመንበርነት የኢትዮጵያና
ደረስኩብሽ : ለወያላው ነበራቸው ሀገረ በመሆንም ቀን
ሲላት : ታነሳና በደህና ሒሳብ በልቶ እንዲሁም
ገልቱነት : እሺ እንዳታደናቅፉ በሊቀመንበርነት የላዛሪስት ዓ.ም.
ተመልሶ : ሙሽራ በኋላ በፊት ሰኔ ተተኪ
አልቅሶ : ቱሪስት አትሌት ያፈዘኛል ማርያም አበባ
ይወለዳል : እሺ ያቆምነው ብርሃነየሱስ በመሆንም ዓ.ም.
ስለዚህ : እንደሚገባና ሌሎቻችን በ# # ጳጳስ
የእኛ : በቀኝ ይህም ነገር ቀን #
ድርሻ : ማሳያ ሠራሽ ቅርብ በፊት በመሆንም
ውኃ : ከሌት እናንተና ዕድሜ በፊት ሰኔ
መሆን : እስር የራቀንን በመሆንም ሲሆኑ ቀን
ይመስለኛል : እሠራለሁ ይታወቃል ግንቦት ሰኔ ዓ.ም.
ትላለች : ለበለጠ በዕድሜ አንተ ረቂቅነቱ ሥልጣን
ሦስተኛው : ፍለጋ ሦተኛው የሚጠራ በሊቀመንበርነት በመሆንም
የተቀመጠች : ይናገራል ይልቅ ከተማው በሊቀመንበርነት ዓ.ም.
ወይዘሮ : ቀዘባ ስንቶች ቆይ እነሆ ቻንስለርም
አንዴ : ሠርተዋል በመመረጥ በመሆንም ዓ.ም. ቀን
እስኪ : ቅርብ ጣይቱ እየታደለ በመሆንም አበባ
የአቶ : ይለኛል ቀን ጥር ጳጳስ
ከበደ : ድርሻ በፊት ተተኪ ዓ.ም. ቀን
ሚካኤልን : በመሆንም ቀን ጳጳስ
ግጥም : ተተኪ ዓ.ም. ቀን ጳጳስ
በቃሉ : ጣራው ቀን ጥር ጳጳስ
ሸምድዶ : ልሙትላቸውና ነበርም የማላሠራለትን ያላደለው #
ለክፍል : ማስጠንቀቂያ ረቂቅነቱ ቀን ጥር ጳጳስ
ጓደኞቹ : የዚህ ተቋም ጥር ጳጳስ
የተወጣ : አይሃለሁ ከመርካት በመሆንም ተተኪ ዓ.ም.
ያውጣ : አለው አለኝ ይታወቃል ቀን #
ሒሳብ : አንዲት መጨረሻ በመሆንም ተተኪ ካርዲናል
ወጣ : አለው ሦተኛው ወደ ቀን ጳጳስ
ሳይስበው : ድረስ መድኃኒዓለም ቀን # ጥር
ተኮሳተረ : ሞቱ ጣይቱ ሊቀመንበር ሊሎንግዌ ቀን
እናዓይኔን : ደጃፍ እግረኛ ጓደኞቹ የአቶ ተቃጥለው
ልታወጣው : ማሳያ የሚያሳፍርም ሲቀረው በፊት ዓ.ም.
እናንተና : ከምትኖርበት ወደዚህ ማንና አዎ በዚህ
ደርሳችሁ : ወደዚህ እናንተና የመግባት ተቋም በመሆንም
ሳንገብርና : ተገድበው ስንቶች ቆይ ነው ጳጳስ
ሳይርበን : የባግዳዱ የመግባት ምን ሆነዋል ተተኪ
የምንኖር : ያሉ የቀረው ሁለተኛ ጠበንጃ የእኔ
ታስመስሉታላችሁ : ጥቂቶች በስማቸው ሲሆኑ ዓ.ም. ጥር
በልጃቸው : ሊያሳስበኝ ሕይወት በሊቀመንበርነት ብርሃነየሱስ ዓ.ም.
የበገኑት : በሉ መካከል ዘመን በመሆንም ቀን
እናት : ከተመራ መመራት ሄደው መምጣታቸውን ሠርግ
አንባረቁበት : አፉ አይሃለሁ የምለው እየተንቀሳቀስን በፊት
ደንግጦ : ካልተሰረቀም የረጅም ክፍለ መምህርም ቀን
ተንደረደረ : የተሰየሙ በፊት ቀን ጳጳስ
እዚያ : ተጠያቂነት የሚገርመኝ መንገዱን በኋላ በፊት
አንዱ : ለበለጠ ደክሞዎታል ሲነግሩህ ይጥፋ ከተማው
ስልክ : ቀጥሎ የምናየውና መምህርም ብርሃነየሱስ በመሆንም
እያናገረ : ሠርቷቸው በሽብር ከመሆን ተቋም በመሆንም
ጠብቅ : ታክሲ ኤምባሲ ኢትዮጵያ አበባ ቀን
ይሰጥሃል : ይመራ አያጅብ ይገጥማል እኔን ክርስቲያኒቱ
ይለዋል : ለመሆን አስመስለው በአኳኋኑ ቆይ ይጥፋ
በምልክት : ዘወር መጨረሻ ከተማው ቀን #
ሁሌ : እናሟላለን አስደንቀዋታል የዚህ በሊቀመንበርነት በመሆንም
ስደውልልህ : አጠገቧ እንዳታደናቅፉ አንዲት ዓ.ም. ቀን
ሥራ : ተመልሶ ሲያስመካው ከተማው ነው ሰኔ
ነኝ : መዋኛ የትውልድ ተስማሚ ዓ.ም. ቀን
ትለኛለህ : ፖርትሬት የሰለቸን በፊት ተተኪ ዓ.ም.
ብቻውን : ያፈዘኛል ጣይቱ የረጅም ታክሲያችን ተቋም
ሮጦ : ለምሳሌ የማትሠራው በሊቀመንበርነት ብርሃነየሱስ ሰኔ
የሚሸለም : ቡና ረቂቅነቱ ተቀምጠው ዓ.ም. ቀን
አትሌት : ቆይ ይጥፋ ከተማው ቀን ጥር
ያየህ : አንተ በሊቀመንበርነት በመሆንም ተተኪ ዓ.ም.
ይመስል : እንዳታደናቅፉ በዚህ ይናገራል ከተማው ዓ.ም.
የት : ወርልድ ያዘ ሁሉን ቦንጋ በመሆንም
ለመድረስ : አገር በፊት በመሆንም ዓ.ም. ቀን
በስልክ : ጋቢና ቆመች ተተኪ ዓ.ም. ቀን
የሚነጋገረው : መተዋወቅ ዘመን ዓ.ም. ጥር ጳጳስ
ተሳፋሪ : ዘርተን የእቴጌ የሚዘምቱት ሠርግ ቦንጋ
ጥቂት : አመሻሽ ያጉረመርማሉ በመሆንም ዓ.ም. ቀን
ቆይቶ : የተቀመጠች እንዳልተንገላቱ ጎረምሳ እናትና ጉንፋን
ኤድያ : አስመስለው ያደገው ቀን ጥር ጳጳስ
ተወኝ : በረባ ተተኪ ዓ.ም. ቀን ጥር
እባክህ : አያችሁ ተቻኩላ ጣይቱ በመሆንም ተተኪ
እኛን : በመሆንም ካርዲናል ዓ.ም. ጳጳስ
የሰለቸን : የእነሱን ትለኛለህ ተተኪ ዓ.ም. ቀን
ባለቤቱን : ስንጠየቅ የማርኬት ሁሉን እያልኩ ልንደርስበት
ሌላውን : ቁርስ አፉ በዚህ ጎረምሳ ይኼን
የማያካትት : ባለአምስት ፀሐይን ጓደኞቹ በቁም ሙሽራ
ለውጥ : ጣይቱ ያማርራል ማኅበር በፊት በመሆንም
ሁላችን : ያልኩት የሚል በመሆንም ካርዲናል ዓ.ም.
ዘርተን : ለወያላው ይመስለኛል ጣይቱ ሠርግ ግንቦት
ጥቂቶች : ባለችው እንዳታደናቅፉ ይኼን ስሙልኝ ከሚል
ብቻ : አድርጐታል የተቀመጠች ዓ.ም. ቀን ጥር
ካጨዱና : ልሙትላቸውና ይለኛል ቀን # ጳጳስ
የበይ : እናመጣልዎታለን ተወኝ ጎረምሳ ሙሽራ ተተኪ
ተመልካች : ከበደ ማስጠንቀቂያ ያለው ሽር በፊት
ሆነን : ልሙትላቸውና ያፅናኑታል የሚነጋገረው ትለኛለህ በአኳኋኑ
ከቀረን : ቀዘባዋ ዋጋ እንዳለመታደል ሽር ቀን
ዋጋ : መሆናቸውም ይገርማል ያደረጋል በፊት በመሆንም
አለው : ተቋቋመ ያውጣ አለኝ ቀን #
ያለረፍት : ጣይቱ ቀን ጥር ጳጳስ
ከሌት : ሲቀረው እንደስላሴ ከእነዚህም በፊት በመሆንም
መልፋቱ : ያደረጋል ጣይቱ ነው ሞልቷቸዋል በተካሄደው
አንዳንድ : እንዳታደናቅፉ ቆይ በመሆንም ዓ.ም. ጥር
እፎይ : ከሚል በፊት ዓ.ም. ቀን ጳጳስ
ማለት : ጭፍን ተተኪ ዓ.ም. ቀን ጥር
ልመድና : እሠራለሁ ይናገራል ከተማው ግንቦት በመሆንም
ሻይ : የሚያወዳድሩት አታዳብሩ ገልቱነት የላዛሪስት በመሆንም
ቡና : የሚሸለም ብትን ተተኪ የአዲስ ዓ.ም.
እንበል : ከሚል በመሆንም ቀን ጳጳስ
ሲል : እያወጋን መድኃኒዓለም በተንሰራፋበት ጳጳስ
ወዳጁን : ከዚህም ረቂቅነቱ መተዋወቅ ክርስቲያኒቱ ተተኪ
ይመክራል : ዕውቀት ተፈተለከ ግን ይዘጋጉታል በሊቀመንበርነት
ሲያሳንፈው : ቆይ ከተማው በመሆንም ካርዲናል ዓ.ም.
ይሁን : የሚያውቅ በመገረም በሊቀመንበርነት ሆነዋል ጳጳሳት
ሲያሳርፈው : ይሆን ጀመር ይወቀው የአብሮነታቸውን በሊቀመንበርነት
የሚያውቅ : ሆኖ መቼ የሚያስቡትን ብትን ያደገው
ይወቀው : አምላክ ትዕይንቱ ነውና መጨረሻ ሊቀ
ሌሎቻችን : ማን በ# በፊት ዓ.ም. ቀን
ለወያላው : ዘርተን ይመስለኛል ደረስኩብሽ እንኳን ጨርሰህ
ሰጥተን : በመሥፈርት ባረባው ሲነግሩህ ነው ኅብረት
መልስ : ኢትዮጵያን ኬፕታውን ኤክስፐርቶች ፍጡሮች ውይ
እንቀበላለን : ረቂቅነቱ ጵጵስናቸው ዓ.ም. ቀን #
አፍታ : እንዳደረጉላቸው ከሚያደርግ ጨርሰህ በየፌርማታው በመሆንም
ሳይቆይ : ሲሠሩ የሚያስችል ዋንጫውን ይሆናል በመሆንም
ሰላማዊ : አይቀርም ይልቅ በፊት ካርዲናል ዓ.ም.
አደጋ : እየተቀባበሉ ምን ሙሽራ በፊት በመሆንም
ያንዣበበት : ጦረኛ መኪኖች በመሆንም ዓ.ም. ቀን
መሰለ : የሰለቸን ፍርድ መካከል ሲሆኑ ዓ.ም.
ፍጥነት : ጥጓን ተንቀሳቀሰች ማስጠንቀቂያ ከተማው ሞልታ
የነበረን : አድርጐታል ፀሐይን ሽር ቀን #
እጅግ : ትለኛለህ የኪራይ ሾፌሩ ተተኪ ጥር
ዘመናዊ : ሁለት እንደዚህ ሊቀ በመሆንም ቀን
ሬንጅ : ጣራው ታሪካዊ ቅንጡዎች ቀን ጥር
ሮቨር : ብትን በፊት ተተኪ ዓ.ም. ቀን
መኪናን : የተቀመጠችው መተዋወቅ ጥር ጳጳስ
ስትሸሽ : የመጀመሪያ ሙሽራ ይታወቃል ተቀምጠው የላዛሪስት
እግረኛ : ከሽብር እየተሳፋ ቤተ በመሆንም ዓ.ም.
ወጥታ : የእንግዳው በዚህ ዓ.ም. ቀን #
ቆመች : የመታጠቢያ የባግዳዱ ተተኪ ዓ.ም. ቀን
የአውቶሞቢሉ : ፈገግታ ከምትሞቱ የማኅበራችን በሊቀመንበርነት ሰኔ
አሽከርካሪ : ውይ አንዳንድ ሞት አለህ ሰኔ
ትንኝ : የበኩሏን ይመስል ታክሲያችን በመሆንም ካርዲናል
ባይኑ : በሊቀመንበርነት በፊት ሰኔ ዓ.ም. ቀን
የገባች : ሠራሽ በፊት ሰኔ በመሆንም የአዲስ
እንኳ : ጉስቁልና ክርስቲያኒቱ ብርሃነየሱስ ጳጳስ
ሳይመስለው : ክፍት አልፎንስ ተተኪ ቀን ጳጳስ
ሞባይሉን : ያለውም ረቂቅነቱ ታክሲያችን ኤምባሲ ስብከት
ጆሮው : በፈገግታ ከተማው በሊቀመንበርነት ሰኔ በመሆንም
ጣደ : ባህር አንቺ ኢትዮጵያ በተንሰራፋበት ተተኪ
ገላምጦን : የመታጠቢያ ዓ.ም. ቀን ጥር ጳጳስ
ተፈተለከ : ሲያስመካው ይዘጋጉታል የምሥራቅ ጵጵስናቸው ከሲመተ
የእኔ : ከሚል ይታወቃል ዓ.ም. ቀን ጳጳስ
የማኅበራችን : እናስቸግራችሁ ስትል ከመርካት በፊት ጵጵስናቸው
ታክሲዎች : የመጀመሪያው ይጥፋ ዓ.ም. ጥር ጳጳስ
በሙሉ : የሚጠራው ተቋም እንዲሁም በመሆንም ዓ.ም.
ቢሸጡ : ተያይተው ጥረትና አመሲያ ቀን #
የማላሠራለትን : ከዚህም በእሳት መጫወት ተተኪ ዓ.ም.
እያሽከረከረ : ጉዞ ይታወቃል በመሆንም ተተኪ ቀን
አሁን : በሽብር አንተ ከተማው በታች ዓ.ም.
ከእኔ : አለመመዘኑ የሚገርመኝ ያደረጋል ኤምባሲ በተንሰራፋበት
ይጋፋል : ያያል ልጃቸው ይጥፋ ብትን ነው
ፍረዱኝ : እናሟላለን ከተማው ተተኪ ቀን ጳጳስ
ይለን : የአብሮነታቸውን ጥር ጳጳስ
ጀመር : ፍጡሮች ግንቦት ሰኔ ተተኪ ጥር
አዛውንቷ : ልጃቸው በመሆንም ጥር ጳጳስ
ኧረ : እንኳን ከተማው በሊቀመንበርነት በማገልገል ዓ.ም.
እሱ : ሠርተዋል ለየው ይገርማል ይታወቃል በመመረጥ
አተረፈህ : ልጅ ጊዜ ተተኪ ዓ.ም. ቀን
አለበለዚያማ : ዜናዊ ያቆምነው ይወለዳል ረቂቅነቱ በመሆንም
ሲያገኝ : እንዴ እያለ መድኃኒዓለም በተንሰራፋበት ጳጳስ
ዓይኑ : በአገሪቱ ነጥብ ብትን ግብግብ የምሥራቅ
ከሚገለጠው : ፒያሳ መሥፈርቶችን እየተሳፋ ተሳፋሪዎች ኤምባሲ
የሚጨልመው : ያውስ የሚዘምቱት የላዛሪስት ቀን #
እንደበዛ : ከመሰብሰቢያ ጀመር ተተኪ ዓ.ም. ጥር
እናውቃለን : ወክዬአቸው በመሆንም ጳጳስ
ልቦና : ለምሳሌ እንመጣለንና እኛን ጣይቱ ነገር
ይስጠን : ከሚል ሜትሮፖሊታንን መንበር ጳጳሳት ተተኪ
ብለው : እናሟላለን ፍረዱኝ በሊቀመንበርነት በማገልገል ከተማ
ያፅናኑታል : ልሙትላቸውና ሆነን ሊሎንግዌ ቀን #
ትከሻ : ውይ ለመድረስ በአኳኋኑ ማን አፍሪካ
ለትከሻ : የሠራተኛ ከሌት እናዓይኔን ከመሆን ቤተ
ካልተገፋፉ : በላይ በመሆንም ቀን ጳጳስ
መሆንና : አጠገቧ የቀለለው ሴራ ስትሆን በመሆንም
ሠርቶ : የወደድነው ከተማው በሊቀመንበርነት የኢትዮጵያና ቦንጋ
ማደር : ዘርተን ረቂቅነቱ በመሆንም ዓ.ም. ቀን
ጡረታቸው : ሽር ቀን ጥር ጳጳስ
መከበሩ : ማዕበል ክርስቲያን ብርሃነየሱስ ከሲመተ ዓ.ም.
ተሳፋሪውን : ጉዞ ሳንባ ባነፈሰው በመሆንም ፃድዋ
እያበሳጨው : ሪፖርተር እንደስላሴ ይልቅ በቫቲካን ኅብረት
ተንቀሳቀሰች : ፍጥነት በመሆንም ዓ.ም. ጳጳስ
ጎዳናውስ : በግራ በቀኝ በውስጣችን ባሮች እየታደለ
ገና : የሚለው የነበረውን መሥፈርቶችን መልስ ልጅ
ብዙ : በዚህም መቼም ያህል ዓ.ም. ቀን
ሳያስተዛዝበን : ዙሪያ ሲያዳምጥ ጥቂት አልተናገራትም ልታደርገው
አይቀርም : ሰላማዊ ሽር ሞልታ ሆነዋል የመጀመርያው
ከመጀመሩ : ስላጠረን ምን ተጀምሯል ሙሽራ በኢትዮጵያ
ወዲያው : ሪፖርተር መሰለ ሠልፍ ይነጋገራል ይልቅ
ጥጓን : ፍጥነት ሞልታ ሦስት ዘመን በፊት
ይዛ : እንግዳው እየተንቀሳቀስን የጀመረችው እስከ ቀን
ወያላውና : ባለው ሲያነበንብ ቀን ጳጳስ
በዓይን : ዞሮ ጥር ጳጳስ
ተያይተው : ቢሸጡ ካጨዱና ግንቦት በመሆንም ዓ.ም.
የቆምንበትን : በየቀለበት ማስጠንቀቂያ ሞት የ#ቱ ሊሎንግዌ
ምክንያት : በዕድሜ እየታደለ ብርሃነየሱስ በፊት ሰኔ
አውቀዋል : ብሎ እንኳን በመሆንም ዓ.ም. ጳጳስ
ጋቢና : ካጠገቤ በስልክ ከጎኑ አጠገቤ ከመጤፍ
የተቀመጡ : እንዳታደናቅፉ ትለዋለች ያለፉ በመሆንም ቀን
ሴትና : አስመስለው ወጣት መሆኑ አፍሪካ በፊት
ወንድ : ካርዲናል ዓ.ም. # ጥር ጳጳስ
ምንድነው : እ ያቆምነው ቀዘባ እየታደለ ሆነዋል
እያሉ : ምክንያቱም ብለን ረቂቅነቱ ከሲመተ ዓ.ም.
ሾፌሩን : ከጎኑ ጊዜ የአብሮነታቸውን ከተማው ተተኪ
በጥያቄ : ከአንደኛው በመሆንም ጥር ጳጳስ
ሲያዋክቡት : እንኳ ሥልጣኔን ሊሞዚን የኢትዮጵያና አለቃ
ራዲያተሩ : ዙሪያ አረጋግጠው ቀን # ጥር
ስለተቀደደ : ከአቶ አስኪያጅአቶ ቆመች መብራትና መምህርም
ያፈሳል : ሲቀረው በመሆንም ቀን ጥር ጳጳስ
እናስቸግራችሁ : በአገር የማኅበራችን በመሆንም ዓ.ም. ቀን
ውረዱ : ድንጋይ አፉ ይገጥማል ካላስቀደማችሁኝ ደረጃ
ያግባባቸዋል : የሚሆኑ እንበል ከሚል ከተማው ግንቦት
ትዕይንቱን : ተወግዶ ፍርድ ግንቦት ሥልጣን መምህርም
በአትኩሮት : በደህና ከዚህና የፍልስፍናና በፊት የአዲስ
እንከታተላለን : የሚጠራ እየተንቀሳቀስን በፊት በመሆንም ተተኪ
ከመቅጽበት : ጎዳናውስ አሽከርካሪ ልታወጣው ገልቱነት መምህርም
እንዳዩት : ስፋታቸው ከቀረን በፊት ቀን ጳጳስ
ፅኑ : ማሳያ የአጥፍቶ ብሎ ቃጠሎ ጣይቱ
ጠጪነቱን : በመሥፈርት ሲታይ ባንኮኒ በየፌርማታው ጥር
መመስከር : ሌላውን አረጋግጠው ሠርግ ከቦሌ ቀን
የሚችሉለት : ሒሳብ በተሻኮቱ እስከ በፊት ዓ.ም.
ምርቃትና : ሁሉ ግብግብ በመሆንም ተተኪ ጳጳስ
እርግማኑን : ነው ቀን ጥር ጳጳስ
እያዥጎደጎደ : ለሥልጣን የሚያጣሩበት ያደገው የጀመረችው የፍልስፍናና
በተከፈተ : ከእነሱ በልቶ ሀገረ በመሆንም ተተኪ
መስኮት : እኮ በመሆንም ተተኪ ዓ.ም. ቀን
አንገቱን : ከጀመሩ በማላዊ በመሆንም ቀን ጳጳስ
አስገባ : ካላችሁ ጥረትና በኋላ በፊት በመሆንም
ወዮላችሁ : ካላችሁ ሱባዔ የሰለቸን አለህ ሜትሮፖሊታንን
ግቡ : ጭፍን አዎ ከተማ ተተኪ ዓ.ም.
አንገት : በሪሴፕሽን እንቢ ቃጠሎ ቤተ በመሆንም
ማስገቢያ : ካላችሁ አፉ ካላስቀደማችሁኝ ቀን ጳጳስ
ጎጆ : ሳንባ በልቶ ያደገው መምራት ሆነዋል
ካጣችሁም : ከመርካት ሀገረ ዓ.ም. ቀን ጥር
ሱባዔ : ጉድጓድ ወዮላችሁ ስብከት ካርዲናል ቀን
እንቢ : ሳንባ አስገባ ልጃቸው እነሆ ዓ.ም.
ካላችሁ : ማስገቢያ ካጨዱና ጎረምሳ ብርሃነየሱስ ቀን
ጉድጓድ : ሱባዔ ተቀምጠው ካርዲናል ዓ.ም. ቀን
ለእኛ : አሸናፊ ለመረዳት በሽንጣም ቀን ጳጳስ
ፀሐይን : ድርሻ ይታወቃል በፊት ቀን #
ያወጣ : ሙሽራ ከተማ ጥር ጳጳስ
አምላክ : በሆቴሉ መሸሽ ፍጡሮች አለው ቅርስ
ለእናንተ : ጠብቀው ከቦሌ ቀን # ጳጳስ
የኮንዶሚኒየም : ለየው ያደረጋል ነው መድኃኒዓለም ያደገው
ዕጣ : ተጠናክሮ ልጅ ልታደርገው አጉል ኤምባሲ
ያውጣላችሁ : ሳይስበው ከተማው መድኃኒዓለም ቦንጋ ቀን
ሙዱ : በቁም # ጳጳስ
ካልተሰረቀም : ደንግጦ የምለው መንገዱን ይታወቃል ያደገው
ያውጣችሁ : ለካ እየታደለ ሲያስመካው ስብከት ቀን
እንደዚህ : ተገምግሞና ጉዞ ደጃፍ ወጥታ ይታወቃል
ታክሲና : ማንና ሞት ጣይቱ ፍርድ የጦርነት
ተቃዋሚዎች : ጭፍን ጠቅላችሁ ጣይቱ መምህርም ዓ.ም.
ትንሽ : ጥሩ በኢትዮጵያ ዓ.ም. ቀን ጳጳስ
ተራምዶ : ወደዚህ እናንተና ጥረትና ቤተ በፊት
ከመቆም : ዙሪያ ከምትሞቱ አለቃ በመሆንም ዓ.ም.
ይሰውራችሁ : መድኃኒዓለም ወደ ቀን ጳጳስ
ዞሮ : በዓይን ብትን ተከታያቸው ጥር ጳጳስ
በዳያስፖራ : ከመሰብሰቢያ ቦንጋ ቀን ጥር ጳጳስ
ስናሾፍ : ትሥላለች ሲደገፍ ድርጅቶች ከኤክስፐርቶቹ አስደናቂ
ታክሲም : ከሚል ብትን ተከታያቸው የመጀመርያው ጥር
አልፎላት : ይልቅ ዓ.ም. ቀን # ጥር
በየመንገዱ : ቅርብ መካከል በፊት # ጳጳስ
መንጎጨት : በመሥፈርቱ ያፈሳል በመሆንም ዓ.ም. ቀን
ጀመረች : እሠራለሁ አሉ ይታወቃል ሰኔ ጥር
ቆይታችሁ : የሰለቸን አንባረቁበት በአኳኋኑ በኋላ በፊት
በየቀለበት : በእርግጠኝነት ሞት እያልኩ ከተማ #
መንገዱ : ትለዋለች ሾፌሩ በተንሰራፋበት ሰኔ ቀን
ባንኮኒ : ጠየቋቸው ሳንባ ድርሻ የተሰየመች ብትን
ካልተሠራ : ከሌሎች እናመጣልዎታለን ቆይታችሁ ከሚል በመሆንም
ብላችሁ : የላዛሪስት ካርዲናል ዓ.ም. ቀን ጳጳስ
ልማት : ትላለች ጦረኛ የቤተ ጳጳሳት ዓ.ም.
እንዳታደናቅፉ : ያድናችሁ ከመርካት ዓ.ም. ቀን ጥር
አላቸው : ተቀምጧል አሟልተናል እናሟላለን ሰኔ ተተኪ
ቀልቡን : ትላለችሁ የታየው ለሽልማት ይበላለጥ ያቆምነው
እኛ : እስር ላይ ቀን # ጥር
መለሰና : የሚገርመኝ እንዳልተንገላቱ የሚጠራ ካላስቀደማችሁኝ ታክሲያችን
ያቆምነው : እ እሠራለሁ ይታወቃል ሆነዋል ጥር
አዎ : ከምትኖርበት ጣይቱ አንተ ተተኪ ዓ.ም.
ሱፐር : ስሜትና ከእኔ እኔ ዘመን ሀገረ
ማርኬት : ግርግሩ ጎዳናውስ የሚጠራ ብትን እስከ
ለ : ይህን የተጻፈው የደነገጠችው ቀን ጥር
መባዘን : የሆኑት ተተኪ ዓ.ም. ቀን ጥር
አቁሙ : ይዘጋጉታል ጳጳሳት ዓ.ም. ቀን ጳጳስ
ፈረንሳይ : ተብሎ አስደንቀዋታል እንዳደረጉላቸው በጫማ ማርያም
የደነገጠችው : ለ ይለን ሆነዋል ጥር ጳጳስ
ደጃፍ : ሜትር ተገምግሞና እንደዚህ እናዓይኔን በፈገግታ
አያችሁ : ትላለችሁ የታየው እባክህ ተቻኩላ በየፌርማታው
የእነሱን : የሰለቸን ትለኛለህ ተተኪ ጳጳስ
ሁሉን : የጉልት ባለቤቱን ወያላው ሜንዴዝን ቦንጋ
ስንኮርጅ : አዛውንቷ ልጃቸው ሕይወት ይገጥማል ብርሃነየሱስ
እነሱ : ቁርስ አስቡት ምነው የሚሸለም ተንደረደረ
የእኛን : መለሰና ካላችሁ አስገባ የሚገርመኝ እንዳልተንገላቱ
የጉልት : ሁሉን አልሽ ቀን ጳጳስ
ገበያ : የሆቴሎች አበባ ቀን ጳጳስ
አልኮርጅም : ተወኝ ልጃቸው ተተኪ ቀን #
ሲያንጣጣው : አዎ ይጋፋል ጣይቱ ያያል ብትን
መሹለክለኪያ : ሮቨር ብትን ተተኪ ጥር ጳጳስ
ባላጡ : ጉዞ ተቀምጠው የተቀመጡት በመሆንም ተተኪ
ነበርም : እየታደለ አለህ ነውና የምለው ኢትዮጵያውያን
ለካ : እየታደለ ብርሃነየሱስ ማኅበር በመሆንም ዓ.ም.
ቅርብ : ማሳያ በፊት በመሆንም አበባ ቀን
ልሙትላቸውና : ሳንባ እናስቸግራችሁ ሆነን ካጨዱና ስትል
ከቁም : ያድናችሁ እንዳታደናቅፉ ተቃጥለው ሙሽራ ነው
ያድናችሁ : እንዳታደናቅፉ አለህ ከሚል ዓ.ም. ቀን
ከምትሞቱ : የተመረኮዘ ከመርካት በፊት ሰኔ ተተኪ
ለእውነት : በርስ ይነጋገራል ነውና ዓ.ም. ጥር
ጠቅላችሁ : ጭፍን ተቃዋሚዎች ጊዜ ዓ.ም. ቀን
ሙቱ : እይታ መሳይ ቆይ ክርስቲያኒቱ ሲሆኑ
ታዲያ : ይመስለኛል ጣይቱ ልብ ምፀትና ሦስት
መንግሥትን : በረባ ተወኝ ይለኛል እኔን በፊት
ተቃውማችሁ : የመግባት ሲያስመካው ነው ይታወቃል ነበሩ
አላልኩም : # ጥር ጳጳስ
ያልኩት : በመሆንም ዓ.ም. ቀን ጳጳስ
እሺ : ዓ.ም. ቀን ጥር ጳጳስ
በሉ : የተቃጠልነው ይገጥማል ቀን ጥር ጳጳስ
ገዢው : ጭፍን ጦረኛ ቀን ጳጳስ
ፓርቲ : ፒያሳ ተድላ ያደገው በኢትዮጵያ ቀን
ያለማዳመጥ : ምርጥ የማድራት ጥረትና ብትን ኢትዮጵያ
አታዳብሩ : ሊሞላት በመሆንም ተተኪ ዓ.ም. ቀን
እ : ያቆምነው ምንድነው ነው ሆነዋል በመሆንም
አሜን : ባረባው ቅርስ ጥረትና በመሆንም ዓ.ም.
ጭፍን : ጠቅላችሁ አዎ ተቃዋሚዎች ነውና ጦረኛ
አማኝ : ወረቀት የተሰየመች ይጋባበታል በኢትዮጵያ ዓ.ም.
በረባ : መንግሥትን ተወኝ ስትል ዓ.ም. ቀን
ባረባው : የተመረኮዘ ሰጥተን ልጃቸው በመሆንም ተተኪ
አትበሉ : የሰለቸን ጣይቱ አመሲያ ተተኪ ካርዲናል
ቦምብና : ሾፌሩን እያልኩ ታክሲያችን ሜትሮፖሊታንን መንበር
ጠበንጃ : እናሟላለን ሽልማት ፈገግታ ፀሐይን ውኃስ
ሲያስታጥቋችሁ : ሲቀረው በፊት በመሆንም ዓ.ም. ጳጳስ
ሲያነበንብ : ለመያዝ ያንዣበበት ሌላው ጣይቱ ይዘጋጉታል
ታክሲዋን : በዓይን ረቂቅነቱ ሆነዋል በመሆንም ዓ.ም.
አስነሳ : በፈጠረህ ያፈዘኛል እንዳልተንገላቱ እንገናኛለን ያጉረመርማሉ
ዘወር : አመለካከት መጨረሻ ተቀምጠው ዓ.ም. ቀን
በል : ጥረትና ብትን የምለው ማኅበር በፊት
ሲያባርረው : የሚሆኑ ከምትሞቱ ሆኗል በዚህ መድኃኒዓለም
እያውለበለበ : የሚያጫርስ አንዲት በተንሰራፋበት ተተኪ ዓ.ም.
ሸኘን : ያትታሉ ሙዱ ያለረፍት ቀዘባ ታዳጊ
ነፍሱ : ከእነዚህም በፊት ቀን ጥር ጳጳስ
ትስከር : ይልቅ ሙሽራ ተተኪ ቀን #
አልያም : እንመጣለንና ጨርሰህ በመሆንም ዓ.ም. ቀን
ሰውነቱ : እያልኩ አልሽ ተተኪ ዓ.ም. ቀን
በመጠጥ : ስንባል በመሆንም ጥር ጳጳስ
ሳናረጋግጥ : ብለው ሰኔ ተተኪ ዓ.ም. ቀን
ራቅነው : እግረኛ በንቀት እያየሁ የጦርነት ቤተ
የማያገናኘው : መንገዱን ይታወቃል ያደገው በሊቀመንበርነት በመሆንም
ዓይነት : የባግዳዱ ተተኪ አበባ ዓ.ም. ቀን
መቼም : በዚህም ብሎ በዚህ ቆይ ከመርካት
መዳረሻችን : ኬፕታውን የላዛሪስት ተተኪ ዓ.ም. ቀን
ተቃርበናል : ሙሽራ ማኅበር አበባ ዓ.ም. ጥር
አትደማመጡ : ባሮች የእነሱን ግቡ የሰለቸን ትለኛለህ
ሊለን : ባሮች ያፈዘኛል ዕድሜ ከአጭር ታክሲያችን
ፈልጎ : ሲገኙ ተተኪ ዓ.ም. ቀን ጥር
ሬዲዮ : ፓትርያርክ የካቶሊክ በተካሄደው በመሆንም ተተኪ
ከፍቶ : እንገናኛለን የሚያስቡትን ይናገራል ረቂቅነቱ ተተኪ
ድምፁን : ልንጓዝ ሜትሮፖሊታንን መንበር በመሆንም ተተኪ
አጉኖታል : አቁሙ በሽንጣም ይልቅ አልፎንስ ከመንፈቅ
በፈረንሳይ : እንኳ ብርሃነየሱስ ጳጳሳት ሰኔ በመሆንም
ስለደረሰው : ሳንባ ሮጦ የአዲስ ዓ.ም. ጥር
የሽብር : ሞባይሉን እናያለን ታክሲያችን ኤምባሲ ዓ.ም.
ጥቃት : ካላችሁ የማኅበራችን ብሎ በሰው ከመርካት
ጋዜጠኞች : ያመሳስሉታል ትንሽ አለቃ በመሆንም ዓ.ም.
እየተቀባበሉ : ምን በኋላ ሆነዋል ተተኪ ቀን
ያትታሉ : የተጋበዝኩት ሸኘን ሲያነበንብ ያልኩት ቀዘባ
ቀንሰው : በርስ ተይ እንዳልተንገላቱ ጵጵስናቸው ቀን
በፈጠረህ : አስነሳ ያፈዘኛል ከተማው በፊት በመሆንም
ራሱ : በልቶ እምነት ቀን # ጥር
ከሽብር : ቀዘባዋ እግረኛ በፈገግታ ብትን ከተማው
ለየው : ያስገኛል አለኝ ይታወቃል ቀን ጥር
ካጠገቤ : አጠገቤ ከመርካት ከተማው ዓ.ም. ቀን
የተቀመጠው : ተጀምሯል ድካም እኔን ከመንፈቅ ቀን
ይነጫነጫል : የእኛን ያልተረጋገጠው እስከ የቤተ ላይ
ከጀርባችን : አልወጣላቸውም ተሞክሮ ከጎኑ ምን ቆይ
የተሰየመችው : መድኃኒዓለም ይመራሉ በተካሄደው ቀን ጳጳስ
የበኩሏን : ምነው ትንኝ አትሌት ጥረትና ነበር
የደሃና : ሌላው በልቶ ከተማው ዘመን በመሆንም
የሀብታም : ድርሻ ያማርራል አፍሪካ በፊት ቀን
አለመመዘኑ : ከእኔ የሚገርመኝ ጣይቱ ጳጳስ
ሲገርመን : ያህሉ የሚገርመኝ ጣይቱ አልሽ ይጥፋ
ለአደጉ : ቦንጋ ቀን # ጳጳስ
አገሮችና : አፉ ከተማው መንገዱን ሀገረ ተተኪ
ለደካማ : የሚያሟላቸውን ስብከት በመሆንም ዓ.ም. ጥር
አገሮች : አሟልተናል ከፍተኛ ተቋም የጂማ ቀን
እንባ : በስማቸው በቁማቸው ጉስቁልና ቆይ ግብግብ
የሚሰጠው : ብርሃነየሱስ ቀን # ጳጳስ
የአየር : ወጣት ያደገው ዘመን በመሆንም ዓ.ም.
ሰዓት : ሒሳብ ልቦናውን ብንጀመርም ስትል ስብከት
ይበላለጥ : ከመድረሱ ስትሆን መድኃኒዓለም ዘመን በመሆንም
ያዘ : ውይ ሞት ጣይቱ ሰኔ በመሆንም
ምነው : ሊሞላት ተቋቋመ ተቀምጠው ካርዲናል ቀን
በሽብር : ዘርተን ብሎ ከተማው ዓ.ም. ቀን
ባግዳድ : ሁኔታ አንጎል በኋላ መንበር የሚል
የምትጠፋ : ባለው የገባች እንቀበላለን ከመሠረቱት በፊት
ነፍስ : ሬንጅ ቀን ጥር ጳጳስ
ፓሪስ : ነበርም ግብግብ ላይ # ጥር
ከምትጠፋው : ይህም የልደት ከሽብር ልጃቸው ከተማ
ምኗ : ምነው በወጣ የሚያስመካበት ካርዲናል ቀን
ይሆን : ሲያሳርፈው እንዲችው ይታወቃል በመሆንም ካርዲናል
ሲመዘን : ፍጡሮች በሊቀመንበርነት ዓ.ም. ቀን ጥር
የቀለለው : ቀርተዋል እንሰጣለን ተከታያቸው ከእነዚህም ቀን
ወይስ : እሺ ትለዋለች አለህ ዓ.ም. ጥር
የባግዳዱ : ተተኪ ዓ.ም. ቀን ጥር ጳጳስ
ቻይና : በሊቀመንበርነት በተካሄደው በመሆንም ተተኪ ቀን
ሠራሽ : ሲቀረው በፊት በመሆንም ዓ.ም. ቀን
የማትሠራው : እናሟላለን ቱሪስት አይደለም የምለው ይታወቃል
ተይ : እንዳልተንገላቱ እየታደለ ታክሲያችን ስብከት ዓ.ም.
በጫማ : ተተኪ ዓ.ም. ቀን # ጳጳስ
የተቃጠልነው : የልደት በሉ ፍረዱኝ ሆኗል መቼስ
አንሶ : በ# ቀን # ጥር ጳጳስ
በነፍስ : ውይ መልስ ስማ ስትይዝ የላዛሪስት
እንቃጠል : በፊት በመሆንም ዓ.ም. ቀን ጥር
እንዴ : እላለሁ አሟልተናል ወይ ያሳውቃሉ ያደረጋል
አጠገቧ : ስደውልልህ አንተ በዚህ ዓ.ም. ቀን
ይስቃል : ላጋጠማቸው የማይሠራውን ይበላለጥ ስትሆን መድኃኒዓለም
ውይ : መንገደኞች አሽከርካሪ ማኅበር በፊት በመሆንም
እንኳንም : ኬፕታውን አልፎንስ ከመሠረቱት ተተኪ ዓ.ም.
አንዳንዱን : ጣይቱ ነገር ከተማው ሜንዴዝን በሊቀመንበርነት
ነገርስ : ይኼው ልታወጣው ኢትዮጵያ በመሆንም አበባ
አይሥራው : ላጋጠማቸው ይበላለጥ ረቂቅነቱ ጠቅላይ በመሆንም
አስቡት : ይፈጥራል ጣይቱ በመሆንም ቀን ጳጳስ
ሳንባ : ልሙትላቸውና እንቢ ዓ.ም. # ጥር
ኩላሊት : የሰለቸን አለህ ጎረምሳ በኋላ በፊት
ጉበት : የላዛሪስት በመሆንም ዓ.ም. ቀን ጳጳስ
አንጎል : የተቀመጠ በፊት # ጥር ጳጳስ
ወዘተ : በተባለው አንስቶ በሊቀመንበርነት ሲሆኑ ቀን
ሠርቷቸው : እያናገረ ብሎ ሲሆኑ ቀን ጥር
ተገዝተው : ይፈጥራል በል እስኪ ብትን ማርያም
የሚገጠሙ : ተተኪ ካርዲናል ዓ.ም. ቀን ጳጳስ
ቢሆን : አስመስለው መቼስ ወጣት በመሆንም ዓ.ም.
ኖሮ : ግንቦት ሰኔ ቀን ጥር ጳጳስ
ቀዘባዋ : ከሽብር ከቀረን በመሆንም ቀን #
ይኼው : መቼም እናስቸግራችሁ ከመርካት ያማርራል እነሆ
የማይሠራውን : ይበላለጥ ስትሆን ብትን በመሆንም ቀን
እያጠፋው : ይበላለጥ ስትሆን ያውስ ልታደርገው መተዋወቅ
አይደል : እንስት የሚጠራ ይዘጋጉታል ታክሲያችን ከመንፈቅ
ፍዳችንን : በተንሰራፋበት በተካሄደው ጳጳስ
ያየነው : ለፊት ያልፈጠርነውን ልንደርስበት የሚጠራ ጥር
ያልፈጠርነውን : ማሟላት ምዝገባ ፍጡሮች አስበን የሚጠራ
የምናጠፋ : ሰው በማገልገል ከተማ ነበሩ የፍልስፍናና
የማናጠፋውን : ሊሞዚን ሥልጣን እምነት ጳጳሳት ቀን
የምናነድ : የምናጠፋ አንሶ ተቃውማችሁ ከቁም መንገዱን
ያልደከምንበትን : ቀኗ እንደተደሰቱ ሲያሳርፈው ካሳንቺስ መሆኑ
የምንዘርፍ : ትላለችሁ ጉዞ አስታኮ ይጥፋ ይመራሉ
ስንባል : ማንና ከሽብር ተቃጥለው ከተማ ጠቅላይ
ያለነው : ይዘጋጉታል ይታወቃል ከመንፈቅ ዓ.ም. ቀን
ፍጡሮች : መለኪያዎች አስመስለው በመሆንም ዓ.ም. ቀን
ነን : ያያል ጥር ጳጳስ
ተሳፈሪ : ማን ክርስቲያኒቱ በ# በፊት ዓ.ም.
ተወርውሮ : ዝምተኛ የቆመ ሜንዴዝን ብርሃነየሱስ ጥር
ሊያርፍ : ባረባው ተንደረደረ ከተማ በፊት በመሆንም
ምንም : መዋኛ ነኝ የምሩ ዓ.ም. ቀን
አልቀረው : ወደየጉዳያችን እንዳታደናቅፉ የሰለቸን መካከል በሊቀመንበርነት
ጥግ : ባለ መድኃኒዓለም ይታወቃል ፓትርያርክ ሆነዋል
ሲለን : ይጭናል ያያል ይጥፋ ከተማው በማገልገል
ከመቼውም : ለመሄድ የረጅም ከተማው ቀን ጥር
ሠልጥኗል : ይጋፋል ከጎኑ አንተ ምን እየተሳፋ
በሚባልበት : ኤክስፐርቶቹ ደረስኩብሽ አይሃለሁ አረጋግጠው ቆይ
እያደር : መሥራቷን በሽንጣም በኢትዮጵያ ተተኪ ቀን
የምናየውና : ስልክ ታሪክና የሚያስቡትን ተተኪ የኢትዮጵያ
የምንሰማው : የዚህ ዘመን ዓ.ም. ቀን ጥር
ሬት : እንገናኛለን ፍርድ ነው ጠቅላይ በፊት
እንዳለን : ከምትሞቱ የመጀመርያው ቀን ጥር ጳጳስ
እያወጋን : ሞት ትዕይንቱ መጨረሻ ሙሽራ #
ወረድን : ሲያጉረጠርጥ የምለው በፊት በመሆንም ቀን
ወግ : ጉዞ ልመድና ከመርካት ስብከት እንዲሁም
ሲያዳምጥ : ተቀምጠው የላዛሪስት በመሆንም ቀን ጥር
የነበረ : ፍረዱኝ ዕድሜ የሚያስመካበት ከተማው አልፎንስ
ዝምተኛ : ጅምሮች ብዙዎቹ ተወርውሮ ሁሉን ከበደ
እባካችሁ : ልጃቸው ጀርባ አፍ ባይ ስብከት
አቃጥላችሁ : ስትይዝ ጠቅላይ በመሆንም ተተኪ ጳጳስ
አታቃጥሉን : እንዳደረጉላቸው ያዘ ሙዱ ትዕይንቱ ታክሲያችን
ዓይኑን : ከአጭር ኤምባሲ ግንቦት እምነት ቀን
ሲያጉረጠርጥ : ምዝገባ ምነው በወጣ ሽር ካሳንቺስ
ይኼኔ : የተቋሙ እያየሁ በፊት ቀን #
መሸሽ : ዘወር ያልኩት አምላክ ያለረፍት መንግሥት
ብለን : የጥሪው ይህም እያሉ ተተኪ ዓ.ም.
ወደየጉዳያችን : ለመሆን የሰለቸን በሊቀመንበርነት በፊት ሰኔ
ተበታተንን : አለው ያውጣ ነው ይመራሉ ቀን
መልካም : ዓላማ እስከ ጵጵስናቸው ቀን ጳጳስ
ጉዞ : እሠራለሁ ይታወቃል ሰኔ በመሆንም ጥር
አቶ : ፎረም የኢትዮጵያና ከሲመተ ዓ.ም. ቀን
ዜናዊ : አለህ በዚህ በፈገግታ የሚጠራ ከሚል
መስፍን : ጉዳተኞችን አንባረቁበት ግብዣ እየተንቀሳቀስን ጳጳሳት
የኢንተር : ተወልደው ሆነዋል ተተኪ ጥር ጳጳስ
ኮንቲኔንታል : ኢንተርኮንቲኔንታል ታሪክና በየፌርማታው ብርሃነየሱስ በመሆንም
ዋና : እምነት እንዲሁም በመሆንም ዓ.ም. ቀን
አስኪያጅአቶ : ከአቶ እየታደለ የኢትዮጵያና በፊት ሆነዋል
ተወልደው : የኢንተር አመሻሽ ያጨለመበት ሆነዋል ጥር
ያደጉትና : ፖርትሬት በመሠራቱ ያልኩት በየቀለበት በመሆንም
ከፍተኛ : ተቋም በመሆንም ዓ.ም. ቀን ጳጳስ
ሁለተኛ : የመጡ የሰው አይሃለሁ ላይ ሰኔ
ትምህርት : ይመስል ቆይ ያደገው የጀመረችው ዓ.ም.
ቤት : የሚያስቡትን ይጥፋ ከተማ ዓ.ም. ጥር
የተማሩት : እንዳሏቸውና አለህ ከሚል ዓ.ም. ቀን
በሽሬ : ሞት ማኅበር በመሆንም ተተኪ ዓ.ም.
እንደስላሴ : ዓመቷ ሲቀረው በፊት በመሆንም ዓ.ም.
በቴክኒካል : የጉልት ቻንስለርም ዓ.ም. ቀን ጥር
ቲቸር : ማስፋፊያ አድሚንስትሬሽን ከመቅጽበት ያጉረመርማሉ በሊቀመንበርነት
ኤዱኬሽን : ለምሳሌ ጥረትና ካርዲናል ቀን ጥር
የሁለት : ማሳያ የተባለው በፈጠረህ የማድራት ባህር
ኮርስ : ሊሞላት ሳያገኙ እናመጣልዎታለን መሥፈርቶችን እንዳታደናቅፉ
ተከታትለዋል : ተቋቋመ አምስት በርስ የሚሆኑ ያቆምነው
ሐንጋሪ : አልተናገራትም የተቀመጡት ተተኪ ዓ.ም. ቀን
አቅንተው : በአዲስ ስብከት ዓ.ም. ጥር ጳጳስ
በቡዳፔስት : የሚሰጠው በፈጠረህ በመሆንም ዓ.ም. ቀን
በሆቴልና : ቻንስለርም ሲሆኑ ዓ.ም. ቀን ጳጳስ
ቱሪዝም : ትርፋማ ጳጳስነት ጳጳስ
ማኔጅመንት : እንዲሆን ቁርስ ለማድረግ አልቅሶ የሚያስቡትን
የመጀመሪያ : ሜንዴዝን በሊቀመንበርነት ሰኔ ቀን ጥር
ዲግሪ : ነጋሽ ተብሎ የነበረውን እናመጣልዎታለን ሲመዘን
በኢንተርናሽናል : ለዚህም በምን የምንሰማው ያማርራል ኤምባሲ
ሪሌሽን : ከዚህም ሆቴሎች የእነሱን ጳጳስ
ዲግሪያቸውን : መሆናቸውም ዘርተን በዕድሜ በፊት በመሆንም
አግኝተዋል : አትርፏል ተቀብለዋል አሉ የሚዘምቱት ይጥፋ
አሜሪካ : ኒውዮርክ እየተሳፋ ኤምባሲ ዓ.ም. ቀን
ተሻግረው : በርስ አቅንተው ባይ በአዲስ *
ከሜሪላንድ : በቡዳፔስት ሲያዳምጥ ሳያስተዛዝበን ቅርስ በመሆንም
በቢዝነስ : በየፌርማታው ስንቶች ቻንስለርም አፍሪካ መምህርም
አድሚንስትሬሽን : ተሞክሮ ጳጳስነት መምህርም ጳጳሳት የአዲስ
የማስተርስ : በወርልድ የመጀመሪያ ሜንዴዝን ይመራሉ በሊቀመንበርነት
ተቀብለዋል : ትምህርት ይጥፋ ያደገው ሆነዋል ዓ.ም.
በቡዳፔስትና : ትለዋለች እነሆ ዓ.ም. ቀን ጥር
በአሜሪካ : በምግብና እሺ ከሚል የስፔን ዓ.ም.
በሚገኙ : የጀመረችው ጳጳስነት ጳጳሳት ቀን ጥር
የተለያዩ : ከተባሉት ሰኔ ዓ.ም. # ጥር
አቀፍ : የታወቁ ኤምባሲ ሊሎንግዌ ቀን #
ሆቴሎች : ወይም ሪሌሽን ሊያሳስበኝ ተቋም የጂማ
ውስጥ : ቀጥሎ ጣይቱ ፓትርያርክ መምህርም ሆነዋል
ምግብና : አስፈላጊውን እናንተና እንዳልተንገላቱ ሆነዋል ዓ.ም.
መጠጥ : ጆሮው ብንጀመርም ሰኔ ዓ.ም. ቀን
ዲፓርትመንት : የካቶሊክ የአዲስ ዓ.ም. ቀን ጳጳስ
ዳይሬክተር : ስልክ ማኅበር ተተኪ ሲሆኑ ዓ.ም.
ሠርተዋል : አይገርማችሁም እሠራለሁ ይታወቃል በመመረጥ ሰኔ
ሆቴሉ : የማድራት በስማቸው አበባ ቀን #
የወርልድ : ቅጥያው የሚገነባው ካላችሁ ጎረምሳ ሜንዴዝን
ሌግዠሪ : ዴይ ማስጠንቀቂያ መጨረሻ ከተማ የላዛሪስት
አዋርድ : ከተማው በሊቀመንበርነት # ጥር ጳጳስ
የ# : እስኪ ዓ.ም. ጥር ጳጳስ
ተሸላሚ : ከዚህ በታች ተተኪ ዓ.ም. ቀን
ዙሪያ : ሳያስተዛዝበን አልተናገራትም በፊት # ጥር
ከአቶ : አስኪያጅአቶ እጅግ እየታደለ የረጅም ከአንደኛው
ታደሰ : በወርልድ ሲታይ ስብከት ዓ.ም. ጥር
ገብረማርያም : መማማር አለህ ቆይ በኋላ ቀን
አድርጓል : አሳድሯል በቅቷል አሉት ሠራሽ ሆነዋል
ሪፖርተር : ኒውዮርክ ይልቅ ዓ.ም. ቀን ጥር
ኢንተርኮንቲኔንታል : ኮንቲኔንታል በል እስኪ ታሪክና በመሆንም
የዓለም : ከሌሎች መንግሥት የአብሮነታቸውን ከሚል በመሆንም
የሆቴሎች : ወረቀት የምለው ብርሃነየሱስ የነበሩት ሆነዋል
ውድድር : ተብሎ የአመራር ዓ.ም. ቀን ጳጳስ
መሆኑን : ለመሆን ወደየጉዳያችን መቼስ ተቀምጠው በመሆንም
አብስራችኋል : ይታወቃል ቀን ጥር ጳጳስ
ሽልማቱን : አሥራ ተጀምሯል በልቶ ይዘጋጉታል ክርስቲያኒቱ
የሰጠው : ኤክስፐርቶቹ አይሃለሁ ስሙልኝ ሙሽራ ከእነዚህም
የትኛው : ልጅ ያደገው የጀመረችው ቀን #
አካል : እንደዚህ በልቶ ቀን ጥር ጳጳስ
ወይም : ሆቴሎች ይመራሉ ዓ.ም. ቀን ጳጳስ
ሆቴሉስ : ተተኪ ዓ.ም. ቀን ጳጳስ
በምን : የሚገመግሙት የሸለመው ስደውልልህ በሊቀመንበርነት በመሆንም
መሥፈርት : ሜትር የተቀበለው የሚገኝባት ክህሎት ሞት
ታይቶ : አስመስለው ጣይቱ በፊት ሰኔ በመሆንም
ለሽልማት : ፖርትሬት ያልኩት ቀልቡን የሚል በመሆንም
የበቃው : ነው ነበሩ ሆነዋል ቀን ጳጳስ
ሆቴልን : ማሳያ በላይ ካሬ አፍሪካ በፊት
የሸለመው : የሚገመግሙት ይኼው የምለው በሊቀመንበርነት ዓ.ም.
ወርልድ : በወርልድ ኢንተርኮንቲኔንታል ታክሲያችን ሜንዴዝን ስብከት
የተባለው : ከተባሉት ውስጥና የ# የሁለት ባህር
የተቋሙ : ተቃዋሚዎች ልንጓዝ አልፎንስ በፊት ዓ.ም.
መሥሪያ : እንዳታደናቅፉ ጡረታቸው ታክሲዎች እሠራለሁ ይታወቃል
የሚገኘው : የወጣው አገኙት የሚመስለው በማላዊ ሆነዋል
እንግሊዝ : ሜርት የሽልማት አስመስለው በፈጠረህ የማያካትት
አኅጉራትም : ክፍሉ መስተዋት ልሙትላቸውና እናስቸግራችሁ ልብ
ቅርንጫፎች : ወክዬአቸው ሁሉ በመሆንም ጳጳስ
አሉት : አሳድሯል በቅቷል አድርጓል ጉዞ ለውጥ
ኒውዮርክ : ሪፖርተር ትለዋለች ዓ.ም. ቀን ጥር
ኢንተርናሽናል : የመሳተፍ አስፈላጊውን ካልተሠራ መመስከር የበይ
አሶሴሽን : ፍለጋ በምን ሦስተኛው ሊያሳስበኝ የሚጠራ
የሚደገፈው : የማኅበራዊ እየታደለ ስትል የምለው ማርያም
ይኸው : ማን እይታና ይዳዳታል ሦተኛው ነበር
በዓለም : ትምህርት የጀመረችው አፍሪካ ጵጵስናቸው በመሆንም
የታወቁ : ፍረዱኝ መንግሥት ክፍለ ካርዲናል ዓ.ም.
የሆቴልና : ወኪሎች ታሪካዊ ክርስቲያኒቱ ሆነዋል በመሆንም
የቱሪዝም : ሁለት ድርሻ ፍርድ ብርሃነየሱስ በፊት
ኤክስፐርቶች : መለኪያዎች ባሮች ለመድረስ አፍሪካ በመሆንም
እነዚህ : ስለሆነም ሪፖርተር አንተ ስትል ዓ.ም.
ኤክስፐርቶችም : ተተኪ ዓ.ም. ቀን ጥር ጳጳስ
በየአገሩ : በመመዘኛው መታገስ የኢትዮጵያና ቻንስለርም ሆነዋል
እየተዘዋወሩ : ስደውልልህ ውኃ ይዘጋጉታል መምህርም በመሆንም
ይመጥናሉ : አለባቸው ኤዱኬሽን ላይ ካርዲናል ዓ.ም.
የሚሏቸውን : ከሌሎች ለእንግዳ ከጀርባችን ይለዋል እውርን
ይመርጣሉ : ይገኙበታል ያደረጋል ነው በተካሄደው ሆነዋል
ለዚህም : ቀን ጳጳስ
ተስማሚ : ቀኗ ከተማው በሊቀመንበርነት ተተኪ ዓ.ም.
የሚሆኑ : ሆኗል ቀን ጥር ጳጳስ
መሥፈርቶችን : ጥቅሞችን ኮርስ ከሚገለጠው በመሆንም ተተኪ
አስቀምጠዋል : እናገኛለን ፈጥረናል ነበሩ ሆነዋል ጥር
በመሥፈርቱ : መንጎጨት እርስ ዓ.ም. ቀን #
መሠረት : በኢንተርናሽናል ኖሮ ግንቦት በሊቀመንበርነት ሰኔ
በመቶ : ያደረጋል ከጀመሩ ጳጳሳት ዓ.ም. ቀን
ያህሉን : ያህሉ ሲያባርረው እናንተና ይላል ጣይቱ
ነጥብ : አሁን ጠፊዎችና እሠራለሁ ግንቦት በታች
የሚሰጡት : አሳድሯል ሜትሮፖሊታንን መንበር አንስቶ የኢትዮጵያና
ለሆቴሉ : ደስታ በስልክ አጠገቤ ማርያም አመሲያ
ፋሲሊቲ : እንዳለመታደል ወጣት በመሆንም ጳጳስ
የቀረው : ይታወቃል ግንቦት ሰኔ ቀን ጥር
ያህሉ : እናሟላለን ፈገግታ ጉድጓድ ሰኔ ተተኪ
ለእንግዳ : በሉ አንዱ ያውስ ሠርግ ከተማ
አቀባበል : የሚዘምቱት የጀመረችው ተተኪ ቀን ጥር
ለአገልግሎት : መንበር # ጳጳስ
ብቃት : ልዩ እንባ እናንተና የመግባት በሊቀመንበርነት
ለውስጣዊ : ኤክስፐርቶቹም አታዳብሩ አይ የምለው በመሆንም
አደረጃጀት : የአየር በፈጠረህ ቅርስ ያደገው ቀን
የሚያዝ : ለመድረስ በፊት በመሆንም ዓ.ም. #
በመመዘኛው : የቆዩትን እንደመጡ በየአገሩ እሺ አሽከርካሪ
አንድን : እንዳታደናቅፉ ሠልፍ ከጀመሩ ቤተ ዓ.ም.
የሚገመግሙት : የሸለመው በምን ይኼው ከተማው የምለው
የሚያወዳድሩት : የሚያዝ ካልተሰረቀም ሻይ እኮ የምለው
እንመጣለንና : ወደየጉዳያችን ነገር በፊት ተተኪ ቀን
ጠብቁን : ፖርትሬት መሸሽ እሺ አንዱ በማገልገል
ሳያውጁ : እናንተና እንደ ዘመን የኢትዮጵያና በፊት
ድንገት : መተዋወቅ ሦስት ቀን ጥር ጳጳስ
ቱሪስት : የምለው በፊት አበባ ቀን ጳጳስ
መስለው : ይፈጥራል እንደስላሴ የምለው በፊት ቀን
ለሌላ : ስደውልልህ ኤምባሲ ቀን ጳጳስ
የመጡ : እንድንነሳሳ ልጃቸው ተተኪ ጥር ጳጳስ
አስመስለው : ለመድረስ መሆኑ በፊት ዓ.ም. ቀን
ማንና : ይህም አዎ ከተማ በፊት ዓ.ም.
መሆናቸውም : ዋጋ በፊት በመሆንም ዓ.ም. ቀን
አይታወቅም : ጉዞ ፍጡሮች ነው ተቋም ሰኔ
በሪሴፕሽን : የሰለቸን አልፎንስ ዓ.ም. ቀን ጳጳስ
በምግብና : በአሜሪካ እግረኛ ከሚል ብትን የስፔን
መኝታ : የመታጠቢያ ምክንያቱም ወያላውና ተጀምሯል ኤምባሲ
ክፍል : ስኩዌር እናስቸግራችሁ የወደድነው ማርያም እንዲሁም
ሲገቡና : ሌላ ፀሐይን ኤምባሲ አበባ ጳጳስ
ሲወጡ : ከእነዚህም በፊት ሆነዋል ሰኔ ቀን
ላጋጠማቸው : ይስቃል ይበላለጥ መቼ ስትሆን ስብከት
የሥራ : የምትመጣው ውኃስ ጥር ጳጳስ
እንቅስቃሴ : ታዋቂ ክፍት ስንቶች ዲፕሎማቲክ አልፎንስ
ይሰጣሉ : ያቆምነው ያውጣ እሠራለሁ ይታወቃል ነበራቸው
መልኩ : ዓ.ም. ቀን ጥር ጳጳስ
ተገምግሞና : እንደዚህ ከተማው ይታወቃል ቀን ጥር
መምጣታቸውን : በማለት በዚህ መታደም ቀን ጳጳስ
የማያሳውቁት : ከተማው በ# ተተኪ ዓ.ም. ቀን
ራሳቸውን : ምዝገባ ያህሉ ከተማ የጂማ የላዛሪስት
ግልጽ : ታች አይሃለሁ ቤተ በሊቀመንበርነት ተቋም
አድርገው : ጉዳዩ ካልተስማማዎት ጭፍን አልቅሶ ጦረኛ
የማይቀርቡት : የጠበቀ የ# የሚዘምቱት ታክሲያችን ቤተ
ይህንን : ሪፖርተር ወይስ ከጎኑ ከተማው ዓ.ም.
አውቆና : አልሽ የአብሮነታቸውን ቆይ ከዚህ ሲሆኑ
ተዘጋጅቶ : ወጪ የራቀንን ቤተ አበባ ጳጳስ
እንዳይጠብቃቸው : የተቀበለው በየቀለበት ካሳንቺስ በሊቀመንበርነት #
ለማድረግ : የእኔ አንባረቁበት አልሽ ስንቶች ዓ.ም.
የኤክስፐርቶች : ለሆቴሎች ይህን ሰርቪስን እግረኛ ልጃቸው
አገማገም : በቴክኒካል ቻንስለርም የላዛሪስት ዓ.ም. ቀን
እንደሚመስል : ለመዳር ይታወቃል በሊቀመንበርነት ስብከት ቀን
ሊያስረዱን : ወክዬአቸው አልሽ በሊቀመንበርነት ዓ.ም. ጳጳስ
ይችላሉ : አድርጐታል የሚገባው እሠራለሁ ይታወቃል ግንቦት
ኤክስፐርቶቹ : የሰጠው በሚባልበት ስማ ቆይ የመጀመርያው
እንደመጡ : በመመዘኛው በየአገሩ መታገስ ክፍለ በመሆንም
የሆቴሉ : ዳይሬክቶሬት ከአራት ይጋባበታል የምለው በሊቀመንበርነት
ሪሴፕሽኒስቶች : ሳንባ ሊያሳስበኝ ሲሆኑ # ጥር
ከመቀመጫቸው : ስንጠየቅ የኤክስፐርቶች የሰጠው እርግማኑን ብትን
ብድግ : አምስት እንቀይርልዎት ገልቱነት እኔ ተቀምጠው
ሆቴላችን : እንመጣለንና ድካም ተተኪ ዓ.ም. ቀን
በደህና : ጎረምሳ በኋላ ቤተ ሜንዴዝን በፊት
መጣችሁ : መለኪያዎች ሠራሽ አልተናገራትም ሜትሮፖሊታንን መንበር
በማለት : መምጣታቸውን ከቦሌ ቀን ጳጳስ
ፈገግታ : ልሙትላቸውና እንዳታደናቅፉ አመሲያ ሰኔ ዓ.ም.
በተሞላበት : ኅብረት ሆነዋል ጥር ጳጳስ
ሁኔታ : ትሥላለች እናሟላለን ሲቀረው መንበር አመሲያ
እንዳደረጉላቸው : እየታደለ የተቀመጠ ታክሲያችን መድኃኒዓለም ማርያም
ከዛም : እንቀይርልዎት በልጃቸው እስኪ ሆነና እየታደለ
ቢና : ቡና ቀረ አይሃለሁ ብትን ተከታያቸው
እንዳሏቸውና : አለህ ከሚል በፊት ተተኪ ዓ.ም.
በዚህም : መቼም አዎ ብዙ ብሎ ከመንፈቅ
እንደተደሰቱ : ሰርፕራይዝ መልስ ሁሉ በፊት ሰኔ
ነግረውናል : ገልጸዋል ምንድነው ጣይቱ አይደለም ይመራሉ
በሁለት : ብዙ ቀን # ጳጳስ
ደቂቃ : ቀናት ኢትዮጵያ አበባ # ጳጳስ
ውስጥም : መሥፈርቶችን ቆመች መልስ ኢትዮጵያ ላይ
አስፈላጊውን : የመሳተፍ ልጃቸው ይጥፋ ሆነዋል ዓ.ም.
አሟልተው : አለበት በማላዊ መለኮት ሆነዋል ቀን
የአልጋ : ነበርም ሸምድዶ ሊሎንግዌ የነበሩት *
እንዳስያዙዋቸው : እንዳለው ብላችሁ የላዛሪስት ዓ.ም. ቀን
ጥቂትም : መካከል ማኅበር ዓ.ም. ቀን #
እንዲቀዩ : አቅም ወንድ እስከ አለቃ ጳጳስ
ጤና : ጥቅሞችን ስልክ በመሆንም አበባ ጳጳስ
ይስጥልኝ : ያፈሳል እፎይ ድካም መንበር በተንሰራፋበት
ጌታዬ : ይጥፋ ይዘጋጉታል ያደገው ኢትዮጵያውያን ዓ.ም.
ክፍሉን : የሚፈጥር ኤክስፐርቶች ያውስ እየተንቀሳቀስን መካከል
እንዴት : ከሚገለጠው አውድማ መምህርም ዓ.ም. ቀን
አገኙት : ነው ሆነዋል ቀን ጳጳስ
ካልተስማማዎት : መምጣታቸውን ያውስ ዓ.ም. ቀን #
እንቀይርልዎት : በሊቀመንበርነት በፊት ካርዲናል ዓ.ም. #
ወይ : የማድረግ ይታወቃል ሰኔ ቀን ጥር
ጠየቋቸው : በመሥፈርት ቱሪስት ጎረምሳ ፍርድ በኋላ
ለመረዳት : ሲያስታጥቋችሁ በመሆንም ተተኪ ዓ.ም. ጳጳስ
ችለናል : ያያል ናቸው ጥር ጳጳስ
ቁርስ : በዚህ ከተማው አልፎንስ ቀን ጳጳስ
ደክሞዎታል : አንዱ እምነት ማኅበር በመሆንም ሲሆኑ
ቁጭ : ገልቱነት ሴራ ግንቦት ከተማ መምህርም
እናመጣልዎታለን : የሰለቸን ጎረምሳ በፊት በመሆንም ተተኪ
ብለዋቸዋል : የሚዘምቱት ነበር ይመራሉ ተቋም ሰኔ
ይህ : ይባል በፊት በመሆንም ካርዲናል ቀን
ዓይነቱ : የሚለው የነበረውን ያለው በልቶ ከዚህ
ሠራተኞች : የመታጠቢያ የተግባር የሚሞላበት ጌታዬ መኝታ
እንግዳን : ተመልሶ በፈገግታ ሙሽራ ኢትዮጵያውያን በፊት
እንደሚንከባከቡ : ያልኩት እስኪ በመሆንም ዓ.ም. ጥር
ያሳያል : ገልጸዋል ነገሮች የበቃው አዲስ አንቺ
ማንኛውም : ዓ.ም. ቀን ጥር ጳጳስ
እንግዳ : መኖሩ ጉዞ ፍጡሮች ተቋም ተተኪ
በሆቴሉ : ከሌሎች ካልተሠራ መንግሥት ከሚል የላዛሪስት
አልጋ : እናሟላለን እናስቸግራችሁ በተንሰራፋበት በማገልገል ቀን
ለመያዝ : ሲያነበንብ ያንዣበበት ይዘጋጉታል ኤምባሲ ጳጳስ
ሲፈልግ : ዘወር ወጥታ ስብከት ዓ.ም. ቀን
በቅድሚያ : መቼ አረጋግጠው ከተማው ጥር ጳጳስ
ይመዘገባል : የሚሆኑ አድርጓል አስታኮ ቀን #
ኤክስፐርቶቹም : ለዚህም የምለው ቀን ጥር ጳጳስ
ፈጽመዋል : ኖሮ ያደረጋል እሠራለሁ አለኝ ይታወቃል
ምዝገባ : አፉ በፈገግታ ከተማ በፊት ሰኔ
የእንግዳው : ወጥታ ማስጠንቀቂያ ቀን ጳጳስ
ስም : መምጣታቸውን መታደም ያደገው ነበር ሲሆኑ
የተወለደበት : ረቂቅነቱ ካርዲናል ቀን # ጳጳስ
የሚሞላበት : ይዘጋጉታል ይታወቃል ከተማ ጵጵስናቸው በመሆንም
ፎርም : መንገደኞች በውስጣችን መለኪያዎች ለመድረስ ማኅበር
አለ : ተቀብለዋል ይመራሉ ሰኔ ዓ.ም. ቀን
ከኤክስፐርቶቹ : እሺ አዎ ትለዋለች ዓ.ም. ቀን
አንዷ : ተጨባጭ ከ# ተቋም የላዛሪስት ሰኔ
እንስት : በርስ የሚገርመኝ እየተሳፋ የሚጠራ ዓ.ም.
በፎርሙ : ዜናዊ በዚህ ያህል በሊቀመንበርነት ሆነዋል
የትውልድ : በሞላችው ነኝ ያሳውቃሉ የሚያስመካበት ሽር
በተባለው : እንዳታደናቅፉ ቆይ ከሚል አንስቶ ሲሆኑ
ቦታ : በዚህ ከተማው በሊቀመንበርነት በማገልገል በፊት
በሞላችው : የሚያስመካበት ተተኪ ዓ.ም. ቀን ጳጳስ
ሲታይ : ታደሰ ሠልጥኗል ከጎኑ እኔን በኢትዮጵያ
ከሦስት : በማግኘታችሁ ሲቀረው አዎ ቡና በመሆንም
ቀናት : ደቂቃ የማይሠራውን በፈጠረህ መብራትና ብሶተኛ
የልደት : ተቀምጧል አሉን የተቃጠልነው ማስጠንቀቂያ በመሆንም
ቀኗ : እጥፍ ተስማሚ የሚያስመካበት ተተኪ ዓ.ም.
ይሆናል : ይሰጣሉ ያውጣ እሠራለሁ ሆነዋል ዓ.ም.
የተገነዘቡት : የወያላውን በተንሰራፋበት ቀን # ጥር
ድረስ : ሳይስበው ካርዲናል ቀን ጥር ጳጳስ
በመሄድ : ረቂቅነቱ ከእነዚህም ዓ.ም. ቀን ጥር
ልደት : መልሰህ ከተማው ተቋም ዓ.ም. ጥር
ሐፒ : እንዳታደናቅፉ ከመርካት ዓ.ም. ቀን ጥር
በርዝ : በስፖንሰር በዚህ ከተማው ያደገው ቀን
ዴይ : ከሚባሉት እሺ ማስጠንቀቂያ አልተናገራትም ከሚል
አስደንቀዋታል : እናሟላለን መስለው የሚገመግሙት ከተማው በፊት
ሰርፕራይዝ : እንደተደሰቱ ኮርስ ትዕይንቱን አረጋግጠው እምነት
አድርገዋታል : ያቆምነው ሽር ናቸው ቀን ጥር
ከላይ : ሲነግሩህ አንተ በመሆንም ዓ.ም. ቀን
ታች : ወጣበት በየፌርማታው ቆይ በመሆንም ቀን
የተዘረዘሩት : ሪፖርተር አንዳንድ ከመጤፍ ኤምባሲ ስብከት
የተግባር : ማኅበር በመሆንም ዓ.ም. ቀን ጳጳስ
አፈጻጸም : መሬት አድርጓል እንዲሁም ጳጳስ
የየራሳቸው : በቀኝ ጣይቱ ስትል ይታወቃል ተቀምጠው
ስለሆነም : እነዚህ የቱሪዝም እናንተና የቤተ ዓ.ም.
የቆዩትን : በመመዘኛው ያየህ አንተ ረቂቅነቱ ታክሲያችን
ባዩት : ስንቶች የሚያስቡትን በሊቀመንበርነት ብርሃነየሱስ እንዲሁም
መጠን : ሊያሳስበኝ አይሃለሁ ብርሃነየሱስ በመሆንም ጳጳስ
የሰጧቸውን : ይታወቃል ተቋም ስብከት በፊት ዓ.ም.
ነጥቦች : ካልተሠራ ልጅ አይገርማችሁም ስትል የሚዘምቱት
በመቀመር : ይመርጣሉ መኪኖች ቀን ጳጳስ
ለመሆን : ሆኗል በመሆንም ዓ.ም. ጥር ጳጳስ
በቅቷል : አሳድሯል አብስራችኋል ይታወቃል አንስቶ ሆነዋል
ውስጣዊና : ከኤክስፐርቶቹ የማይሠራውን በሽብር ቃጠሎ ካልጠፋ
ውጫዊ : የጠበቀ ለመቀበል ግልጽ አደረጃጀት ሳይስበው
ገጽታ : ምክንያቱም ይዘጋጉታል ከመንፈቅ ጵጵስናቸው ጳውሎስ
የታየው : ትላለችሁ ጉዞ ያቆምነው እሠራለሁ የሚል
ካለው : ፈገግታ ለደካማ ያጨለመበት ሕይወት ስትል
ገጽታው : ሠዓሊት ሽልማቱን አምላክ መመስከር ሦተኛው
ለሚያርፉት : አንደኛው ቤተ ተቋም በመሆንም ቀን
እንግዶች : አካሄድ ዙሪያ ከምትሞቱ ሸምድዶ በፊት
ልዩ : ደረጃው ጣራው ያህሉ በስልክ ባይ
የሆነ : የሚለው በመሄድ ልጃቸው ብትን ሲሆኑ
እርካታ : ደስታ ብትን የምለው በሊቀመንበርነት ጵጵስናቸው
ስሜትና : በየዓለም የተገነዘቡት አንዳንድ በተንሰራፋበት በመሆንም
ደስታ : እርካታ በፈገግታ በሊቀመንበርነት ሰኔ ቀን
የሚፈጥር : ይህም ማንና ለመድረስ ያለው ከተማ
ሆኖ : እየታደለ አበባ ጥር ጳጳስ
ተገኝቷል : ያሳውቃሉ ያደረጋል እሠራለሁ ይታወቃል ቀን
የተነሳ : ሰብረናል ለመስበር ማትረፉ እንዳደረጉላቸው መንግሥት
ብዙዎቹ : መንገደኞች እ ድርሻ አንቺ ያደገው
ከዓለም : ከጀመሩ ሆነዋል ቀን ጥር ጳጳስ
ከታወቀው : የጂማ የላዛሪስት ተተኪ ዓ.ም. ቀን
ያመሳስሉታል : ያወካት እንድንነሳሳ ይጋፋል ልጃቸው በኋላ
ያደንቁታል : ሆኗል ይጥፋ ቀን ጥር ጳጳስ
በዘመናዊ : በመሄድ ተቀብለዋል ታስመስሉታላችሁ ከበደ ሊቀመንበር
መልክ : ክትትል ሆነን እንኳን ያጨለመበት ለመዳር
በመሠራቱ : የተቀናጀ ከኤክስፐርቶቹ አስቡት በየቀለበት አስበን
ለአገር : የወያላውን በተለያዩ ከእነዚህም ጵጵስናቸው ከሲመተ
ፈጥሯል : ይሆናል ሆነዋል ዓ.ም. ቀን ጥር
ግንባታ : ማስፋፊያ ቻይና መድኃኒዓለም ክርስቲያኒቱ በሊቀመንበርነት
በመጀመሪያ : ይሰጣሉ ሲወጡ ኒውዮርክ እንባ አልኮርጅም
የሎቢ : የሚያገኘው ይኼ ሾፌራችን ደግሞ አጋማሽ
አሠራሩ : ድርሻ በአኳኋኑ ሊቀ # ጥር
ክፍት : ሳይመስለው አልፎንስ አመሲያ ተተኪ ቀን
ጣራው : ከተማው ቀን ጥር ጳጳስ
በተለየ : ኤክስፐርቶችም ሥልጣኔን ቦንጋ ቀን #
መስተዋት : በአገር እናስቸግራችሁ ቀን # ጳጳስ
መሠራቱ : ከኤክስፐርቶቹ ሳንባ ብትን በተንሰራፋበት ጥር
ከታች : ቁርስ የምለው ቀን # ጳጳስ
ያለውም : ለበለጠ ጉዞ አንዲት ግን የሚጠራ
ጥሩ : ፍጡሮች በሽብር ዘመን በመሆንም ዓ.ም.
እይታ : ሠልፍ መካከል ሲሆኑ ጥር ጳጳስ
በብዙ : በየቀለበት ጣደ አልተናገራትም መንበር ከ#
አድናቆትን : በመሆንም ዓ.ም. ቀን ጥር ጳጳስ
አትርፏል : አገኙት እ ነው ይመራሉ ሆነዋል
ከዚህም : ቁርስ እሺ ከተማው ክርስቲያኒቱ ዓ.ም.
ሌላ : ኤምባሲ አበባ ቀን ጳጳስ
መዋኛ : ነኝ ጣይቱ ቀን ጥር ጳጳስ
መኖሩ : እንግዳ እንዳታደናቅፉ ያደረጋል ይታወቃል በመሆንም
ሆቴሉን : ይገርማል አለህ ይታወቃል ሰኔ ተተኪ
አድርጐታል : ይታወቃል ዓ.ም. ቀን ጥር ጳጳስ
የሚገነባው : በወርልድ ካላችሁ ጣይቱ አልሽ ሜንዴዝን
ቅጥያ : የጠበቀ እንግዳ ቁርስ ፍጡሮች እንዳታደናቅፉ
ከመሰብሰቢያ : ከተማው ቦንጋ ቀን ጥር ጳጳስ
አዳራሽ : አምስት የተጻፈው የመጡ ተከታትለዋል የተወጣ
ሬስቶራንት : ሞባይሉን የዚህ ታክሲያችን በመሆንም ዓ.ም.
አካትቷል : ያያል ናቸው ሆነዋል ሰኔ ጥር
በአጠቃላይ : ከታች እርስ የምለው በሚገኘው ዓ.ም.
ቅጥያው : የወርልድ ትለኛለህ መቼስ ከተማው ሰኔ
ምርጥ : ሳንባ ልሙትላቸውና # ጥር ጳጳስ
ከሚባሉት : ያድናችሁ ልጃቸው ይጥፋ ዓ.ም. ጥር
በከፍተኛ : ማሳያ ቱሪስት ጎረምሳ አልሽ የአብሮነታቸውን
ወጪ : ተገድበው ሸር በፊት በመሆንም የአዲስ
እየተገነባ : ተተኪ ካርዲናል ጳጳስ
አስተዋጽኦ : የሚንቀሳቀሰው የሀብታም ወያላው ከተማው መሆኑ
እንደሚኖረው : ታክሲያችን ቤተ ሆነዋል ሊቀ አበባ
ጥርጥር : ሊያስረዱን ዋጋ የሚያስቡትን በሊቀመንበርነት ሆነው
የለውም : ይጋፋል ያያል የሚዘምቱት ናቸው ነበሩ
በተለይ : ተስማሚ በነፍስ እየተሳፋ ከተማው በሊቀመንበርነት
ተሽከርካሪው : መስተዋት የገባች መጨረሻ ዘመን በመሆንም
ጣሪያው : ጆሮው በፈገግታ በሊቀመንበርነት ሰኔ ካርዲናል
የተለየ : ሬስቶራንቶች ይታወቃል ተተኪ ቀን ጥር
ይፈጥራል : ማርያም በመሆንም ተተኪ ቀን ጥር
አሳድሯል : በቅቷል አሉት አድርጓል አላቸው ጣይቱ
ሰርቪስን : ይህን የኤክስፐርቶች የመጡ ዲግሪ ቻንስለርም
በተመለከተ : ፍራንስ የሚደገፈው ብትን ከእነዚህም ቻንስለርም
ከሌላው : ለመስበር ልሙትላቸውና ግጥም ተቀምጠው በሊቀመንበርነት
የሚያደርገው : ተመሥርተው ያደረጋል አስበን ከተማው ይታወቃል
ከሌሎች : በሆቴሉ የዓለም ካልተሠራ መንግሥት ጎረምሳ
ለእንግዶቻችን : የሚያስቡትን ባይ ብርሃነየሱስ እንዲሁም ተተኪ
የምንሰጠው : ተቃውማችሁ ጥላቻና የመጀመሪያው ሠርግ ሥልጣን
ባህላችንን : በመሥፈርቱ ሜትሮፖሊታንን መንበር በተካሄደው ጳጳስ
ያደረገና : መስለው የሰጠው ተተኪ ዓ.ም. ቀን
የተቀናጀ : የተቀበለው ተገምግሞና ካሳንቺስ ተተኪ ዓ.ም.
ይህም : ማንና አዎ ከተማ ተተኪ ዓ.ም.
የእንግዳ : ተያይተው ግጥም ሞት ሠርግ ከተማ
አቀባበላችን : የሚያወጣ ብዙዎቹ መሆኑ ሲሆኑ ዓ.ም.
አካሄድ : እንግዶች ዙሪያ ምነው ከምትሞቱ ውጥንቅጡ
ተጠናክሮ : ልታደርገው ማኅበር በመሆንም ዓ.ም. ጥር
እንዲቀጥል : እባክህ ሊሞዚን በአዲስ በፊት በመሆንም
በእያንዳንዱ : ከጀርባችን አንባረቁበት በልጃቸው ሊሞዚን የምለው
ለሚገኙ : አቀናጅቶ አግኝተዋል ስንቶች ይመራሉ እንዲሁም
ሠራተኞቻችን : በዕድሜ ሠርግ ግንቦት ሰኔ በመሆንም
የአቅም : መንገደኞች አስኪያጅአቶ ትለኛለህ ሠርግ መንበር
ሥልጠና : ኢትዮጵያን መልስ ስማ በፊት በመሆንም
እንሰጣለን : ቀርተዋል ይታወቃል ነበራቸው ሰኔ ቀን
በርስ : ያደረጋል እንዳልተንገላቱ ማርያም ቤተ በሊቀመንበርነት
መማማር : እናሟላለን በእሳት ተተኪ ዓ.ም. ቀን
አሠራር : ሁለት አስመስለው መጨረሻ ቀን #
ዘርግተን : እየታደለ በፊት ጥር ጳጳስ
ዕውቀት : ስንኮርጅ ይመክራል ማርያም በሊቀመንበርነት ብርሃነየሱስ
የአሠራር : ታነሳና ያፅናኑታል መድኃኒዓለም ቀን #
ዘዴና : በመሄድ እንዲሁም በፊት ዓ.ም. ቀን
ተሞክሮ : መለኪያዎች እየተሳፋ ከሚል መምህርም ዓ.ም.
በመቅሰም : ሠልፍ በማገልገል ከተማ በመሆንም ጥር
እንገኛለን : አድርጐታል ያደረጋል ይታወቃል ቀን ጥር
የአመራር : የማድረግ በሆቴሉ ውድድር ፍጡሮች ጀመር
ብቃትና : ያሉ ማንና የሚያስቡትን ይጥፋ የጀመረችው
መተማመንን : ያለነው በፊት ጵጵስናቸው ዓ.ም. ቀን
ፈጥረናል : በቅቷል አሉት አላቸው የሚገባው ነው
ሽልማቱ : ተቃዋሚዎች ተመልሶ ጊዜ ሙሽራ መምህርም
የተሰጠው : ከምትሞቱ ማደር የማኅበራችን ከመርካት ጵጵስናቸው
ሽልማት : ባይ ተተኪ ዓ.ም. ጥር ጳጳስ
ኬፕታውን : እንኳንም መልስ ይልቅ እምነት ተተኪ
ደቡብ : አዲስ ፍራንቼስካና በመሆንም ቀን #
ለዚህ : ሄዶ ለሆቴሉ ብቻ ያጨለመበት ከሚል
የተመረጠችው : ተስማሚ ዋጋ ተሳፋሪዎች ሙሽራ አፍሪካ
ለምንድነው : የሚዘምቱት በ# ጥር ጳጳስ
ቱሪስቶች : ታሪካዊ በሊቀመንበርነት ካርዲናል ዓ.ም. ቀን
መዳረሻ : በየፌርማታው ይገጥማል ሆነዋል በመሆንም ቀን
እና : በአጠቃላይ ደንግጦ ተመሥርተው በእሳት ያደገው
የአፍሪካ : የ# አበባ ቀን ጳጳስ
ቅርንጫፍ : ተተኪ ቀን # ጥር ጳጳስ
የሚገኝባት : የተቀናጀ ወደየጉዳያችን አልፎላት በወጣ ከእነዚህም
በመሆኗ : አስመስለው መሆኑ በፊት ሰኔ #
ሄዶ : ኮርስ በሚገኘው በመሆንም ተተኪ ዓ.ም.
የተቀበለው : የተቀናጀ ካሳንቺስ ከተማ ተተኪ ዓ.ም.
ከሥፍራው : ኩላሊት ከምትሞቱ ዘርተን አለህ ጎረምሳ
ተገኝቼ : እንቃጠል ማኅበር በመሆንም ዓ.ም. ጥር
እንድቀበል : በመጀመሪያ በቁማቸው እየተወራጨ በሊቀመንበርነት በፊት
የተጋበዝኩት : ያትታሉ ሞት እየታደለ ሕይወት ብርሃነየሱስ
ነበርኩ : የእነሱን አላቸው የሰለቸን ያውጣ እሠራለሁ
የማርኬት : ባለቤቱን ለመድረስ እየተሳፋ ኤምባሲ በሊቀመንበርነት
ማናጀሯ : ይፈጥራል ቆይ ረድፍ በሰው እንዲሁም
ሄደው : ተገኝተን ሲያስመካው መምህርም በፊት በመሆንም
እንዲቀበሉ : ጉዞ በልቶ የሚል ስብከት *
ወክዬአቸው : ቅርንጫፎች መምህርም በመሆንም ዓ.ም. ጳጳስ
አልተሳካም : አልወጣላቸውም እሠራለሁ ይታወቃል ቀን ጥር
ምክንያቱም : እያሉ ብዙ ከመንፈቅ ጵጵስናቸው ከሲመተ
አሸናፊ : አልወጣላቸውም ይገጥማል በመሆንም ቀን ጳጳስ
መሆኑንና : ዘመናዊ በመገረም በመሆንም ጳውሎስ ዓ.ም.
ሽልማቱንም : አልቀረው ያሳውቃሉ ጣይቱ ይታወቃል ከመንፈቅ
በወርልድ : ወርልድ ነገር አልፎንስ ስብከት ቦንጋ
በሚከናወነው : ከሚባሉት ጥላቻና በተሻኮቱ በመሆንም ዓ.ም.
ሥርዓት : ሮቨር በተለያዩ ከእነዚህም በፊት ቀን
ተገኝተን : ሄደው መዋኛ ማንና ጋዜጠኞች ነኝ
እንድንቀበል : ትለኛለህ እንኳን መሳይ ይሆኑ ቆይ
የተላከልን : ገልጸዋል ታሪክና መድኃኒዓለም በሊቀመንበርነት ቀን
የጥሪ : የአየር ወጣት ነበር ዘመን እንዲሁም
ወረቀት : ከተማው ሜንዴዝን ጥር ጳጳስ
የተጻፈው : አሰጣጡ በመሆንም ቀን ጳጳስ
ሥነ : ትባላለች ስደውልልህ ልብ ቀን ጳጳስ
ሥርዓቱ : ከእነዚህም በተንሰራፋበት በፊት የመጀመርያው ቀን
ከመድረሱ : ሊካሄድ ይፈጥራል እየታደለ ብትን ጠቅላይ
የጥሪው : ይህም ስትል ከመርካት ዓ.ም. #
እጃችን : ጎረምሳ እስከ በፊት ቀን ጳጳስ
የገባው : እየተቀባበሉ ያውጣ አፉ በመሆንም ተተኪ
የሽልማት : እንግሊዝ በመሆንም ተተኪ አበባ ዓ.ም.
አሰጣጡ : የተጻፈው ቢሆን ያለው በመሆንም ቀን
ሊካሄድ : ከመድረሱ በመሆንም ካርዲናል ዓ.ም. ጥር
ሲቀረው : በፊት በመሆንም ዓ.ም. ቀን #
ባለችው : መንገደኞች ትለኛለህ ሞት አይ ቀን
አጠናቅቆ : ከመድረሱ ሰዎች ተከታያቸው በፊት ሆነዋል
ለመሄድ : ከመቼውም ካላችሁ የተቀመጠ የረጅም የአብሮነታቸውን
ስላጠረን : እንግዳው ከመጀመሩ የረጅም በኢትዮጵያ በፊት
ከጉዞ : እንድንነሳሳ ለመሆን ወደየጉዳያችን በሚባልበት አረጋግጠው
ቀርተናል : የተሰየመች ልቦናውን የጀመረችው ቀን #
ተቋሙም : በጎዳናው ለምሳሌ አሠራር ትምህርትህን በታች
የሽልማቱን : ሬስቶራንቶች ከሾፌሩ የሚጠራ በመሆንም ዓ.ም.
ሰርቲፊኬት : እጥፍ ባለቤቱን ልንደርስበት ቆይ ሽር
በዲኤችኤል : ብትን ምክር ማኅበር ተተኪ ዓ.ም.
ልኮልን : ወደየጉዳያችን ሰኔ ዓ.ም. ጳጳስ
ተቀብለናል : ጉዞ ለየው እሠራለሁ አለኝ ይታወቃል
ዋንጫውን : ለምሳሌ ቁርስ አጠገቧ በዚህ እርስ
ለመቀበል : ሳይስበው ክፍለ ቀን ጳጳስ
ለመውሰድ : እንዳታደናቅፉ ማስጠንቀቂያ ተቀምጠው ዓ.ም. ቀን
በቅርቡ : መታገስ የሚያስቡትን ጳውሎስ ቀን ጥር
እንሄዳለን : አሳድሯል በቅቷል አሉት አድርጓል በመሆንም
የሚያስገኘው : እንዳታደናቅፉ ጉድጓድ የለም ይታወቃል ዓ.ም.
ጥቅም : አስተያየት ሙሽራ እኔ ከተማ ተተኪ
አሥራ : ቱሪስቶች የዓለም ዜናዊ መንግሥት የአብሮነታቸውን
ስድስት : ጣይቱ ጥረትና ያደገው በፊት ካርዲናል
ጥቅሞችን : መሥፈርቶችን በመሆንም ተተኪ ዓ.ም. ጳጳስ
ያስገኛል : ለየው ነው ሆነዋል ሰኔ ቀን
ከጥቅሞቹም : በጎዳናው አዎ አንተ ቀን ጥር
የመሳተፍ : አስፈላጊውን ኢንተርናሽናል የማላሠራለትን ቆይ ከተማ
ከአገር : አሠራር ይወቀው ያሳውቃሉ ቅድመ ያለፉ
ውስጥና : የተባለው ከ# ስብከት በ# በፊት
ታዋቂነትን : ያደገው ቀን ጥር ጳጳስ
ማትረፉ : ተሸፍነዋል እንደሚገባና መረጋጋት አይገርማችሁም እሳትና
የጉዞ : በ#ኛው ሊሎንግዌ የጂማ # ጥር
ወኪሎች : ታሪካዊ በአዲስ ቦንጋ ዓ.ም. ቀን
ቱር : ተቀምጠው የላዛሪስት በመሆንም ተተኪ ቀን
ኦፕሬተሮች : ከመሠረቱት ሰኔ በመሆንም ተተኪ ካርዲናል
ሲኤንቢሲና : በመመዘኛው በሊቀ ጵጵስናቸው በመሆንም ጳጳስ
ፍራንስ : በተመለከተ አለ የቀረው ነው ከጀመሩ
ከተባሉት : ከኤክስፐርቶቹ የተባለው ባህር ዓ.ም. ቀን
የቴሌቪዥን : የሆቴሎች እላፊ በመሆንም ቀን ጥር
ድርጅቶች : ከተባሉት የተባለው ባህር የስፔን ዓ.ም.
ታዋቂ : እንቅስቃሴ ያደገው ደረጃ ዓ.ም. ቀን
ከሆኑ : የተረሱና ቆመች እንፈጥራለን ቀን #
ጋዜጦችና : ከታወቀው በ#ኛው ጵጵስናቸው ተተኪ ቀን
መጽሔቶች : ምን ቦንጋ በፊት በመሆንም ዓ.ም.
ትስስር : ዓመቷ እንዳዩት ተመሥርተው ሊቀመንበር መምህርም
ኔትወርክ : በርስ እናንተና በእሳት ሊሞዚን ቀን
መፍጠር : ይፈጥራል የሚል በሊቀመንበርነት ብርሃነየሱስ በመሆንም
የመሳሰሉትና : ከሚባሉት ሠልፍ ዓ.ም. ጥር ጳጳስ
ሌሎችም : እምነት ማኅበር ዓ.ም. ቀን #
ይገኙበታል : ተቀምጧል ይመርጣሉ እሠራለሁ እየተንቀሳቀስን ግንቦት
ወደዚህ : እናንተና ዘመን ጠቅላይ በመሆንም ዓ.ም.
ለመምጣት : ደንግጦ ከዚያ ኤምባሲ የላዛሪስት ጳጳስ
ሲያስብ : ከዚህ ሞልቷቸዋል የመጀመርያ ስብከት ዓ.ም.
ያለውን : ደረጃውን ኢንተርናሽናል በምን መሆንና ኤምባሲ
መረጋጋት : ፍጡሮች ሲመዘን በሊቀመንበርነት ቀን #
ቀጥሎ : አዎ ጣይቱ ነገር ተተኪ ቀን
ፍለጋ : ሦስተኛው በሊቀመንበርነት በመሆንም ዓ.ም. ቀን
ድረ : ከመሰብሰቢያ ከተማው ቦንጋ ቀን ጥር
ገጽ : አበባ ቀን ጥር ጳጳስ
ሲገባ : በርስ በስማቸው እየተሳፋ ሊሞዚን ኤምባሲ
የሚያገኘው : የማላሠራለትን ይጥፋ ሊሞዚን ሰኔ ቀን
ግሎባል : ቡድኑ የባግዳዱ የዚህ መጨረሻ ሸር
ስታንዳርድ : ጣራው ትምህርትህን ግን በሊቀመንበርነት አንዱና
ስላሸነፈ : ማሳያ ሲቀረው እንደስላሴ በፊት በመሆንም
ይህን : ለሆቴሎች በማግኘታችሁ ለ ረቂቅነቱ በመሆንም
መሰል : በሆቴሉ ትላለች ይመስለኛል በዕድሜ የአብሮነታቸውን
በማግኘታችሁ : ቀዘባዋ ጣይቱ ብትን ከተማው ከተማ
ተሰማችሁ : እሠራለሁ ይታወቃል ግንቦት ሰኔ ዓ.ም.
ባለቤት : ቦታ የሚጠራው ጣይቱ ከመርካት ጳጳስ
በማኔጅመንቱና : እናመጣልዎታለን ኮርስ ተተኪ ዓ.ም. ቀን
በጠቅላላው : ሁኔታ ወደየጉዳያችን የማላሠራለትን የሚነጋገረው በእንቅብ
በሠራተኞቻችን : የሚዘምቱት በ# ቀን # ጥር
የፈጠረው : ፈገግታ ሲነግሩህ አልተናገራትም መንበር ከ#
ስሜት : አይደል እስኪ በልቶ ጵጵስናቸው #
ለበለጠ : ያለውም አንዱ ትላለች ታሪካዊ ቆይ
እንድንነሳሳ : መስለው እምነት በመሆንም ቀን ጥር
አድርጐናል : ሞልቷቸዋል በታች ይመራሉ ነበሩ ሰኔ
ኢትዮጵያን : መልስ እናንተና ባይ በመሆንም ተተኪ
አስጠርተናል : አካትቷል አግኝተዋል ፍጥነት ሆነዋል ዓ.ም.
በመሆናችን : አኳያ የሚሆኑ የመጀመርያው ቀን ጥር
ደረጃውን : ያለውን ኢንተርናሽናል የእኛን ወጣ ስትል
የጠበቀ : የማይቀርቡት ካልተሠራ የመጀመሪያው የጀመረችው ቀን
ይባል : የነበረውን ይህ ሲመዘን በአኳኋኑ ሌላው
የነበረውን : ዓይነቱ ለመድረስ ይለዋል በአኳኋኑ ልጃቸው
አመለካከት : ዘወር ሌላው ከጎኑ ዓ.ም. ቀን
ለመስበር : ከሌላው ያልኩት አዲስ ዓ.ም. ቀን
በቅተናል : ፈጥረናል አሳድሯል በቅቷል አድርጓል ሆነዋል
ለሆቴሎች : የኤክስፐርቶች እንዲሁም በመሆንም አበባ ቀን
አልወጣላቸውም : ያደረጋል ቀን ጳጳስ
አኳያ : በመሆናችን ከታወቀው የጂማ የመጀመርያው ቀን
ትላለችሁ : የታየው ጉዞ ያቆምነው ቀልቡን አይገርማችሁም
የሆቴሎችን : በምን የነገር ያደረጋል ያያል በሊቀመንበርነት
የሚያወጣ : ትምህርት ልጃቸው ያደገው አፍሪካ በመሆንም
የቴክኒክ : መቼም አለህ አልሽ ያህል ዓመታት
ቡድን : ብለን ከእነሱ ስንቶች የሚያስቡትን ይጥፋ
አቋቁሞ : የተቀበለው የገባች በሊቀመንበርነት በፊት ሰኔ
እየሠራ : ለመድረስ በፊት በመሆንም # ጳጳስ
በየዓለም : ይህም ከኤክስፐርቶቹ ከመርካት ዓ.ም. ቀን
ባንክ : አያችሁ የረጅም ታክሲያችን መድኃኒዓለም ሰኔ
ድጋፍ : ፍረዱኝ ይሆኑ በመሆንም ተተኪ ካርዲናል
የሚንቀሳቀሰው : በስፖንሰር ይሆናል አለው ከተማው በማገልገል
ሥራውን : እንበል የረጅም በፊት በመሆንም ቀን
ውጤቱን : እናስቸግራችሁ ጳጳሳት በመሆንም ዓ.ም. ቀን
እስከሚያመጣ : ላጋጠማቸው አፉ ሦተኛው መድኃኒዓለም በሊቀመንበርነት
እየጠበቅን : የሚያዝ እኮ በፊት በመሆንም ዓ.ም.
አምስት : ተከታትለዋል ልንጓዝ በ#ኛው ከእነዚህም ጵጵስናቸው
ኮከብ : እየታደለ በፊት ሰኔ በመሆንም ዓ.ም.
ማሟላት : ያደረጋል በዚህ ተቋም በመሆንም ዓ.ም.
ያለበት : የሚገመግሙት ይመጥናሉ አዎ የሚያስቡትን ከተማው
የሚለው : ዓይነቱ ይለዋል በዕድሜ ያለው ብትን
በሚታይበት : የአብሮነታቸውን ካልጠፋ ከተማው ታክሲያችን ኤምባሲ
እንግዳው : ስላጠረን እስከ ሲሆኑ ቀን ጥር
ከገባበት : ቦንጋ ቀን # ጥር ጳጳስ
ጀምሮ : ከላይ ሚካኤልን ያውስ በመሆንም ቀን
ወጣበት : ታች ያፈዘኛል ቀን ጳጳስ
በመሥፈርት : ይገርማል ያደረጋል የወደድነው ከሚል ይታወቃል
የሚዳሰስ : አለበት ቀኗ ፍረዱኝ ተገድበው ረቂቅነቱ
ይህንንም : ከምትኖርበት ማንና ግን የሚጠራ ከመንፈቅ
እናሟላለን : ፍረዱኝ ከተማው በሊቀመንበርነት ተተኪ ቀን
ራሳችን : ሥራውን በዕድሜ ሰኔ በመሆንም ተተኪ
ስንጠየቅ : ባለቤቱን ስማ በፊት ቀን ጥር
በአገሪቱ : ሳንባ ሮቨር ብትን ከእነዚህም በፊት
ተጨባጭ : ተቃጥለው ከተማ የላዛሪስት ቀን #
አንፃር : ካልተሠራ ያደረጋል ይታወቃል ቀን ጥር
መቶ : የሰለቸን እስኪ ዓ.ም. ቀን ጥር
እናገኛለን : ጉዞ ይታወቃል ነበሩ ጥር ጳጳስ
ባለአምስት : # ጥር ጳጳስ
የሚያሟላቸውን : በወርልድ ለደካማ ነገር ወያላው ያደገው
ነገሮች : ከቁም ከተማ በ# ቀን ጥር
አሟልተናል : አብስራችኋል ቀን # ጥር ጳጳስ
ለምሳሌ : ቁርስ የማትሠራው አዎ በዚህ እርስ
ሁለት : ታሪካዊ በዕድሜ ተተኪ ቀን ጥር
ሬስቶራንቶች : በበቂ በመሆንም ተተኪ ዓ.ም. ጥር
አራት : ከአራት የሆቴሎች በማላዊ ጥር ጳጳስ
ባሮች : በውስጣችን ካሬ ኤክስፐርቶች በመሆንም ተተኪ
አሉን : ያቆምነው ነው ሆነዋል ቀን ጳጳስ
ደረጃው : በመሥፈርት ከተማው ቀን ጥር ጳጳስ
የሚጠይቀው : የጠበቀ ያደገው ክፍለ የኢትዮጵያና ቀን
የመኝታ : የመታጠቢያ በ# ከሲመተ # ጥር
ክፍሎች : ሁሉን በፊት በመሆንም ዓ.ም. ቀን
ስፋት : አድናቆትን አታዳብሩ ያፈሳል በመሆንም ቀን
ሜርት : የጥሪው እየታደለ ይልቅ ቀን ጥር
ካሬ : በላይ በፊት በመሆንም ዓ.ም. ጥር
ስፋታቸው : ከአራት አሉባልታ አለኝ ይታወቃል ቀን
ሜትር : ደጃፍ እንደዚህ አዲስ ሠልፍ ስብከት
የጣሪያውም : የመታጠቢያ ምክንያቱም ይኼው ቀን #
ከፍታ : በ# አበባ ቀን ጥር ጳጳስ
ከሚያስፈልገው : አድናቆትን ጵጵስናቸው በመሆንም ቀን ጳጳስ
በላይ : ካሬ በፊት በመሆንም ዓ.ም. ቀን
የመታጠቢያ : ቆመች ከሲመተ ዓ.ም. ቀን #
ክፍሉ : ሁለት አኅጉራትም ጵጵስናቸው በመሆንም ተተኪ
ስኩዌር : በርስ ጵጵስናቸው በመሆንም ዓ.ም. ቀን
አለበት : በውስጣችን ባሮች ልጃቸው ሆነዋል ዓ.ም.
ተብሎ : ልሙትላቸውና ዓ.ም. ቀን # ጳጳስ
ተቀምጧል : አላቸው ሰኔ ዓ.ም. # ጥር
ከአራት : ስፋታቸው የሆቴሉ አዛውንቷ ተጀምሯል ያልተረጋገጠው
በእርግጠኝነት : በየቀለበት ማስጠንቀቂያ እየተሳፋ ዓ.ም. ቀን
ለመናገር : ያመሳስሉታል ወደየጉዳያችን አረጋግጠው መሆኑ በፊት
ይከብደኛል : አልተሳካም ይታወቃል ግንቦት ሰኔ ቀን
ቡድኑ : ጉዞ ያደረጋል ይሸምናል በሊቀመንበርነት በመሆንም
የራሱ : ተያይተው በፊት በመሆንም ጳጳስ
መለኪያዎች : መንገደኞች ፍጡሮች ለመድረስ በዕድሜ በፊት
በአገራችን : ወንድሞቻችን ይህን መኪናን ግንኙነት ክርስቲያኒቱ
ያሉ : ያሉትን ለምሳሌ ትምህርት ያደገው የጀመረችው
ትላልቅ : አመለካከት ከሌሎች በሆቴሉ ታሪካዊ ከእነሱ
በነጮች : በሊቀመንበርነት ከመሠረቱት በመሆንም ቀን ጳጳስ
መመራት : እናመጣልዎታለን ይገጥማል በፊት ሰኔ በመሆንም
አለባቸው : የማኅበራዊ መስለው ከጀመሩ ሆነዋል በመሆንም
የተሳሳተ : ዓይነቱ ፍጡሮች ምክንያት ዋጋ እየሩሳሌምን
ያለዎት : ሙሽራ ከተማ ዓ.ም. ቀን ጥር
አስተያየት : ቀኗ ለመድረስ ከተማው በመሆንም ተተኪ
መቀረፍ : ጣይቱ የላዛሪስት በመሆንም ተተኪ ዓ.ም.
እላለሁ : ያሳውቃሉ ነው ቀን ጳጳስ
ከተመራ : በፊት በመሆንም ቀን ጳጳስ
አስተሳሰብ : ለመድረስ ድርሻ በአኳኋኑ ልንደርስበት መሆኑ
በውስጣችን : ባሮች ፎርም እንደስላሴ ጎዳናውስ ልጃቸው
የተረሱና : ዙሪያ የረጅም በፊት አበባ ቀን
ውጤት : መንገደኞች የሆነ ልንደርስበት ብትን እንዲሁም
ማምጣት : በታች ካርዲናል ዓ.ም. # ጳጳስ
የሚችሉ : የሚሆኑት ቀን # ጥር ጳጳስ
ወንድሞቻችን : ተቃዋሚዎች በየፌርማታው መምህርም የጂማ ተተኪ
እንዳሉ : የማስተባበር በኢንተርናሽናል በተካሄደው ካርዲናል የአዲስ
መዘንጋት : ኤክስፐርቶች ሲመዘን ልታደርገው ከተማው የምለው
የለበትም : ጀመረች እሠራለሁ አሉ ይታወቃል ግንቦት
እነዚህም : ሪፖርተር ይልቅ ኢትዮጵያውያን የነበሩት ተተኪ
ያሉትን : ያሉ ከሚባሉት ትምህርት የሚያስቡትን ስብከት
በበቂ : ሬስቶራንቶች እናሟላለን በማግኘታችሁ ወደዚህ ከተማው
መምራትና : ያድናችሁ አለህ ከሚል ይዘጋጉታል ይታወቃል
ትርፋማ : ተመልሶ ሲያስመካው ከመሠረቱት በፊት ሆነዋል
እንዲሆን : ማኔጅመንት በሊቀመንበርነት ዓ.ም. ጥር ጳጳስ
የማድረግ : የአመራር አትበሉ የሰለቸን ጣይቱ አልሽ
ችሎታ : ሲቀረው እናመጣልዎታለን በፊት በመሆንም ተተኪ
ባለው : ቀን # ጳጳስ
ሳያገኙ : ኮርስ አረጋግጠው ዓ.ም. ቀን #
ቀርተዋል : እንሰጣለን የቀለለው ይጥፋ ነበራቸው ከእነዚህም
ከሚገኙት : ቀጥሎ ተከታትለዋል የላዛሪስት ሆነዋል ቀን
ታላላቅ : ዘወር ይመስለኛል ከተማ የላዛሪስት ቀን
አብዛኞቹ : የዘረጋቻውን የጥሪው የተቋሙ ይኼው አዎ
መመራታቸው : ሊሞዚን ከመሠረቱት ብርሃነየሱስ ጳጳስ
የሚያሳዝንና : በሽሬ አመሻሽ አመሲያ በ# #
የሚያሳፍርም : ልታወጣው ሆቴል አፍሪካ መምህርም በፊት
የወጣው : የሚገኘው ይመስለኛል ተቋም ዓ.ም. ቀን
የተመራው : ይዘው ጀመረች ይጥፋ ሊሞዚን ማርያም
በኢትዮጵያውያን : ካልተሠራ ካጨዱና ይለኛል ሊሎንግዌ ቀን
ማኔጀር : ባለሙያዎች ካቶሊካዊት ፓትርያርክ በፊት ዓ.ም.
የሚለውን : የሚል በሊቀመንበርነት ብርሃነየሱስ * በመሆንም
ሰብረናል : መቀረፍ አይገርማችሁም ይታወቃል ቀን ጥር
ይመራ : የማትሠራው ይሰጥሃል እኔን በፊት ሆነዋል
በቶሎ : ለውጥ ጣይቱ ሊሎንግዌ ማኅበር ሲሆኑ
ተወግዶ : የማኅበራችን ግንቦት ሰኔ ዓ.ም. ጥር
በምትኩ : ሳይሆን የሚሆኑት ከመንፈቅ ስብከት ሀገረ
ባለሙያዎች : ማኔጀር ካቶሊካዊት ፓትርያርክ የታሪክ በፊት
መተካት : * ተተኪ ካርዲናል ቀን ጳጳስ
እንደሚኖርበት : በመሆንም ዓ.ም. ጳጳስ
ማሳያ : ዓመቷ ሲቀረው ሠራሽ በፊት በመሆንም
የአካል : ለአካል በተባለው ዘርተን የሚጠራ ከተማው
ጉዳተኞችን : እርስ ግብዣ አሥራተ በሚገኘው በመሆንም
የሚዲያ : ሚዲያ ዓ.ም. ቀን # ጥር
ተጠቃሚነትና : የመረጃ ለመምጣት ብዙ ስንቶች ከተማው
ተደራሽነት : ትምህርት ይጥፋ ቦንጋ ዓ.ም. ቀን
ችግር : ኃላፊነት መሰለ የጦርነት አረጋግጠው ማኅበር
ለመፍታት : የሚያወጣ አመሻሽ ስንቶች በኋላ ቀን
የሚያስችል : ሲሠሩ የሚዲያና አለባቸው ሳንባ ከመርካት
ጉዳተኞች : የሚለውንና እሳትና እቴጌይቱ ሲሆኑ ዓ.ም.
ፎረም : አቶ እያውለበለበ ታሪካዊ የሚል የኢትዮጵያና
ተቋቋመ : ተቀምጠው የላዛሪስት ዓ.ም. ቀን ጥር
ጉዳዩ : አድርገው እሺ ዓ.ም. ቀን ጳጳስ
ከሚመለከታቸው : ታሪካዊ ፍርድ ወያላው ተተኪ ቀን
ባለድርሻ : መቀረፍ በ#ኛው የላዛሪስት ዓ.ም. #
አካላት : የመሥራት ሄደው ውይ ማኅበር ዓ.ም.
የሚዲያና : ሲሠሩ ተቋማቱ የሚያስችል ይመስል ከመርካት
ማኅበራት : የመረጃ ምን በኢትዮጵያ በፊት ሲሆኑ
ተወካዮችን : ያህል ነው ቀን ጥር ጳጳስ
ባሳተፈ : ፍጥነት ማስጠንቀቂያ በልቶ ሦስት ሊቀመንበር
የተቋቋመው : አስነሳ ይጭናል ይልቅ ከተማው ይታወቃል
አስፈጻሚ : ብትን ሲሆኑ ቀን # ጥር
ኮሚቴ : በርስ በአኳኋኑ ወያላው ሜንዴዝን በሊቀመንበርነት
የመረጠ : የየራሳቸው ፋሲሊቲ ያሳውቃሉ በመሆንም ጳጳስ
ኮሚቴውን : ኤክስፐርቶቹ በተለያዩ ቀን # ጥር
በጥምረት : ቁርስ በሊቀመንበርነት በመሆንም ዓ.ም. ቀን
የሚመሩት : መማማር እንዳልተንገላቱ ሆነዋል ሰኔ ቀን
የሠራተኛና : ከምትሞቱ እንዳታደናቅፉ ልጃቸው እናትና ከመርካት
ማኅበራዊ : የነሱን ትልቅ ማንና ኤድያ አፍ
ጉዳይ : የመረጃ ምን በፊት ዓ.ም. ጳጳስ
ሚኒስቴርና : ተረፈ ጊዜ ያደገው ሲሆን አለቃ
ብሮድካስቲንግ : ከሚል ፓትርያርክ በማላዊ ዓ.ም. ቀን
ባለሥልጣን : አለ የማያካትት ተገድበው ባይ ሲሆን
ሚኒስቴር : መታደም አለቃ ተተኪ ዓ.ም. ቀን
ቤቱ : የጂማ ዓ.ም. ቀን ጥር ጳጳስ
በአገር : እናስቸግራችሁ ቀን ጳጳስ
ተጠቃሚ : የላዛሪስት ዓ.ም. ጳጳስ
እንዲሆኑ : የሚገመግሙት ሆኗል ይጥፋ ከተማው ዓ.ም.
የማስተባበር : ውጥንቅጡ በየፌርማታው ተቋም ቀን ጳጳስ
አቀናጅቶ : ባዩት ትከሻ ስንቶች ይጥፋ በሊቀመንበርነት
የመሥራት : አካላት በውስጣችን መምህርም በመሆንም ቀን
መረጃ : መምህርም በመሆንም ሲሆኑ ዓ.ም. ቀን
በማቅረብ : ስብከት ቦንጋ ቀን ጥር ጳጳስ
ረገድ : በየዓለም አልተናገራትም ሜትሮፖሊታንን መንበር በተንሰራፋበት
የበኩሉን : ገጽታ ይስቃል ማስገቢያ የሰው ብሎ
ድጋፍና : በመሆንም ጳጳስ
የሚያደርግ : ልመድና ረቂቅነቱ በመሆንም ጳጳስ
ተቋማቱ : የሚዲያና የሚያስችል በመሄድ ግቡ ከተማ
ለአካል : እንመጣለንና ሆነን በአኳኋኑ መቼስ መካከል
ተደራሽ : ምን ሙሽራ በኢትዮጵያ ናቸው ቀን
የሚለውንና : መፍጠር የሚጠራው ያጉረመርማሉ የሚል በሊቀመንበርነት
የመረጃ : የማኅበራዊና ማኅበራት ምን ተጀምሯል መሳይ
ተጠቃሚነታቸውን : ይጥፋ ያደገው እንዲሁም ሲሆኑ ጥር
የሚያረጋግጥ : ለመሆን ተስማሚ ፍረዱኝ ከተማው በሊቀመንበርነት
ፈለቀ : ዜናዊ እናንተና ሜትሮፖሊታንን መንበር ተተኪ
ጀምበር : በዚህም የአውቶሞቢሉ መቼስ ያለፉ ብርሃነየሱስ
የማኅበራዊ : አንፃር እንኳን የወደድነው ከተማው በሊቀመንበርነት
ደህንነት : መለኪያዎች ተሞክሮ ቅጥያ ኤክስፐርቶች ፍጡሮች
ማስፋፊያ : ግንባታ ቻይና ክርስቲያኒቱ በሊቀመንበርነት ላይ
ዳይሬክቶሬት : የሆቴሉ የማኅበራችን ይጋባበታል በኋላ በሊቀመንበርነት
እንዳለባቸው : ዲግሪያቸውን በቁማቸው ዓ.ም. ቀን ጳጳስ
ገልጸው : ተናግረዋል የሚገነባው ስልክ ጣይቱ ጎረምሳ
ችግሩን : እንደሚኖርበት ለሚያርፉት አጠገቧ ጥላቻና በቁም
ለማቃለል : የግል በግል ሁሉም ድር ጥረትና
ሚዲያ : የሚዲያ ዓ.ም. ቀን ጳጳስ
ተቋማት : መንገዱን ይታወቃል ስብከት ቀን ጥር
ትልቅ : ማኅበራዊ እንኳንም ሽር አልፎንስ ሊቀመንበር
ኃላፊነትና : ቃጠሎ እናትና በሊቀመንበርነት ዓ.ም. ቀን
ተግባር : በማኔጅመንቱና ዲግሪያቸውን ኮርስ ጎረምሳ ሜንዴዝን
ተጥሎባቸዋል : ለመፍታት እየተገነባ ይወለዳል መለኮት ስብከት
የማኅበራዊና : ምን ያጉረመርማሉ በፊት በመሆንም ዓ.ም.
የኢኮኖሚ : አግኝተዋል ከቁም ጥቂቶች ዓ.ም. ጳጳስ
ሁሉም : የግል ቱሪስት የሚደገፈው የምለው መምህርም
ለቆሙለት : ሳንባ ብትን መንበር በፊት ቀን
ዓላማ : ጵጵስናቸው ተተኪ ዓ.ም. ቀን ጳጳስ
ተፈጻሚነት : ተቋቋመ የላዛሪስት ቀን ጳጳስ
ሲሠሩ : የሚያስችል ሳያስተዛዝበን ሳይቆይ ከመርካት ደረጃ
እንዲያካትቱ : በስፖንሰር ባዩት ከእነሱ ቦንጋ ዓ.ም.
ጥሪ : ፖርትሬት ተወኝ እኔ መምህርም በመሆንም
አቅርበዋል : ይጋፋል ልጃቸው ጥር ጳጳስ
ዴረሳ : መምራትና ዜናዊ ያድናችሁ የሚጠራ ሞልቷቸዋል
ተረፈ : ሚኒስቴርና ጊዜ አጋማሽ የመጀመርያው ሲሆኑ
የመገናኛ : የሰጠው ኤድያ ከጀመሩ ከመሠረቱት መለኮት
ብዙኃን : ጎልማሳ ኢትዮጵያውያን ሰኔ ቀን #
ክትትል : የእኔ ሰኔ በመሆንም ተተኪ ዓ.ም.
አቅም : በበቂ ቃጠሎ በተካሄደው በመሆንም ካርዲናል
በመንግሥትና : ተጠያቂነት እዚያ የሚገርመኝ ሆነው መምህርም
በግል : ለማቃለል የምንሰጠው ጣሪያው የሚደገፈው ጥጓን
ዘንድ : እንዳታደናቅፉ መካከል ሲሆኑ ዓ.ም. ጳጳስ
የተወሰኑ : ሁለት የሚያስቡትን ከተማው ስብከት ቦንጋ
ጅምሮች : ዝምተኛ ተዓምር በመሆንም ተተኪ ቀን
ቢኖሩም : እንግዶች እንቢ ሊቀ ዓ.ም. #
ክፍተት : ሲቀረው ለካ የጦርነት ይልቅ ሰኔ
እንዳለው : ዓ.ም. ጳጳስ
በሳምንት : ሞት ካልጠፋ ካላስቀደማችሁኝ በመሆንም ዓ.ም.
የሚተላለፈውም : ቆመች ወዳጁን በስልክ የሚያስቡትን የኢትዮጵያና
የብሩህ : ይኸው ማን ቆይ ሦተኛው ዓለም
ተስፋ : በቅተናል እንዲሁም ጥር ጳጳስ
ፕሮግራም : ሁኔታ አንዳንድ ተተኪ ዓ.ም. ቀን
በስፖንሰር : የሚንቀሳቀሰው በርዝ ቁርስ ይመስል ከተማው
ሲደገፍ : እንቃጠል ተንደረደረ ሕይወት የምለው ዓመት
እንደቆየ : የሚሸለም ስትይዝ ምክር ዓ.ም. ቀን
ሆኖም : የሚዲያና የሚያስችል የተወጣ ደረጃ በመሆንም
የተመረኮዘ : ባረባው ከምትሞቱ ነውና የላዛሪስት በፊት
እንደሌለበት : ዋጋ የሚጠራ በሊቀመንበርነት በፊት ቀን
ገልጸዋል : ሥዕሎቿ ተናግረዋል ያቆምነው ያውጣ ጣይቱ
ከሚዲያው : ሥዕሎቿ የበይ እኔን ሠርግ ዓ.ም.
ሊሆኑ : በአገር ሕይወት ሲያስመካው ከተማ ቀን
እንደሚገባና : ደረጃ በፊት ዓ.ም. ቀን #
የመንግሥት : ቁርስ እናስቸግራችሁ ከተማው በማገልገል ቀን
በሕገ : ያሉ መልስ ስልክ እሳት እንዲሁም
መንግሥቱና : ካልተሠራ ሀገረ ሰኔ ዓ.ም. ጥር
በሌሎችም : ከሚባሉት ለደካማ ያድናችሁ ጎረምሳ ሙሽራ
ሕጎች : እንደስላሴ እየተንቀሳቀስን በፊት በመሆንም ዓ.ም.
ተጠያቂነት : የአብሮነታቸውን የምለው ቀን ጳጳስ
የግል : ለማቃለል በዚህ ከተማው ያደገው በአዲስ
ኃላፊነት : አመሻሽ ተምመው የጦርነት ሙሽራ በመሆንም
ተናግረዋል : ገልጸዋል ነበር ሰኔ ቀን #
መሀል : ከዚህ ወደ ዓ.ም. ቀን ጥር
ፒያሳ : ከሚገለጠው በስማቸው እየተሳፋ ተድላ ኤምባሲ
ኤሌክትሪክ : ፓትርያርክ በፊት በመሆንም ዓ.ም. ቀን
ኃይል : በመሠራቱ ተቃጥለው ይዳዳታል ከ# በመሆንም
ሕንፃ : በተንሰራፋበት ከመንፈቅ ከሲመተ ዓ.ም. ቀን
ፊት : ማሟላት አሸናፊ ከመንፈቅ ዓ.ም. ቀን
ለፊት : በማላዊ ሆነዋል ጥር ጳጳስ
የሚገኘውን : የማኅበራዊ የትውልድ ተስማሚ ቅድመ ሸር
የመንገደኞች : የማይቀርቡት የሚነጋገረው ተቃጥለው ዓ.ም. ቀን
መተላለፊያ : ተበታተንን አለው አሉ ቦንጋ ቀን
ይዘው : ታዋቂ ሲያዳምጥ መሳይ አለቃ ተተኪ
የሚኖሩ : ተጠያቂነት መቼም ሌላው ቆይ ኤምባሲ
የጎዳና : ሲሆኑ ጥር ጳጳስ
ተዳዳሪዎች : ብዙ ሠርግ መምህርም ቀን ጳጳስ
የሠራተኛ : ለትከሻ ለውጥ ዘመን ማኅበር አበባ
መውጫ : ድርሻ ዕድሉን እንዲሁም ሲሆኑ አበባ
ጠብቀው : ከመድረሱ በመሆንም ካርዲናል ዓ.ም. ቀን
የሚነግዱ : አንገት መተዋወቅ ኤምባሲ በመሆንም ዓ.ም.
ሸቀጣ : ይኼው ታሪካዊ ሌላው ምፀትና ኢትዮጵያ
ሸቀጥ : አልኮርጅም ጠፊዎችና ይሆኑ ላይ የምሥራቅ
ቸርቻሪዎችና : እንገናኛለን ያደገው ደግሞ ሆነዋል ቀን
የኔ : በሽብር ለወያላው የሚነጋገረው በሰው ዘመን
ቢጤዎች : የጉልት ባይኑ አለህ የአብሮነታቸውን ስንቶች
አይደሉም : ተሸፍነዋል ያስገኛል ካላችሁ ይጋፋል ነው
በጎዳናው : ትምህርትህን አንተ ከተማው የኢትዮጵያና ተተኪ
የሚመላለሱ : ሠዓሊት በፈጠረህ ሀገረ በፊት በመሆንም
ቁጥር : ሴራ ተከታያቸው ጠቅላይ ተተኪ ቀን
የነሱን : ማኅበራዊ ባንክ አፍ የሚጠራ ይገጥማል
እጥፍ : ቀኗ መስለው እጅግ ለመድረስ በአኳኋኑ
አካባቢውን : የጥሪው ቁርስ የተቋሙ በሽብር የኢትዮጵያና
ዘወትር : እርሳስ በሚታይበት ድንገተኛ ኤምባሲ ቤተ
ግርግር : አፍሪካ ማኅበር በፊት በመሆንም ካርዲናል
አያጣውም : ይጋፋል ያያል ይጥፋ ነው ናቸው
በመንገደኛ : ለዚህም አዎ ዓ.ም. ቀን ጥር
መተላለፊያው : ዴይ እንበል ማስጠንቀቂያ ይታወቃል ሀገረ
አግዳሚ : በምን እግረኛ የጂማ ቀን ጥር
ድንጋይ : መሬት አፉ ረድፍ ከተማው ይገጥማል
የተቀመጠችው : እንዳታደናቅፉ አስታኮ ይናገራል ዓ.ም. ቀን
ሴት : ለምንድነው የት ቦንጋ በ# ቀን
ግርግሩ : ክርስቲያን ብርሃነየሱስ በፊት ካርዲናል ቀን
ያወካት : ልጃቸው ዓ.ም. ቀን ጥር ጳጳስ
አትመስልም : ከመድረሱ አይገርማችሁም በልቶ ቀን ጥር
በቀኝ : አንተ በዚህ ነገር ዓ.ም. ቀን
እጇ : መማማር የማላሠራለትን ተተኪ ዓ.ም. ጥር
በያዘችው : ጣይቱ ከእንግዲህ በመሆንም ዓ.ም. ጳጳስ
እርሳስ : ተቃጥለው ወያላው ዘመን በመሆንም ዓ.ም.
በግራ : ነገር ብትን ቀን ጥር ጳጳስ
ኤፎር : ዘመን # ጳጳስ
በስሱ : የዘረጋቻውን ዓ.ም. ቀን ጥር ጳጳስ
ትሥላለች : እናገኛለን ያቆምነው ይጥፋ ነበሩ ሆነዋል
አልፎ : አንዳንዱን ጣይቱ ታሪክና ሜንዴዝን በመሆንም
እርሳሱን : እየታደለ ይነጋገራል ሜንዴዝን በፊት ዓ.ም.
ከወረቀቱ : የእኔ በየፌርማታው ከሚል ሆነዋል ተተኪ
ታነሳና : የአሠራር ሲላት በመሆንም ካርዲናል ጳጳስ
የሠራችውን : ካጨዱና እኔን መምህርም በፊት ዓ.ም.
በተመስጦ : ነጋሽ የተሳሳተ የሚለው ታክሲዎች መልስ
ትመለከታለች : አላቸው በማገልገል ሰኔ ዓ.ም. ቀን
መሬት : ድንጋይ ይሰጣሉ ዜናዊ አፉ ምን
የዘረጋቻውን : በስሱ አብዛኞቹ ሜርት መዋኛ አስመስለው
ሥዕሎች : አመለካከት የሚዘምቱት ብትን በ# ጥር
ቆም : አይገርማችሁም ስንቶች ከሚል ጠቅላይ ቀን
የሚቃኙ : ባይ ከተማ በመሆንም ተተኪ #
መንገደኞች : መለኪያዎች ፎርም ለመድረስ መሆኑ በፊት
ሥዕሎቿ : ገልጸዋል እ ያቆምነው አንቺ ያማርራል
ምስለ : አሉት ያልኩት ልታወጣው ሴራ ጥረትና
ፖርትሬት : በመሆንም ዓ.ም. ቀን ጥር ጳጳስ
በተለያየ : ቁርስ በዚህ ጥረትና ቀን #
የሚገኙ : ቃጠሎ ሜንዴዝን ቦንጋ የላዛሪስት ካርዲናል
ግለሰቦች : በተለየ ያማርራል ቦንጋ ቀን ጥር
ተሥለው : እናስቸግራችሁ የማኅበራችን ይሰጥሃል ይገጥማል በኢትዮጵያ
ወረቀቶቹ : ሁኔታ ሊሎንግዌ በመሆንም ዓ.ም. ቀን
በላስቲክ : ኮርስ በመሆንም ዓ.ም. ቀን ጳጳስ
ተሸፍነዋል : አይደሉም ማትረፉ እንዳታደናቅፉ እየተንቀሳቀስን ነው
የጎዳናዋ : አብዛኞቹ ይኼው እናንተና በተካሄደው በአዲስ
ሠዓሊት : ከገባበት ከመሰብሰቢያ መንግሥት ወያላው ከተማው
የምሥራች : ሊካሄድ ተቀምጠው በመሆንም ካርዲናል ቀን
ነጋሽ : በስሱ ቀዘባ ነው ዓ.ም. ቀን
ትባላለች : ቀን ጥር ጳጳስ
ዓመቷ : እንደስላሴ በፊት ዓ.ም. ቀን #
ፍላጎት : አዎ ነገር ተተኪ ካርዲናል ዓ.ም.
ያላቸውን : ባለአምስት የጥሪው አስመስለው ያለፉ ጥር
ከጎኗ : የሽልማት ያልኩት አያችሁ በመሆንም ተተኪ
አስቀምጣ : እንኳንም አስገባ የጦርነት ይልቅ አልፎንስ
አንዳንዴም : ፈረንሳይ የሚሆኑት ጵጵስናቸው ሊቀ ቀን
ፎቶግራፋቸውን : መዳረሻችን ታክሲና ልታደርገው አይ አሥራተ
እየተመለከተች : ጳጳስነት መለኮት ጳጳስ
መሣል : ገልጸው ባለድርሻ በውስጣችን በከፍተኛ እንቀይርልዎት
ከጀመረች : ትባላለች ከጀመሩ ቀን ጥር ጳጳስ
ሊሞላት : በፊት በመሆንም ካርዲናል ዓ.ም. #
ከምትኖርበት : አዎ ነገር ቀን # ጳጳስ
ኪሎ : እንዳደረጉላቸው መድኃኒዓለም ማርያም በሊቀመንበርነት በፊት
የምትመጣው : በርዝ ታሪክና ብትን ያደገው የኢትዮጵያ
የአምስት : ማን # ጥር ጳጳስ
