ይበጅ : ማድረጉ እንዲቆዩ መግለጽም በብዛት ሊፈርድ
ይመስለኛል : ሀሰትን ሰነባብቷል እንዴ ፖሊሲው በመረጋገጡ
* : ጎልቶ ቆራጭ ሐሳብበዓለም ሚና ለመጠበቅ
እዚህ : ያልፈተሹትን አዎንታዊ በሥጋት ተጭኗቸው ያለበት
ላይ : የሚባለውን ፍልስፍናዬ አምባገነናዊ ለመጠበቅ ገለልተኝነትንና
ግን : የድጋፍ የሚባሉ የኢትዮጵያ ማብቂያ ትንሽ
ገለልተኝነትንና : ሐሳቦቼን ሊያዝናና መርምሮ የክልል ይታይ
ሚዛናዊነትን : በከፍተኛ የፖለቲካ መሪዎችን ሚዲያ ለመጠበቅ
ለመጠበቅ : የያዘበት በማያፈናፍን በሥልጣን ከአገዛዙ የፈላጭ
የሚጣጣሩትን : ወዳጄ የሚዲያ በሥልጣን ከአገዛዙ የሚሰብክና
እንዳልዘነጋሁ : አለመሆናቸውም ከመሆን የሚወሰድ ተደርጎ አገዛዝ
ይታወቅልኝ : ይባላሉ ያደርጋል በ#ኛው ሐሳብ ለመጠበቅ
አምባገነናዊ : በባለቤትነት መርጠው ኢንዱስትሪውን ላይ እዚህ
ሚና : አቋም የልማታዊ አደረጃጀት ቆራጭ ሐሳብበዓለም
ንድፈ : የባንክ ያሉ ዴሞክራሲያዊ ሚዲያ እዚህ
ሐሳብበዓለም : ትክክለኛ ብቃት በነፃነትና ተቋማቱ ሚና
ሚዲያ : በየትኛውም ጉምሩክ ሌላ በመረጋገጡ በላቲን
ታሪክ : አስፈጻሚና ምሥራቁ ሥነ መሣሪያዎቹ ጭቁን
ቀዳሚው : በሥራ አድራሻቸው ወደኋላ ደርግ እንደመርግ
የሚባለው : አልያም የሚያነሱት ምርመራ በሥልጣን ለመጠበቅ
ይህ : የአፈና ክፍለ ለመጠበቅ እዚህ ይመስለኛል
ሐሳብ : ማሪዋና ስለማይችል የተባለው በአንፃሩ በላቲን
በ#ኛውና : ቢመጥቅ ሚዲያው የሚናገሩ የቦርድ የውጭ
በ#ኛው : መስፋፋት ፍልስፍና ለመጠበቅ እዚህ ይመስለኛል
ክፍለ : ሳምንት ይህ ለመጠበቅ ይመስለኛል ይበጅ
ዘመን : መስፋፋት ለመጠበቅ እዚህ * ይመስለኛል
በእንግሊዝ : እግዚአብሔርና ሰዓታት ካቶሊክ ቁጥሩ መራሹ
አገር : ያለፈ ብዙኃን ይነገራል የሚጣጣሩትን ግን
እንደተጀመረ : ኃላፊ እንደማይችል ዕድል እንዳይኖር እንዳልዘነጋሁ
ይነገራል : ተለመደ ሙሉ መሪዎችን ነው ግን
መርሆ : ማካሄዳቸው አለመስጠት የሚገባው የተስማሙበት አሠራር
የፈላጭ : መልካም ሥርዓት መገልገያ ለመጠበቅ እዚህ
ቆራጭ : ዲ የሚጠቅማቸውን ሚና * ይመስለኛል
ንጉሣዊ : የሚባል ይሁን ወጥቶና ከዕውቀትና አምባገነናዊ
አገዛዝ : በሸቀጥነት መኖራቸው ልብን ማረጋገጥ የሚወሰድ
ሥልጣንን : ሚዲያን ትንሽ ተደርጎ የአፈና የሚወርደውን
መለኮታዊነት : የምዕራቡ በአንፃሩ ከአገዛዙ አምባገነናዊ ላይ
የሚሰብክና : መርጦ እምነቱ አሁንም ከአገዛዙ የሚጣጣሩትን
ከአገዛዙ : በሥልጣን ለመጠበቅ ላይ እዚህ ይበጅ
የሚወርደውን : የአወሮፓውያኑ በሥጋት መሣሪያነታቸውም እዚህ ይመስለኛል
የአፈና : ይታዩና አነብናቢነት ይህ ለመጠበቅ ላይ
አሠራር : ገጽታዎች ጊዜ ፍልስፍናው የአፈና የሚወርደውን
አስፈጻሚ : መዋቅሮችን በሥልጣን ከአገዛዙ ለመጠበቅ ግን
ተደርጎ : ስለሚሰጣቸው ለባለሀብት አኳያ ውጤትም ወደኋላ
የሚወሰድ : እንዴት ባለሙያዎች ማረጋገጥ እንዳልዘነጋሁ ግን
ነው : ተለመደ ይታያል ነበሩ የአምባገነን ይነገራል
ዋናው : የነፃነት ዋነኛ የሚዲያ የአፈና የሚጣጣሩትን
ዓላማም : ከቴክኖሎጂ ወገን ገለልተኝነትን ፓርቲ ይህ
በሥልጣን : ለመጠበቅ ላይ እዚህ * ይመስለኛል
ያለውን : ሆኖም ስለኤሌክትሪክ የኮሙዩኒኬሽን የአሁኑን ኃላፊነት
መንግሥትንና : መሣሪያዎቹ መገለጫ ይህ ቀዳሚው ለመጠበቅ
የመንግሥት : ኃይሎችን ጭብጥ ውዝግብ የሙጭኝ ሚዲያዎችን
መዋቅሮችን : በመረጋገጡ አስፈጻሚ ሚና ለመጠበቅ ግን
በመደገፍ : ኒዮሊብራሊዝም መገልገያ ለመጠበቅ ላይ *
የአምባገነን : ኤመርሰን በገዥው ብዙኃን ንድፈ ግን
መሪዎችን : ኪሳራ ጉድለት ፍልስፍናን ባህሪ ሚዲያ
ሥልጣን : የሚወርደውን ሥልጣንን ቆራጭ * ይበጅ
ቀጣይነት : እንዲገነዘብ አባልነትና አሁንም ሁኔታ ተሳትፎ
ማረጋገጥ : የተፈታ የሚወሰድ እንዳልዘነጋሁ ይበጅ
የዚህ : አድልኦ ኢትዮጵያዊያንና የሐሳብ አምባገነናዊ የሚጣጣሩትን
የሚዲያ : በእጃቸው ዋነኛ የሚጣጣሩትን ለመጠበቅ ላይ
ፍልስፍና : ቅኝ የተመልካቹ መፈራረስና በ#ኛው ለመጠበቅ
ዋነኛ : የሚዲያ ዋናው የአፈና የሚጣጣሩትን ለመጠበቅ
መገለጫ : በባህል መከናወን ያልፈተሹትን ግንኙነትና መንግሥትንና
የቅድመ : አስተሳሰብ መሆኑን የአምባገነን ነው ንድፈ
ምርመራ : እነ የሚያነሱት የሚባለው ለመጠበቅ እዚህ
ሳንሱር : ቃል ሚዲያን ሥልጣንን ቀዳሚው የሚጣጣሩትን
ያለበት : ኒዮሊብራሊዝም አባልነትና ይህም እዚህ ይበጅ
መሆኑ : ሐቅን የሚጋርጥ የጋዜጣ ከአገዛዙ ለመጠበቅ
ይህም : ግንኙነትና ብለው ያለበት የፈላጭ ለመጠበቅ
በሙያተኛው : ስለሚችል ኃላፊዎችና ዕገዳና በሥልጣን የሚባለው
ነፃነት : በግል መስፋፋት በ#ኛው የሚባለው ለመጠበቅ
እንዳይኖር : ባንኩ ክትትል መልዕክት ምሁራን ቢኖርም
ያደርጋል : ተቀላቅለዋል አይደሉም ይታወቅልኝ ይመስለኛል ይበጅ
የሐሳብ : ጸሐፊ ይህን በአገራችን በአሁኑ በውስጡ
ነፃነትና : እያደነቃቸው ዕገዳና ላይ ይበጅ
የሕዝብን : መገልገያ ለመጠበቅ ሚዛናዊነትን ላይ እዚህ
ተሳትፎ : ይታዩና የአፈና ይህ ለመጠበቅ ሚዛናዊነትን
የሚያፍንና : ኒዮሊብራሊዝም ያለበት በመደገፍ አምባገነናዊ ለመጠበቅ
ዴሞክራሲያዊ : ቲ ለዴሞክራሲ አለመላቀቁ ንድፈ እዚህ
ባህሪ : የተመልካቹ ጉድለት መሪዎችን ለመጠበቅ እዚህ
እንደሌለው : መቀየሪያ ሲል አሁን የክልል በማያፈናፍን
ብዙዎች : መገናኛ የውጭ ንድፈ ለመጠበቅ ግን
የተስማሙበት : ታስቦ የተነሳ አይደለንም የሚታበል እንደቆሙ
ፍልስፍናው : የሚወዳቸውን ማንም የጋዜጠኝነት የአፈና ንድፈ
ዛሬም : አገሪቱ ቲ ጉምሩክ አለመላቀቁ ስለማይችል
ቢሆን : ነን በድፍረት በመጠኑ አገሮች አምባገነናዊ
እንደመርግ : በሥራ ደርግ ቀዳሚው ለመጠበቅ ላይ
ተጭኗቸው : ዜና የሆኑ እዚህ ይመስለኛል ይበጅ
ያሉ : ንድፈ ለመጠበቅ እዚህ ይበጅ
አገሮች : እጅ በማስመልከት ነጋሪዎች ወቅት የሚያፍንና
አሉ : አረጋግጠዋል ለማድረስም ታይቷል ይባላሉ ይታወቅልኝ
በአፍሪካ : ለማጠቃለል የአዲስ ዋናው አሠራር ታሪክ
ኤርትራን : የራሱን ቆሞ ለአዲስና አበባ ልማታዊነት
የመሰሉ : ሊሸፈን መንግሥትና ለመጠበቅ ላይ እዚህ
ጭቁን : ምዕራፍ # ታሪክ ሚና ግን
ሕዝቦች : በእስያ እየተስፋፋ የሐሳብና በመደገፍ ገለልተኝነትንና
በመካከለኛው : እብድ በዩናይትድ የዲሞክራሲ የፈላጭ ሚዲያ
ምሥራቅ : መተዋወቅ መኖራቸውስ ለሚዛናዊነት አሠራር የአፈና
በላቲን : በኤዲቶሪያል ሚዲያን ከአገዛዙ ለመጠበቅ እዚህ
አሜሪካና : የሚጎዳና መገልገያ መዋቅሮችን ላይ *
በእስያም : መተዋወቅ ቢታወቅም ባለው ነፃነት የሚሰብክና
ቁጥራቸው : በሥልጣን ለመጠበቅ ላይ እዚህ ይበጅ
ትንሽ : ቤልጄማዊው ጉድለቶችን በአንፃሩ ሥልጣንን ግን
አይደሉም : ገልጿል ያነሳሁት ያደርጋል ይታወቅልኝ ለመጠበቅ
የግልና : በአሁኑ በደርግ የሐሳብ ዘመን የሚጣጣሩትን
የውጭ : መገናኛ ሚዲያን ብዙዎች የአፈና ለመጠበቅ
ሚዲያዎችን : እንዳጫወተኝ ሚዲያን የመንግሥት አምባገነናዊ እዚህ
ፈቅደው : ከነፃ ከነምክንያቱ ይህም ላይ እዚህ
ሚዲያን : ባለመቻላቸው ፖሊሲ አንባቢያን ሀብት ጉድለትን
የሥርዓቱ : ግንኙነትና ብለው ይህም አምባገነናዊ ለመጠበቅ
መገልገያ : ባወጣው በማያፈናፍን ሥርዓት ለመጠበቅ ላይ
በማድረግ : ቀደም በጥልቀት የአፈና ይህ ላይ
ፍልስፍናን : ፍፁም መሪዎችን የሚባለው ለመጠበቅ እዚህ
የሙጭኝ : በማያፈናፍን የመንግሥት ለመጠበቅ ላይ እዚህ
ብለው : ግንኙነትና ይህም በመደገፍ ለመጠበቅ ላይ
የሚንገታገቱ : ዴሞክራሲ መንግሥትንና ይህ ሚና ለመጠበቅ
መንግሥታትም : አካል አዎንታዊ ነበሩ አሉ ንድፈ
መሀል : ተቸግሮ ምን ወይም በሚታትር ባህልን
መንገድ : ዘገባ ለውጥ አገራዊ ለሚነገር ምርመራ
እንደቆሙ : ያለ ክፍተት ድክመት የተስማሙበት ሥልጣን
ኢትዮጵያዊያንና : በሕጋዊ የዚህ መንግሥትንና ተደርጎ መለኮታዊነት
የአገሪቱ : የአሁኑን ሽብርተኝነትና ፈተና ኃላፊዎች ፈቅደው
መገናኛ : የውጭ ብዙዎች በሥልጣን የአፈና ለመጠበቅ
ብዙኃን : ኤመርሰን የሙያው የአምባገነን አገር ንድፈ
እስከ : ታስቦ ተፈጥሯል በባለሥልጣናት ቀብሯል የተስማሙበት
# : በይሉኝታ በቃላት በብዙዎቹ በማያፈናፍን እንደሌለው
ዓ.ም. : በቅድሚያ አንደኛው ሥርዓቱ ዋናው ይህ
ማብቂያ : የፌስ መንግሥት ግን እዚህ ይመስለኛል
ድረስ : ኤመርሰን የማይተች የሚያቀነቅኑ ብዙኃን የአምባገነን
ሙሉ : ከሪፖርተር ድምዳሜን ይነገራል ግን ይመስለኛል
በሙሉ : በአገራችን የማይችል ለዚህ የሐሳብ የሚዲያ
እንደተጫናቸው : ይዘዋወር ልጅ የሚገባው ብቻ መርሆ
ነበር : ፊላደልፊያ እንቀመጥ ጳጳሱ ፈጥኖ የጋዜጠኞች
በንጉሡ : ስለሚችል ገብነት የሐሳብ በሙያተኛው ሚና
ጊዜ : የእኛ አሠራር ይህ ለመጠበቅ እዚህ
በአንፃሩ : የኤሌክትሮኒክና እንደነበረው ሚዲያን መለኮታዊነት ሐሳብ
የተሻለ : ካለው መገለጫ በ#ኛው ይህ ሚና
የሙያው : ያለፈ ብዙኃን ፍልስፍናው መሪዎችን የአፈና
ቢኖርም : ዜና መዋቅሮችን እዚህ ይመስለኛል ይበጅ
ደርግ : መርጠው ኢንዱስትሪውን እንደመርግ ቀዳሚው አምባገነናዊ
የተባለው : የምዕራቡ ስለማይችል ሐሳብ አምባገነናዊ ግን
አፋኝ : በባህል አድርባይነትና ደኅንነት የሚያፍንና መገለጫ
ወታደራዊ : ጉልህ የለውጥ በማያፈናፍን ሚዲያን የውጭ
ሥርዓት : በመረጋገጡ መገልገያ ለመጠበቅ እዚህ ይመስለኛል
በማያፈናፍን : መገልገያ ለመጠበቅ ላይ እዚህ *
ሁኔታ : ፊላደልፊያ አጠንክሮ ቤቶች ተሳትፎ ቀጣይነት
የሐሳብና : በማድረጉም በተጨባጭ ኢንዱስትሪውን ደርግ ከአገዛዙ
የአመለካከት : በከፍተኛ መቶ የፕሬስ ሚዲያን ያሉ
ነፃነትን : ከሆነ አማራጭ አገዛዝ ንድፈ እንዳልዘነጋሁ
ጨፍልቋል : ወሰነ ይቀነቀናል ማበብ አይደሉም የሚባለው
ዜጎችን : ተደምሮ በአመለካከት # ሐሳብበዓለም ግን
በፖለቲካ : በተጠንቀቅ ኢንዱስትሪው መንግሥታት ዓለማዊ የኅትመትና
አስተሳሰባቸው : ለጥሬ በሥራው ፕሮፓጋንዳ የሚባለው ለመጠበቅ
ብቻ : ይዘዋወር እንዳይለውጥህ ሊወጣ መሆን እንደተጫናቸው
ገድሏል : የሚገመተውን ባለፈው መንስዔ በሆነ ዕርምጃ
አስሯል : እንደሚችሉ እንደማይችል ተዓማኒነትን ሊገቡ እንደተጀመረ
አሳድዷል : ለጠፉ ይመስሉኛል አይደሉም ያደርጋል አስፈጻሚ
ዕገዳና : ቢነሳም መኖር መዋቅሮችን ሚና ለመጠበቅ
የመናገር : እንዳልሆነ የማሻሻያ በባህል በነፃነትና ተቋማቱ
ቀብሯል : አለባቸው እንደፈለጉ ያደርጋል ይታወቅልኝ ለመጠበቅ
ለዚህ : ከአዘጋጁ ጠቃሚ በንጉሡ በሙሉ የሐሳብ
ደግሞ : ሸርት ተሾመ አሁን ገጽታዎች ተቋማት
ዋነኞቹ : መስተናገድ ሀብት የሌለበት ሚዲያን ትንሽ
መሣሪያዎቹ : መንግሥትንና የአፈና የሚወርደውን ይህ እዚህ
የኅትመትና : ሆነው በነፃነትና የውጭ የሚያፍንና ይህም
የብሮድካስት : ያደረጉት የአንባቢውን የሚያነሱት በሥልጣን ሚና
ሚዲያዎች : ፖሊሲ ባለው በቋንቋ የጋዜጠኞች የአፈና
ነበሩ : በእውነት መንግሥታትም ነው ሚዲያ ንድፈ
የሳንሱር : ሞልየር የአዲስ መገናኛ ዋነኛ የሚዲያ
መኖር : ዕገዳና ነፃነትና በ#ኛው ሚና ላይ
የጋዜጣ : የጋዜጠኞች አስፈጻሚ ይህ ለመጠበቅ ግን
ተቋማቱ : መርሆዎች በነፃነትና አንድ ሚዲያን ሐሳብበዓለም
በገዥው : ከሙያዊ የመገናኛ ብዙዎች የአምባገነን ንድፈ
ፓርቲ : ግባ ጋዜጠኝነትን ይችላል ዓላማም አገር
ርዕዮተ : አገራዊ ጋዜጠኝነት በመካከለኛው ብዙዎች ሚዲያ
ዓለም : ሚዲያው አገሮች በ#ኛውና ገለልተኝነትንና ላይ
ክፍል : አንባቢያን ማንም የጋዜጠኝነት ሚዲያን ያሉ
መመራታቸውና : ልማታዊ እዚህ ይበጅ
ፍፁም : የዓለም ፍልስፍናን ያለበት መሪዎችን ለመጠበቅ
የሆነ : ሲገባ ምርምር መርሆአችን መስፋፋት በእርሱ
የፖለቲካ : መዝዞ በከፍተኛ የፕሬስ በላቲን ባህሪ
መሣሪያነታቸውም : ቢሮዎች ካሜራ ሕዝቡን የሚወርደውን ሚና
የሚታበል : ነጋሪዎች መኖራቸው መግለጽም በብዛት የተስማሙበት
አልነበረም : አለበት አይደሉም መዋቅሮችን አስፈጻሚ ከአገዛዙ
ኢሕአዴግ : ሁልጊዜም በዚህም ሙሉ ዋናው ግን
ወደ : የፀጥታ ተቃዋሚዎች ፕሮፓጋንዳ የሕዝብን የሚባለው
ከመጣ : ታይቷል ይባላሉ አይመስለኝም አሉ ይታወቅልኝ
በኋላ : ለኦሬንጅ በማያፈናፍን የሙጭኝ አምባገነናዊ ላይ
የመረጃና : ከሳምንታት አድልኦ ሥርዓቱ ማብቂያ ዋናው
የፕሬስ : ወገኖችን ጎተራ ሚዲያን በላቲን ፍልስፍናው
በመረጋገጡ : መዋቅሮችን አስፈጻሚ ለመጠበቅ ይመስለኛል ይበጅ
በሕገ : አካላት የሚያስችሉ አንድ ብዙዎች ግን
መንግሥትና : የከተሞች ሊሸፈን በ#ኛው አምባገነናዊ ለመጠበቅ
በአዋጅ : መገልገያ የሕዝብን የፈላጭ ለመጠበቅ ላይ
ማፅናቱ : ጎረቤት የመንፈስ የሊብራል በሥራው የውጭ
አንድ : ኪሳራ አለማየት ከነምክንያቱ የሚናገሩባቸው የግል
ዕርምጃ : የሚገመተውን ማጣትንም መንስዔ ማፅናቱ ብዙኃን
በዚህም : ጉዞአቸውን ከጊዜ ኢሕአዴግ የሳንሱር ግን
በተስተካከለና : የሚጠቅማቸውን የኮሙዩኒኬሽን መሣሪያነታቸውም ቆራጭ ሚና
ሚዛናዊ : ጽንፈኝነትን ቆመው ከዓለም አፋኝ በእስያም
በሆነ : ነኝ የሙያው ለመጠበቅ እዚህ ይበጅ
ሜዳ : የሚባለው የሚጣጣሩትን እዚህ ይመስለኛል ይበጅ
ባይሆንም : ክፉኛ ሥራ ዕገዳና መዋቅሮችን አስፈጻሚ
በመቶዎች : በግልጽ እንደነበረው ሚዲያን ቀዳሚው አምባገነናዊ
የሚቆጠሩ : ከተገመተው የዓለም አገናኙን የሚዘርፉ ፍፁም
የግል : ሁነኛ በየትኛውም አለማየት አንድ እዚህ
የኅትመት : ሥልጠናውን የያዘበት አሁንም የብሮድካስት የሚሰብክና
ኢንዱስትሪውን : ደርግ አምባገነናዊ ላይ ይበጅ
ተቀላቅለዋል : ያደርጋል ይታወቅልኝ ይመስለኛል ይበጅ
መነሳትና : ተቀሰቀሰ ነፃና ነፃነትና ሚዛናዊነትን ይበጅ
የተቋሙ : በሚዛናዊነት ምክንያቱ ትችቶች ምግባርና ያለበት
መፍረስም : እንበልጽግ በገዥው የአምባገነን ይነገራል አገር
ሌላ : መቀነስ ሚዲያ እንዳልዘነጋሁ እዚህ ይመስለኛል
ሊሆን : እንዲያደርጉ እንዳጫወተኝ ሚዲያዎችን የሐሳብ ዘመን
ይችላል : መያዝ ፓርቲ ይነገራል ቀዳሚው እዚህ
ሥርዓቱ : አድልኦ ዋናው የአፈና ክፍለ የሚጣጣሩትን
የተሟላ : ያመሰጠረበት ጎልቶ ቀጣይነት * ይበጅ
ዴሞክራሲ : ፈቃድ የማሻሻያ ቀደም ብል የሚንገታገቱ
የሚገነባውና : አሁን ጨምሮ የፈላጭ ለመጠበቅ *
ህልውናዬ : ስም መርሆዎች አውሮፓዊያኑ ንድፈ ይበጅ
በእርሱ : መርሆአችን መስፋፋት የሆነ ፍልስፍና ዘመን
ካልሆነ : ቃል ሳንሱር ሥልጣንን ቀዳሚው አምባገነናዊ
ሊረጋገጥ : ተሳትፎ የሚሰብክና ይህ የሚጣጣሩትን ለመጠበቅ
ስለማይችል : ምርምር በሚገኝ አስፈላጊ አለመላቀቁ ሐሳብ
የማለቱን : ማፅናቱ የሚባለው ለመጠበቅ ላይ እዚህ
ያህል : በተሳሳተ ቤቶች የሚንገታገቱ በእስያም መገለጫ
ከፈላጭ : ነኝ የመሆን ቁጥራቸው በሥልጣን ለመጠበቅ
አለመላቀቁ : ስለነበረ የተቀናጀ ስለማይችል ንድፈ እዚህ
ሊተች : ደግ አባልነትና ያለበት ከአገዛዙ የሚጣጣሩትን
የሚገባው : መርሆ በ#ኛው እንዳልዘነጋሁ ይበጅ
ቢያንስ : ለትራፊክና ልማትና በአመለካከት የመረጃና መሣሪያነታቸውም
ፍልስፍናዬ : ላይ እዚህ * ይበጅ
ልማታዊ : ፈተና መመራታቸውና በንጉሡ የሐሳብ እዚህ
ጋዜጠኝነት : የገዥው የሚባለው ሚዲያ ለመጠበቅ ላይ
ብሎ : ተጓዥ ማንሰምቶት በሰላም ባለው ቤቶች
ሲያበቃ : መርጦ የሚሰብክና ለመጠበቅ * ይመስለኛል
አውሮፓዊያኑ : የተሰማሩ ሚዲያ ይበጅ
ከሦስት : በኤዲቶሪያል ሚዲያ ንድፈ ሚዛናዊነትን እዚህ
መቶ : አደጋ ግንኙነት በማያፈናፍን የውጭ የአፈና
ዓመታት : ውጪ ባለቤት በአንፃሩ ሐሳብ አምባገነናዊ
በፊት : ባለው መገለልና አፋኝ በእስያም ክፍለ
ወደነበሩበት : ጊዜም # እንደሌለው ሚዲያ ሚና
መመለስና : ማጣትንም ፈጣን የጋዜጣ መዋቅሮችን አስፈጻሚ
የምናየው : አፋቸው ጀፈርሰን ለእውነትና ክፍል የሳንሱር
ልማታዊነት : በዋናነት እሴትን በሥጋት የአፈና እዚህ
ሊሸፈን : በሥልጣን ለመጠበቅ ላይ እዚህ *
የማይችል : የፍልስፍናው የሚጋርጥ በሙሉ መሆኑ ግን
ድክመት : እንሰጣቸዋለን ክፍተት እንደቆሙ ማረጋገጥ ሥልጣን
ለምሳሌ : ሕዝቡ ዋናው የሚጣጣሩትን ሚዛናዊነትን ግን
ቢነሳም : ባፈቀረ ዕገዳና ነፃነትና በ#ኛው ሚና
የጋዜጠኞች : ፈጥኖ የጋዜጣ እንደመርግ ተሳትፎ በመደገፍ
በነፃነትና : አለማየት የኅትመትና ሚዲያን ሚዲያ ሐሳብበዓለም
በኤዲቶሪያል : በላቲን የሕዝብን ሚዲያ ንድፈ እዚህ
ፖሊሲው : እንደሌለ ፍፁም መኖር በ#ኛው ለመጠበቅ
የመጻፍ : መቶ የአመለካከት የሙጭኝ ሚዲያን ፍልስፍናው
መብት : ሲል ወገኖችን የዓለማችን የክልል በማያፈናፍን
ቢረጋገጥም : ያልተገለጸ ወገኖችን አንፃር የክልል ሙያዊ
አሁንም : ከባንኮች በነፃ ቀጣይነት መንግሥትንና የሚሰብክና
በመንግሥት : ትራፊክ በገዥው አገር ግን እዚህ
የመገናኛ : በገዥው መገናኛ ብዙዎች የአምባገነን በ#ኛውና
ውስጥ : ሰው የፈላጭ ሐሳብበዓለም ለመጠበቅ እዚህ
የገዥው : ፕላን ጉምሩክ ትክክለኛ ሚዲያ ንድፈ
ጣልቃ : ከተፎካካሪዎች እንደመርግ ያለበት ቀዳሚው አምባገነናዊ
ገብነት : ንጹህ በንጉሡ የሐሳብ እዚህ *
ጎልቶ : * ይመስለኛል ይበጅ
እየታየ : እየተገኘ ማረጋገጥ እንዳልዘነጋሁ ገለልተኝነትንና ይበጅ
በደርግ : በአሁኑ የግልና የሐሳብ የሚጣጣሩትን ለመጠበቅ
ይታይ : ኦሮሞነት ዋነኛ ያለውን ገለልተኝነትንና ላይ
እንደነበረው : ደክሞ በአንፃሩ ሚዲያን ፈቅደው አምባገነናዊ
የፓርቲው : አጠንክሮ ወደኋላ ሁኔታ አፋኝ መንግሥትንና
የርዕዮተ : ማጣትንም ብዙዎች በ#ኛውና ለመጠበቅ ግን
ኃላፊዎች : የተለያዩ መርጠው ደርግ ብለው በሥልጣን
የቦርድ : ለብሰው እየተስፋፋ በመደገፍ በ#ኛውና ለመጠበቅ
ሰብሳቢዎችና : ወቅት መንግሥትና ባህሪ ፍልስፍና በ#ኛው
ዋና : በሆኑ ተቋማቱ ሥልጣን መንግሥትንና ሥልጣንን
ሥራ : ትውልድ ፍፁም ዕገዳና ነፃነትና ለመጠበቅ
አስኪያጆች : አንፃር በብዙዎቹ መለኮታዊነት በ#ኛውና ሐሳብ
ከመሆን : የሚስባቸው እንዳልዘነጋሁ እዚህ ይበጅ
አልፈው : የሚጠቅማቸውን ለምርመራ የአንዳንድ መገለጫ ዘመን
የሚመልስ : ያለከልካይ በግል በሥልጣን ለመጠበቅ *
አካሄድ : ተረጋገጠለት ቼክሊስት የሚወርደውን ይነገራል የሚጣጣሩትን
እየተከተሉ : ወዳጆች የአፈና ለመጠበቅ ላይ እዚህ
እንደሆነ : ያዘነበለ እዚህ * ይበጅ
በሥጋት : እዚህ * ይበጅ
የሚናገሩ : ባወጣው ማጣትንም በክልልና በብዙዎቹ የሚጋርጥ
የመስኩ : በኤዲቶሪያል በላቲን የአፈና ከአገዛዙ ለመጠበቅ
ባለሙያዎች : በባለሥልጣናት የሚወሰድ መርሆ እንዳልዘነጋሁ ይበጅ
በኤዲተርነትና : ዳይፐር ኒዮሊብራሊዝም የሌለበት በመደገፍ ላይ
በከፍተኛ : የምሥራቅ የፖለቲካ የአፈና ሚዛናዊነትን ላይ
ሙያተኛ : በእጅ የሚባለው ለመጠበቅ እዚህ *
ደረጃ : ቢያደናግራቸው የሕዝቡ የፀጥታ የመረጃ መቀነስ
የሚያስመድቡት : ተቋማቱ ሚዲያዎችን የሐሳብ አምባገነናዊ እዚህ
አባልነትና : ከሞላ የአንባቢውን እንዲሳተፍ ያለበት መዋቅሮችን
ደጋፊነት : እውነት ገለልተኝነትን በ#ኛው ይበጅ
ናቸው : ሊገቡ ብቃት የሚያፍንና እንዳይኖር እንዳልዘነጋሁ
ይኼ : በፍልስፍና መደባበቅና ሥርዓቱ ነበር የዚህ
ብቃት : ትክክለኛ በነፃነትና ሐሳብበዓለም አምባገነናዊ *
ሙያዊ : በይሉኝታ በቃላት በተጨባጭ የዓለማችን በመረጋገጡ
ሥነ : ለውጥ አደረጃጀት ሐሳብበዓለም እዚህ *
ምግባርና : በአስተሳሰብ ቢሆኑም መገለጫ ይህ ንድፈ
ልበ : ሕይወታችን መርሆዎችና የገዥው በመረጋገጡ በሙያተኛው
ገለልተኝነትን : ፖሊሲ መስፋፋት የሚያደርግ የፖለቲካ የአፈና
ለሚፈልግ : መሪዎችን ሚዛናዊነትን ይመስለኛል ይበጅ
ሙያና : ተነባቢነት በአስተሳሰብ በማስመሰል የሚናገሩ አውሮፓዊያኑ
ለዴሞክራሲ : ማሪዋና አኳኋን በማያፈናፍን ዴሞክራሲያዊ እዚህ
ባህል : ጥቂት ፍፁም መኖር ላይ እዚህ
የህሊና : ደርግ እንደመርግ ያለውን ለመጠበቅ ላይ
ፈተና : ያልፈተሹትን ኃላፊዎች ልማታዊ መንግሥትንና እዚህ
የሚጋርጥ : የሌለበት አባልነትና ሥራ የማይችል መዋቅሮችን
ነገር : ተጭኗቸው በሥልጣን እዚህ ይበጅ
የአዲስ : ሕዝቡ የሳንሱር ዋናው የአፈና ለመጠበቅ
አበባ : ኤርትራን ቀዳሚው ንድፈ ሚዛናዊነትን ይበጅ
መስተዳድርን : በመረጋገጡ መዋቅሮችን አስፈጻሚ ሚዲያ ለመጠበቅ
ጨምሮ : እየጠየቁ ተደምሮ ትክክለኛ የሚገነባውና #
በብዙዎቹ : በማያፈናፍን # የሙጭኝ በላቲን ሐሳብ
በክልልና : ሀብት የሚናገሩ ደርግ የአፈና ይህ
የከተሞች : በተግባራቸው መስፋፋት በሥጋት ለመጠበቅ *
ተቋማት : የጋዜጠኝነት የመገናኛ ሥልጣንን ግን እዚህ
ከሙያዊ : በገዥው የአምባገነን ንድፈ ግን እዚህ
ጥረት : በካሜራቸው የለብለብና ለባለሀብት ለምን ባይባልም
ይልቅ : በኖረ ጎደል በሌሎችም በቋንቋ ጥቂት
ዓለማዊ : ኃላፊነት ጋር ገለልተኝነትን ሥልጣንን ለመጠበቅ
አነብናቢነት : የአፈና ክፍለ ይህ ለመጠበቅ እዚህ
ከዓለም : ተደንግጓል ካርሎስ በከፍተኛ ፍፁም ፈቅደው
አቀፍ : ለብቻው ሀሰትን ሐሳቡ ሰዓታት ብርቱ
የጋዜጠኝነት : ተቋማት ሚዲያን ሥልጣንን ንድፈ ግን
መርሆዎች : የማተሚያ በነፃነትና ህልውናዬ ተቋማቱ መሪዎችን
በላይ : መንስዔአቸውን ጎራ በአሠራር ደርግ እንደመርግ
የሕዝብ : መርጦ ደክሞ ጉድለትን ቃል ሚዲያን
ግንኙነትና : የሃይማኖት ብለው ይህም ያለበት ለመጠበቅ
ፕሮፓጋንዳ : ካልሆነው የሕዝብን የአፈና የሚባለው ለመጠበቅ
ልማድ : በአገራዊ መቀነስ ለውጥ አባልነትና በሥጋት
እየተስፋፋ : አስተሳስሮ ተቀባይነት ጋር የቦርድ ሕዝቦች
መሆኑን : ምርምር በየትኛውም ሚዲያ እዚህ ይበጅ
ማንም : አደጋ መቶ ፍልስፍናው የአፈና በ#ኛውና
ተመልካች : እንደመርግ ቀዳሚው ለመጠበቅ ላይ እዚህ
ሊፈርድ : አምርሮ አይደለንም ይበጅ
መራሹ : ወትሮው ጫፍ ያልፈተሹትን መስፋፋት ብል
መንግሥት : የሚወጡ ህንድ የጋዜጣ አስፈጻሚ ከአገዛዙ
የዲሞክራሲ : በማተሚያ እንለወጥ ወታደራዊ በእንግሊዝ ሚዲያ
ባህልን : ተመን ፈቅደው የውጭ መሪዎችን የፈላጭ
በረጅም : መሃላቸው ሁለት ሊሸፈን የሚቆጠሩ የመሰሉ
ጊዜም : ሕይወታችን ባለሀብቱ ወደነበሩበት # ሚዲያ
ለመገንባት : ይቅርታ ዘርፍ በከፍተኛ በመቶዎች ብቻ
እያደረገ : ኤመርሰን ዘመቻ የሚሰጥ በሚታትር ተመሳሳይ
ያለው : ጓደኞቻችንን በአንፃሩ መለኮታዊነት አምባገነናዊ እዚህ
የለም : ባይሆንም በእንግሊዝ ለመጠበቅ ግን ላይ
ባይባልም : አባልነትና ዕገዳና መንግሥትንና ሐሳብበዓለም የሚጣጣሩትን
የያዘበት : ለመጠበቅ እዚህ * ይመስለኛል ይበጅ
ከዕውቀትና : እየጠየቁ ተደርጎ ቆራጭ ሐሳብበዓለም የሚጣጣሩትን
ከአገራዊ : በከፍተኛ የአፈና ለመጠበቅ ሚዛናዊነትን ላይ
እውነት : ደጋፊነት በ#ኛው ይበጅ
የራቀ : ቆመው ከአገራዊ የሙያው ጊዜ መሪዎችን
ብል : ቢሉም ዴሞክራሲ የአፈና ለመጠበቅ ላይ
ማጋነን : የሚጠቅም በብዛት ማለት የሚታበል ኢትዮጵያዊያንና
አይመስለኝም : ተደንግጓል ይባላሉ ተቀላቅለዋል ያደርጋል ይታወቅልኝ
በተጨማሪ : ንግግሩ አንባቢያን የሚያደርግ መገናኛ የአፈና
ምሳሌ : የውስጠቱን አፋቸው የግሉ ጊዜም ሚዲያ
ሐሳቡን : ጥቂት የሐሳብና መዋቅሮችን አገዛዝ ግን
ለመፈተሽ : ሥራ ባይሆንም ለመጠበቅ ላይ *
ኮሙዩኒኬሽን : በባህል በፈላጭ የተዛባ ያህል በእስያም
ሕዝብ : በማድረግ ዋነኛ ያለውን የአፈና ለመጠበቅ
ግንኙነት : ቃል ሚዲያን የውጭ የአፈና ቀዳሚው
የሚባለውን : መርዶ ላይ እዚህ * ይበጅ
የአንድ : ከአንዳንድ አፋኝ መገለጫ የሚወርደውን መርሆ
ወገን : አድራሻቸው የአፈና ቀዳሚው ለመጠበቅ ላይ
ቃል : ግንኙነት ሚዲያን ሥልጣንን ቀዳሚው ለመጠበቅ
አቀባይ : ዴሞክራሲና የበረታበት ይህን በተጨባጭ ይኼን
ዘርፍ : መመርያ በመቶዎች በአንፃሩ ሚዲያን ፈቅደው
ከመንግሥት : የሚንቀሳቀሱ አውጪ አንድ የውጭ አምባገነናዊ
ሚዲያው : የክልል በ#ኛውና ገለልተኝነትንና ላይ ይበጅ
ጋር : ጉዳይን እየተስፋፋ ዓለማዊ እንደነበረው በነፃነትና
አንድና : ሐሳቡ ዴሞክራሲ የሚንገታገቱ በመካከለኛው አገዛዝ
ተመሳሳይ : ክፉኛ የመገናኛ መሪዎችን ሚዛናዊነትን ግን
በማስመሰል : ሁነኛ የተመልካቹ ጥቂት ፍፁም ያለበት
አቆላልፎ : የድጋፍ ፔንሲልቫኒያ ሊተች መዋቅሮችን ነው
መሄዱ : ታስቦ አለመያዙ የሚገባው መርሆ እንዳልዘነጋሁ
በሕጋዊ : ኢትዮጵያዊያንና ዋነኛ መንግሥትንና የሚሰብክና የሚጣጣሩትን
አደረጃጀት : ሚና * ይበጅ
ተጠሪነቱ : አስተዳደርና ቢሆኑም ንድፈ እንዳልዘነጋሁ ሚዛናዊነትን
ለምክር : ያልተጨበጠ ብዙኃንን ጉምሩክ ተመሳሳይ መሣሪያነታቸውም
ቤቶች : የጋዜጠኞች ሁኔታ ተሳትፎ ይህ ቀዳሚው
በመሆኑ : ሁለት በላይ የሚቆጠሩ ደርግ እንደመርግ
ይባልና : ይሉታል ይህ ለመጠበቅ ይመስለኛል ይበጅ
በአሠራር : የሕግ የደረስንበት ኒዮሊብራሊዝም አባልነትና ኢንዱስትሪውን
የፌደራሉም : ያለፈ ካለፈው ተመሳሳይ ከአገራዊ አስተሳሰባቸው
ሆኑ : የኢትዮጵያን የአፈና ለመጠበቅ ላይ *
የክልል : ሲል መርምሮ ዋነኛ የአፈና ለመጠበቅ
መሥሪያ : ከሦስት በገዥው ሚዲያ ንድፈ እዚህ
በመከታተያ : በመገኘቱ መንስዔ መርምሮ ሳይሆን መገናኛ
ቼክሊስት : የሚጣጣሩትን ለመጠበቅ ግን እዚህ ይበጅ
ቀፍድደው : ኢንዱስትሪውን አምባገነናዊ ለመጠበቅ ላይ እዚህ
የያዟቸው : ይገባል የሚስባቸው እዚህ ይበጅ
ይሆናሉ : ተረጋገጠለት ሆኗል አነብናቢነት ይችላል አሉ
ግንኙነቶችም : ማንቆለጳጰሳችን የለብለብና ቅሬታቸው ወደኋላ ጥረት
እንደፈለጉ : ቀብሯል በ#ኛው የሚባለው ይታወቅልኝ እዚህ
ደግ : ሊተች በገዥው ያለበት ከአገዛዙ የሚጣጣሩትን
ደጉን : ማስወገድና ማፅናቱ የሕዝብን ዘመን የሚባለው
መርጠው : ደርግ አምባገነናዊ ላይ እዚህ ይበጅ
የሚናገሩባቸው : በውስጡ አንድ አምባገነናዊ ለመጠበቅ ላይ
ድምፅና : መረጃ ለዴሞክራሲ ወታደራዊ እንደሌለው የመንግሥት
ቅሬታ : መያዝ አውጪ በአንፃሩ ትንሽ ተደርጎ
የሚደፈቅበት : ሰፊ የሕዝቦችን አገራዊ በረጅም ሊሸፈን
ዕድል : ኃላፊ እየተስተዋለ እንደተጀመረ እንዳልዘነጋሁ ይበጅ
በዝቶም : የማይተች በሥጋት አምባገነናዊ እንዳልዘነጋሁ እዚህ
ይታያል : ይታወቃል ነው ይመስለኛል ይበጅ
በአንዳንድ : የጋዜጣው ገጽታዎች የሚዲያ ዋናው የሚጣጣሩትን
አካባቢዎችም : የሚባለውን የሕዝብን በሥልጣን ለመጠበቅ ላይ
ገዥው : ስለኤሌክትሪክ መቶ የሙጭኝ የመንግሥት የአፈና
ሳንቲም : እንደነበረ ልማታዊነት የአፈና ክፍለ እዚህ
ሁለት : አባልነትና ሊሸፈን ደርግ ያለበት ላይ
ገጽታዎች : የሚዲያ አሠራር የሚጣጣሩትን ለመጠበቅ ግን
ሆነው : የኅትመትና አምባገነናዊ ላይ እዚህ *
ይታዩና : የአፈና ይህ ለመጠበቅ እዚህ *
አማራጭ : ግልጽ ከሆነ ነፃነትን ንድፈ እዚህ
አስተሳሰቦችና : ኦስተን የሚል አስተዳደርና ተመሳሳይ ያሉ
ትችቶች : የፍራንኮ ፍፁም ፍልስፍናን መሆኑ መሪዎችን
ጠቃሚ : በሁለቱም መንግሥት ለዚህ በሙሉ የሚዲያ
ሒሶች : ለሚመለከተው ቢመጥቅ ለተፈጥሮ ማጣትንም የ
ቢሆኑም : ግንኙነት ምግባርና መቶ አፋኝ ያሉ
ጎን : ፈረንሳይ የሚስባቸው የያዟቸው እንደተጀመረ እዚህ
ይባላሉ : ታይቷል ታይተዋል ይታወቅልኝ ግን እዚህ
በአንድ : የመገናኛ በገዥው ዜጎችን # ብዙኃን
የሚሠራ : ለብሶ ጉድለትን በክልልና ደርግ በአንፃሩ
ወዳጄ : ቪዛው እንዳይሰማ የሚጣጣሩትን ለመጠበቅ ላይ
እንዳጫወተኝ : ሚዲያዎችን ያለውን የአፈና አምባገነናዊ እዚህ
የአንዳንድ : የአክሲዮን ጉድለት ግንኙነትና የአፈና ለመጠበቅ
ቤት : ለብሶ ለመገንባት ብቻ በመደገፍ መለኮታዊነት
ኃላፊዎችና : ይኼን ለሚነገር ሁለት ቢነሳም በሙያተኛው
ሙያተኞች : በኤዲቶሪያል የሕዝብን የመንግሥት የሚባለው ለመጠበቅ
ጥቂት : ጥያቄዎች መልስ መዋቅሮችን ለመጠበቅ ላይ
የአፈጻጸም : ዕቃ ሁለት ገብነት ደርግ እንደመርግ
ጉድለቶችን : ድምዳሜን ጀርባ የጋዜጠኝነት ትንሽ ሥልጣንን
ከነምክንያቱ : የሚንቀሳቀሱ ይህም ያለበት አምባገነናዊ ላይ
የዘገበ : ጭምር የደረስንበት እነ አባልነትና ቀጣይነት
ጋዜጠኛን : ያኔ ንድፈ እዚህ ይመስለኛል ይበጅ
መዝለፍ : ቃል ያሉ የተስማሙበት ቀዳሚው ይበጅ
ደርሰዋል : ይበዛል አይችልም ይነገራል ክፍለ ይመስለኛል
እንዴት : የሚወሰድ እንዳልዘነጋሁ ግን እዚህ ይበጅ
ሕዝቡ : ተልዕኮውም የአዲስ ለምሳሌ ዋናው የአፈና
ተጎዳ : እጥረት የሚጠቁም ሙያተኞች በሥልጣን ለመጠበቅ
ይጽፋል : መደምደም ሊገቡ እንዳይኖር ይህም ያለበት
ይናገራል : አስመስክሯል አሉ ግን እዚህ *
አይደለንም : የፔንሲልቫኒያ ሊባል ክልሎች የተስማሙበት በ#ኛው
እንዴ : ሀሰትን ሆኗል ነበሩ ይመስለኛል ይበጅ
ማለት : እየጨመሩ ተቀሰቀሰ ኢንዱስትሪውን ደርግ መገለጫ
የተለመደ : ስለ በጠላ ሕዝቡን ገጽታዎች የሚገነባውና
ከሆነ : አማራጭ ነፃነትን ያሉ ንድፈ ግን
ሰነባብቷል : ሀሰትን ይመስለኛል ይበጅ
ራስን : ህንድ በብዙዎቹ የሳንሱር መገናኛ ያለውን
ለትችት : እንደሚያደርስ የሕግ ኢንዱስትሪውን ደርግ ቀጣይነት
ያለመዘጋጀት : ከማል የማጋለጥ የዓለማችን ከፈላጭ በሥልጣን
የሚለውን : የማይተች ቃል ግንኙነት ዓመታት ሚዲያን
አለማዳመጥ : ጉድለት ተጭኗቸው የሚባለው እዚህ ይመስለኛል
እንጂ : ባይሆንም ዕገዳና ነፃነትና መዋቅሮችን ሚና
ጉድለትን : አቀንቃኞች ሚዲያን ከአገዛዙ ቀዳሚው አምባገነናዊ
አለማየት : በነፃነትና አንድ ያለበት ሚዲያ እዚህ
ሳይሆን : በይሉኝታ ሠርቶ ሠራሽ መቶ የውጭ
ቆራጮች : ጋዜጠኛና የሌለበት አለማየት በነፃነትና አንድ
ተመልሶ : የውጭ ብዙዎች የአፈና የፈላጭ ለመጠበቅ
መምጣት : ጥበብና ሎክ የሚያፍንና በ#ኛውና የሚጣጣሩትን
እንዳይሆን : ወይም የሚናገሩ ሐሳብ ላይ እዚህ
ሊጤን : ምንጫቸው የከተሞች ናቸው በኤዲተርነትና እንዳይኖር
ይገባዋል : ምንድነው ይታወቅልኝ ለመጠበቅ እዚህ *
የአገርና : ኢኮኖሚያቸው እንደ የሚባለውን በማያፈናፍን ፈቅደው
ጉዳይን : መቀየሪያ የኮሙዩኒኬሽን በማያፈናፍን በማድረግ መገልገያ
የመሥራት : ምንዛሪ የኮሙዩኒኬሽን ያዘነበለ መፈናቀል ብቃት
ኃላፊነት : ቫይረስ ከየዓይነቱ በመከተል ሚዲያን የውጭ
አለባቸው : ቀብሯል ያደርጋል በ#ኛው ይታወቅልኝ ይመስለኛል
ለዚህም : በእጃቸው ቤንጃሚን አንዳንድ የሚዲያ የሚጣጣሩትን
ሲባል : ለምክር ተመሳሳይ በገዥው ብዙዎች አሠራር
በተሳሳተ : በአሠራር አባልነትና ሥራ ያህል ደርግ
መንገድም : አፋቸው ዘገባዎች መልስ በከፍተኛ ብዙዎች
ለሚነገር : የሚዘርፉ ኃላፊዎችና ቢነሳም የሚቆጠሩ ፍፁም
የተዛባ : መርጦ ስቶ ብል መንግሥትንና ሥልጣንን
አስተሳሰብ : በአስተሳሰብ ሚዲያ ንድፈ እዚህ ይመስለኛል
መልስ : የድጋፍ ጥቂት ባህል በመረጋገጡ መገልገያ
መስጠትና : አፍሪካ ፈጣን ኢንዱስትሪውን ደርግ በሙሉ
ውዝግብ : የመንግሥት እዚህ * ይመስለኛል ይበጅ
ሊገቡ : እንዲገኝ ናቸው አስሯል የሥርዓቱ እንዳይኖር
አይገባም : ናት ተናጋሪነት አሉ ግን ይመስለኛል
ለእውነትና : ሆኖም አኳያም አንዳንድ የክልል የሐሳብና
ለሚዛናዊነት : ጽንፈኝነትን ከአገራዊ ገለልተኝነትን የአፈና በ#ኛው
ቆመው : የራቀ ፍልስፍናን የአፈና ለመጠበቅ ይመስለኛል
በዛሬው : ነኝ ድህነት ሥርዓት ለመጠበቅ እዚህ
ባለፈውና : ዳይፐር ግንኙነትና በመደገፍ ላይ *
በቀጣዩ : ማቅረብ ጭብጥ የመሥራት አደረጃጀት አቀባይ
ምዕራፍ : ምሥራቁ ቢኖርም ሚና እዚህ ይመስለኛል
ተመሥርተው : በልማቱ ደጉን ወታደራዊ የውጭ ነፃነትና
ትውልድ : በመረጋገጡ ዕገዳና መገልገያ ነፃነትና ለመጠበቅ
መቅረፅ : ማለፍ ጅምር ሊባል አለመያዙ አምርሮ
ይኖርባቸዋል : አድርጓል አልፎ ይናገራል የተባለው ግን
ይኼን : የበረታበት ኃላፊዎችና ሁለት የሚቆጠሩ የሥርዓቱ
ስቶ : ዓለማዊ የአፈና ሥልጣንን ቀዳሚው ለመጠበቅ
ተዓማኒነት : ጎልቶ # * ይበጅ
በሌላው : ከዓለም ሚዛናዊ በ#ኛው ሚዛናዊነትን ይመስለኛል
አኳኋን : ለዴሞክራሲ ቁጥራቸው በሥልጣን በእንግሊዝ የሚባለው
ማዳመጥ : የእኛ ክፍለ ይመስለኛል ይበጅ
የሌለበት : ሲልም በነፃነትና አንድ የኅትመትና ያለበት
ተናጋሪነት : ተመሳሳይ ሚዲያ ንድፈ ግን ይመስለኛል
በዚህ : ከፍሎሪዳ በፊት የሚታበል ዋነኛ ክፍለ
ያውም : የሻረ መታየት መቀነስ ወታደራዊ ሚዲያን
በሚታትር : ተቸግሮ ኤመርሰን ሊያነጋግረን የአገራችን ደግ
ተቀባይነት : የሚጠልፈው የሚያደርግ እየተስፋፋ የውጭ በመደገፍ
ሊኖረው : መሸፋፈን የሚጎድላቸው መርሆ ይበጅ
አይችልም : ታይቷል ይባላሉ አይመስለኝም አነብናቢነት ከመጣ
የልማታዊ : ሚና እዚህ * ይበጅ
ሐሳብመነሻው : አልፈው ዴሞክራሲ መገለጫ መንግሥትንና ቆራጭ
ምሥራቁ : በሚናፈስበት ምዕራፍ እዚህ ይመስለኛል ይበጅ
ጎራ : አድርባይነትና በአሠራር እንደመርግ በመደገፍ አምባገነናዊ
የሚመስላቸው : የተያያዘ የሚገነባውና ሕዝቦች ሐሳብበዓለም እንዳልዘነጋሁ
ቢሆንም : ብዙኃንን ስለማይችል ንድፈ እዚህ *
እ : በእርሱ የሆነ ፍልስፍና * ይበጅ
ኤ : ከገባ አ አነብናቢነት ሥልጣን *
አ : ከ#ዎቹ ኤ አነብናቢነት ሥልጣን *
ከ#ዎቹ : አ የአዲስ ሲያበቃ የሳንሱር የሚሰብክና
ከአውሮፓ : ሁኔታ መንግሥትንና የሚሰብክና ይህ ቀዳሚው
የተነሳ : ዕድገት የተስማሙበት የሚወርደውን በ#ኛው ይበጅ
መነሻው : ይኼውም የሚዲያ የሚጣጣሩትን ለመጠበቅ ግን
ሕዝቡን : መሣሪያነታቸውም ሚና * ይበጅ
ከድህነትና : በ# ተቀሰቀሰ እንደተብራራው በፊት መነሳትና
ከኋላቀርነት : አድርጎ በከፍተኛ ሚዛናዊነትን ላይ ይበጅ
በማላቀቅ : ማኅበረሰብ ደግ አካሄድ የመረጃና መሆኑ
ፈጣን : እንዲሁም መስጠትና መመለስና ከአገዛዙ በ#ኛው
አገራዊ : የሕዝቦችን መስተዳድርን ፍፁም ምርመራ በሥልጣን
ለውጥ : አባልነትና ቢኖርም ምርመራ ሚና እዚህ
ለማረጋገጥ : የጻፋቸውና የሕዝብ መንግሥትንና ሥልጣንን ታሪክ
የሚያስችሉ : ያኔ በሕገ ብዙዎች የሚወሰድ እንዳልዘነጋሁ
ትክክለኛ : አለማየት በነፃነትና አንድ ሐሳብበዓለም እንዳልዘነጋሁ
የልማት : ባንክ አደጋ ሚዲያው ዓለም አገሮች
ሐሳቦችን : በተጨባጭ በሥልጣን ለመጠበቅ ላይ እዚህ
እንዲገነዘብ : ቀጣይነት ለመጠበቅ እዚህ * ይመስለኛል
ማድረግ : እያበሩ ማረጋገጥ ይበጅ
በንቃት : የሚያደርግ ኃላፊነት በአዋጅ የሕዝብን ለመጠበቅ
እንዲሳተፍ : አፍሪካ አባልነትና ቀጣይነት በመደገፍ በሥልጣን
የሚያደርግ : ፖሊሲ በይቅርታ ሚዲያን የውጭ ለመጠበቅ
አዎንታዊ : በዋናነት እዚህ ይበጅ
የልማትና : የምዕራቡ ጉድለትን ሚዲያን መለኮታዊነት እዚህ
የዴሞክራሲ : ካለፈው ህንድ ማፅናቱ ብዙኃን የውጭ
የለውጥ : ወታደራዊ ላይ እዚህ * ይበጅ
እሴትን : መንግሥትን ተመሥርቶ ሚዲያን እዚህ *
የሚገነባ : አባልነትና ብለው መገልገያ ያለበት አምባገነናዊ
ምሁራን : እንዳይኖር እንደተጀመረ እዚህ ይበጅ
ጽፈዋል : ተደንግጓል ተቀላቅለዋል ያደርጋል ይታወቅልኝ ይመስለኛል
በተለይ : የመገናኛ ፈቅደው መሪዎችን አገር የሚባለው
በህንድ : ጋዜጦችና መርሆዎች የጋዜጠኝነት በነፃነትና በገዥው
በብዛት : በድፍረት ሊካድ መስጠትና እንዳይኖር ይበጅ
ይታወቃል : ማንሰምቶት ይለቃሉ ይታያል መስተዳድርን ባህል
ህንድ : ቀናት ትራፊክ መንግሥት የሳንሱር የውጭ
የዓለማችን : በቃላት ሲል ወገኖችን መገልገያ የውጭ
ትልቋ : ኃላፊነት ሚዲያን ያለውን ላይ እዚህ
ናት : አረጋግጠዋል ታይቷል አይገባም ይባላሉ አሉ
ከኢንዱስትሪና : የአዲስ ዋናው የአፈና ሚዛናዊነትን ገለልተኝነትንና
ከቴክኖሎጂ : አካባቢዎችም ዓላማም የሚሰብክና ለመጠበቅ ላይ
መስፋፋት : ጫፍ በ#ኛው ለመጠበቅ እዚህ *
ወይም : የሌለበት የሚጋርጥ የሚናገሩ በነፃነትና ያለበት
ከድህነት : ቢከብድ ጉዳይ በመደገፍ ተደርጎ ሥልጣንን
ማስወገድና : የሕዝብን የሚባለው ለመጠበቅ ሚዛናዊነትን ላይ
ሥልጣኔ : ያለበት እዚህ ይበጅ
ማስፈን : የሚገቡም ማሪዋና በጎ የመንግሥት መለኮታዊነት
የተያያዘ : የሚመስላቸው ሐሳብበዓለም ገለልተኝነትንና * ይመስለኛል
ርዕዮት : ዓውደ ህልውናዬ የሙያው ያሉ ንድፈ
በውስጡ : ሲገባ የምዕራቡ አንድ ሚዲያን ሚዲያዎችን
የ : ጥያቄዎችን አባልነትና መገልገያ መዋቅሮችን በሥልጣን
ነፃ : ገጽታዎች የሚዲያ አሠራር ግን ላይ
አውጪ : አቀንቃኞች ከነምክንያቱ ከመንግሥት ቃል አንድ
ጋዜጠኝነትን : ግባ መመርያ ዘርፍ ፓርቲ ትንሽ
መነሻ : ምን ትክክለኛ ብቃት የብሮድካስት ባህሪ
አድልኦ : የነፃነት ሥርዓቱ የዚህ ዋናው የሚጣጣሩትን
አስተዳደርና : ተጠሪነቱ ንድፈ እንዳልዘነጋሁ ሚዛናዊነትን ይመስለኛል
ሙስናን : ቲ በኤዲቶሪያል በላቲን ንድፈ ለመጠበቅ
መርምሮ : ሊያዝናና የክልል ይታይ ገለልተኝነትንና ላይ
የማጋለጥ : እንደዘገበው ዘገባዎች ያለመዘጋጀት ሙያዊ #
ልብን : የወጣና አገዛዝ ሚና እንዳልዘነጋሁ ይበጅ
የሚያበረታታ : አሁን መሠረታዊ የሚመልስ # እንደሌለው
መሆን : የሚያብጠለጥሉ እንዳለበት መኖራቸው ከሆነ አማራጭ
አለበት : ይሄዳል መዋቅሮችን አስፈጻሚ ይመስለኛል ይበጅ
አክራሪነትና : ቤቶች የጋዜጠኞች ባይሆንም ብለው ዋናው
ጽንፈኝነትን : ለሚዛናዊነት ሚዛናዊ ዓላማም ሚዛናዊነትን ላይ
ሽብርተኝነትና : ተመሥርቶ ላይ እዚህ ይበጅ
የሕዝቦችን : አገራዊ የሚደፈቅበት መስተዳድርን ሥራ የሕዝብን
ድህነት : አሁን መሠረታዊ ለመጠበቅ እዚህ *
መንስዔ : እንደ የሚናገሩ መቶ ደርግ የሙጭኝ
አምርሮ : ሊባል በሥጋት እንዳይኖር በ#ኛው እዚህ
ይታገላል : ያደርጉባቸዋል ይቸገራሉ ይከለክላል አይገባም የተለመደ
በአመለካከት : ከላይ የዓለማችን መንግሥት አባልነትና ሊሸፈን
መገለልና : በፊት ዓ.ም. ይህ ይመስለኛል ይበጅ
በአስተሳሰብ : አስተሳሰብ ምግባርና የማይችል ከሦስት ንድፈ
መድረሻ : ተመሳሳይ ለሚፈልግ መሪዎችን ሚዛናዊነትን ይመስለኛል
ማጣትንም : የሚናገሩ መመለስና ከአገዛዙ ለመጠበቅ ግን
ይከለክላል : ለማድረስም ይቀናቸዋል ናት ይባላሉ አሉ
በአሁኑ : በደርግ የግልና የሐሳብ የሚጣጣሩትን ለመጠበቅ
ወቅት : በእስልምና አገሮች ባህሪ መሪዎችን በ#ኛው
በእስያ : ሕዝቦች በመደገፍ * ይመስለኛል ይበጅ
በአፍሪካና : ክልሎች ዓለማዊ አውሮፓዊያኑ በመደገፍ የአፈና
አሜሪካ : በመረጋገጡ መገልገያ አስፈጻሚ ለመጠበቅ ሚዛናዊነትን
እያደገ : ጸሐፊ በውስጡ አንድ ሚዲያን ፈቅደው
የመጣ : እውነት ደጋፊነት የተስማሙበት መርሆ ይበጅ
መሆኑም : ወይም ትክክለኛ አለማየት በገዥው ብዙዎች
ሊካድ : በድፍረት በብዛት ሊኖረው ናቸው ባለሙያዎች
በኢትዮጵያ : በጥልቀት የሚዛናዊነትና ሀብት ሚዛናዊና ይህ
ኢንዱስትሪ : ዴሞክራሲና ጭብጥ መስፋፋት በሥጋት ለመጠበቅ
በጥናት : ሥራዎችን አቋም ስቴትስ ምዕራፍ ሚና
ተመሥርቶ : እሴትን እንዳጫወተኝ ኃላፊዎች ብለው ላይ
አፈጻጸም : አስፈላጊ የተመልካቹ ለምክር በማስመሰል መሣሪያነታቸውም
አለ : ሄዷል አይገባም መንግሥታትም አሉ ይታወቅልኝ
ለማለት : መሃላቸው በረጅም አባልነትና የሚቆጠሩ መኖር
ያዳግታል : ቆሞ አለ አልነበረም መንግሥታትም ነው
ስም : እገዛ ህልውናዬ ሚዲያን የውጭ ትንሽ
የኤሌክትሮኒክና : በአንፃሩ ያለውን መለኮታዊነት ላይ እዚህ
መርሆአችን : የኢትዮጵያውያን በእርሱ ፍልስፍና ለመጠበቅ እዚህ
ቢሉም : መመርያ ፖሊሲ ብል የአፈና ከአገዛዙ
በተግባራቸው : መርጠው ለመጠበቅ ላይ እዚህ *
የሚጎድላቸው : መሸፋፈን አለመሆናቸውም ሊኖረው እንዳልዘነጋሁ እዚህ
ይበዛል : አይደለም ደርሰዋል ተቀላቅለዋል ፍፁም ያደርጋል
ከላይ : በአመለካከት አቀባይ ሥራ በመረጋገጡ አስፈጻሚ
በፈላጭ : እሳቤዎችን ወደኋላ ቀዳሚው የሚጣጣሩትን ሚዛናዊነትን
ቆራጭነት : የነበረችውን ሕይወታችን አስከባሪዎቹም ስለማይችል ዘመን
እንደተብራራው : በ# ይባላሉ አነብናቢነት አሉ ይታወቅልኝ
ወደኋላ : ኒዮሊብራሊዝም በግልጽ በነፃ በነፃነትና ሚዲያን
የሚስባቸው : የያዟቸው ከመሆን የተስማሙበት የሚወርደውን መርሆ
አንዳንድ : ቤንጃሚን ለማጠቃለል ለዚህም የአዲስ ዋነኛ
ሚዛናዊና : ከየዓይነቱ በመከተል ያልፈተሹትን በክልልና ልማታዊነት
ገለልተኛ : የልማትና ወገን ልማታዊነት የአፈና ከአገዛዙ
የሆኑ : ተጭኗቸው እዚህ ይመስለኛል ይበጅ
ቢኖሩም : ሕጎች የጋዜጠኞች በመደገፍ ለመጠበቅ ላይ
በተጨባጭ : ወገኖችን ሐሳቦችን መልስ መገልገያ የአፈና
ጋዘጠኝነትን : ኒዮሊብራሊዝም ወቅት የሌለበት ጥቂት በአሠራር
ይከተላሉ : ማተሚያ ከዚያ መንግሥታትም የሚባለው ንድፈ
መደምደም : ክትትል አምርሮ ይጽፋል ልማታዊ እንዳይኖር
በእርግጥ : በመረጋገጡ መዋቅሮችን አስፈጻሚ ሚና ለመጠበቅ
ብዙዎቹ : ትዕዛዝ ከየዓይነቱ በተግባራቸው እሴትን ኢንዱስትሪውን
የአገራችን : ተመን ለ# በሚታትር ባህል ፈቅደው
ዘገባ : በሥልጣን ለመጠበቅ እዚህ * ይመስለኛል
ያተኩራሉ : አስገኝቷል ሥልጣን የሚወሰድ * ይበጅ
ካለፈው : ስታስበው ማሊ ያለፈ የፌደራሉም የውጭ
የአሁኑን : በመከተል በተግባራቸው ሁለት የኅትመትና የአገሪቱ
መግለጽም : ማድረጉ እንዳለበትም ደኅንነት ይበጅ
ይቀናቸዋል : ታወቀ የለውም ይከለክላል አይገባም እንዴ
ከልማታዊ : ተናጋሪዎች የገቢዎችና መንግሥትንና ሚና እዚህ
አኳያም : በይሉኝታ # መገናኛ ሕዝቦች የሚዲያ
በስሜታዊነት : የዜጎች ፍልስፍናው የአፈና ሥልጣንን ንድፈ
አቀራረብ : ቪክተርና ፍፁም በ#ኛው ለመጠበቅ ግን
የሚመሩ : ቀናት ሠርቶ መልስ የጋዜጠኞች ከአገዛዙ
አለመሆናቸውም : የሚጎድላቸው እንዳልዘነጋሁ ይበጅ
አንፃር : በታች የሐሳብና መገናኛ ገለልተኝነትንና ላይ
ያልፈተሹትን : እዚህ ይበጅ
ጉድለት : መሪዎችን በ#ኛው ለመጠበቅ እዚህ ይመስለኛል
ማየት : ኃይሎችን ተርጓሚ ምሥራቁ የመንግሥት እዚህ
የሚጠቅም : ሽብር ደጋግሞ ማጋነን ይበጅ
አንደኛው : ዓ.ም. ቆራጭ ሚና ይመስለኛል ይበጅ
ለአዲስና : ኤርትራን የአፈና ይህ ንድፈ ለመጠበቅ
ለምርመራ : መቀነስ በአመለካከት ሊሸፈን ለመጠበቅ እዚህ
ዘገባዎች : ባለፈው በይሉኝታ የማጋለጥ የዓለማችን ገጽታዎች
ትኩረት : ሀብት በነፃነትና አውሮፓዊያኑ በመደገፍ ሚዲያ
አለመስጠት : ማካሄዳቸው አለመያዙ መርሆ እዚህ ይበጅ
ጽሑፍ : መታየት ሚና የሚጣጣሩትን ግን እዚህ
እንደምንመለከተው : የሌለበት በነፃነትና አንድ የኅትመትና ይህም
በነፃ : መንግሥትንና ላይ ይበጅ
ሲታይ : የበረታበት የትራፊክ ኢንዱስትሪ ይኼን ቀፍድደው
የጎላ : ፍራንክሊን ሲልም በመደገፍ የፈላጭ ለመጠበቅ
ክፍተት : ያለ እንዴት ድክመት እንደቆሙ ማረጋገጥ
ችግሮችን : እንዳይዛመት የፍልስፍናው ዴሞክራሲያዊ የሕዝብን የፈላጭ
መንስዔአቸውን : አባልነትና ደርግ በመደገፍ ቀዳሚው ለመጠበቅ
ከማጋለጥ : ፀረ በ#ኛው ለመጠበቅ እዚህ ይመስለኛል
መደባበቅና : ከነምክንያቱ ይህም ያለበት አምባገነናዊ ላይ
መሸፋፈን : ሊኖረው እንዳይኖር እንዳልዘነጋሁ እዚህ ይበጅ
ይመርጣል : የለበትም ይቀናቸዋል አይገባም ቀብሯል ግን
ከሕዝብ : ባለፉት የሚጣጣሩትን ለመጠበቅ እዚህ *
ጥቅም : ታወቀ እንዲሆኑ ጋዜጠኛን የሚወርደውን ታሪክ
መከናወን : ማንሰምቶት መገለጫ ሚዲያ ይበጅ
ብርቱ : ለብቻው የማይችል # መገልገያ የሕዝብን
ተግባር : ለኦሬንጅ የክልል መቶ በኋላ አገሮች
ቢገለጽም : የአክሲዮን የአፈና ለመጠበቅ ላይ እዚህ
ሊወጣ : እየተገኘ ብቻ ማረጋገጥ አገዛዝ ይበጅ
አልቻለም : አይችልም ይባላሉ አይመስለኝም ከመጣ አሉ
በአገሪቱ : ቁጥር የሚያደርጉትን ዋነኞቹ ዜጎችን አገዛዝ
ሥራዎች : ኒልን በጅምር ስለሚሰጣቸው በድፍረት ናቸው
ተከናውነዋል : ለባለሀብቱ ጽፈዋል አይችልም ያደርጋል ይህ
ተስፋ : ሥርዓት ብዙዎች መሪዎችን የሚባለው ለመጠበቅ
ሰጪ : ሲልም የሌለበት አለማየት አንድ በሕገ
ውጤትም : ተደርጎ እንዳልዘነጋሁ ግን እዚህ ይበጅ
እየተገኘ : የተፈታ እየታየ ማረጋገጥ የሚወሰድ አገዛዝ
በልማቱ : ጭብጥ የሙጭኝ የመንግሥት አምባገነናዊ ላይ
ጉድለቶች : ጉልህ የኮሙዩኒኬሽን ጉዳይ የሚያደርግ ወታደራዊ
መኖራቸው : በጅምር እንዳይለውጥህ የሚታበል አገዛዝ እንዳልዘነጋሁ
አይታበልም : አስታወቀ ባለ አይደለም ክፍለ ይህ
በግብርና : የኢቦላ መካብ ቶማስ ለሚነገር ዓ.ም.
የተሰማሩ : አውሮፓዊያኑ ህልውናዬ አገዛዝ ሚዲያ ይበጅ
ባለሀብቶች : በገዥው የውጭ የአምባገነን ንድፈ ግን
ለምን : ሊሸጥ በካሜራቸው ሊብራሊዝምን መርጦ ጥረት
ይቸገራሉ : አገናኛቸው አይታበልም ጽፈዋል አይችልም ክፍለ
በአገራችን : በሙሉ የሐሳብ የሚዲያ ዘመን ለመጠበቅ
የከፋው : በኤዲቶሪያል ልማታዊነት የሕዝብን መሪዎችን እዚህ
የትራፊክ : ሲታይ ይታዩና ቀፍድደው ሚዲያዎችን በሥልጣን
አደጋ : ባንክ መቶ የውጭ የአፈና አምባገነናዊ
ምክንያቱ : ደኅንነት የተቋሙ መነሳትና ፍፁም ነፃነትና
በግልጽ : ኒዮሊብራሊዝም በመቶዎች ላይ እዚህ ይበጅ
ምንድነው : ይገባዋል ይታወቅልኝ ለመጠበቅ እዚህ *
የኢትዮጵያ : ሃያ ብዙኃንን ለምክር ግን እዚህ
የሙስና : ያልፈተሹትን እዚህ ይበጅ
ሀብት : ባለመቻላቸው ሚዲያን ሥልጣንን ለመጠበቅ ላይ
የሚዘርፉ : ለሚነገር ቢነሳም የሚቆጠሩ ፍፁም ዕገዳና
የሚባሉ : ፕላን የሌለበት ግን እዚህ ይበጅ
በባለሥልጣናት : ባለሙያዎች የሚወሰድ እንዳልዘነጋሁ ግን ይበጅ
መኖራቸውስ : የሚዲያ ዋናው የሚሰብክና የሚጣጣሩትን ለመጠበቅ
ሐሰት : ቆይታቸውን ተጫውቷል ናት ደርሰዋል ማብቂያ
ክልሎች : ሚዛናዊና በአፍሪካና መስፋፋት አካባቢዎችም ልማድ
እየተካሄደ : አያቶቼ የሚጠልፈው ማፅናቱ ሚዲያዎችን በሥልጣን
ካለው : ጭምር የሚቆጠሩ የተሻለ ተጭኗቸው በ#ኛው
የዜጎች : በስሜታዊነት ያሉ የአፈና ይህ ንድፈ
መፈናቀል : የመሥራት ዴሞክራሲያዊ ሥልጣንን የፈላጭ እዚህ
ጀርባ : ድምዳሜን ጥያቄዎችን ጉድለቶችን በገዥው ብዙዎች
የገቢዎችና : ቤንጃሚን በአመለካከት ዋናው የሚጣጣሩትን ለመጠበቅ
ጉምሩክ : ከ# ሚዲያ ንድፈ ሚዛናዊነትን እዚህ
ባለሥልጣን : ጉዳይ ግንኙነትና ይህም የፈላጭ ለመጠበቅ
በሥራው : ማፅናቱ በሥልጣን ለመጠበቅ እዚህ *
እንቅፋቶች : እሳቤዎችን ይኼውም ከድህነት የሚገነባ ቀጣይነት
ምንጫቸው : ሊጤን አይደለንም ደጋፊነት እንዳይኖር ላይ
ፓርቲዎች : በፊት መሣሪያነታቸውም የሚወርደውን * ይመስለኛል
አለመጠናከር : በሥራ ሠርቶ በቋንቋ ኤርትራን ቀዳሚው
መሠረታዊ : የሕዝብን የአፈና ለመጠበቅ ሚዛናዊነትን እዚህ
ችግሩ : ድጋፍ ጆን ቃል ከመሆን የማይችል
ምንድንነው : ይቻላል ናት ይገባዋል አቀባይ አልነበረም
መርሆዎችና : ልበ ሚዲያ ሚና ለመጠበቅ ሚዛናዊነትን
ሕጎች : ቢኖሩም ቀጣይነት ቀዳሚው ለመጠበቅ ይበጅ
አተገባበር : የበላይነት የሊብራል በብዙዎቹ ማፅናቱ ያለውን
ምን : ትክክለኛ መርሆዎች የገዥው መሪዎችን የሚባለው
የሚሉ : ወታደራዊ # ዛሬም ዋነኛ የሚዲያ
ጥያቄዎችን : የድጋፍ ከነፃ ወይም መዋቅሮችን ግን
መዝዞ : የመረጃ የፖለቲካ ባህሪ መሪዎችን ሚዲያ
ደክሞ : ፖሊሲ ጉድለትን እንደነበረው ሚዲያን የአፈና
ወጥቶና : አዲስ መርጦ ሊሸፈን ሲያበቃ የሚሰብክና
ወርዶ : እንደሚላቸው ሥራዎችን የተባለውን ሚዲያ እዚህ
ማን : የአድማጭና ቅሬታቸው የሚገነባውና በእስያም በሙያተኛው
መረመረ : ያነሳሁት ይገባዋል ይባላሉ ይታወቅልኝ ግን
አረጋገጠ : ሐሰት ናት ግን * ይመስለኛል
ሁለተኛው : ጉድለቶችን የሐሳብ ሐሳብ አምባገነናዊ ግን
የእኛ : አየናቸው ሀሰትን ጊዜ በ#ኛው ይህ
የከሸፈ : መነሻ ስለማይችል የብሮድካስት ፍልስፍና ሐሳብበዓለም
ሚዛናዊነትና : የሕዝብ ሳንሱር ሥልጣንን አምባገነናዊ የሚጣጣሩትን
አጠንክሮ : ስለሚሰጣቸው የፓርቲው ከአገዛዙ ለመጠበቅ እዚህ
አለመያዙ : ታስቦ አለመስጠት መሄዱ የተስማሙበት መርሆ
በየትኛውም : አለማየት በነፃነትና ሚዲያ እዚህ ይበጅ
ቢመዘን : በውስጡ መለኮታዊነት ሐሳብ አምባገነናዊ እዚህ
አይደለም : ጋበዛቸው ይበዛል ተቀላቅለዋል ያደርጋል ይታወቅልኝ
በፆታ : ጊዜ ይህ ለመጠበቅ ይመስለኛል ይበጅ
በሃይማኖት : ፈጣን የማይችል መመለስና ከአገዛዙ ግን
በቋንቋ : ጥቂት ባህል መገልገያ በመደገፍ ከአገዛዙ
ወዘተ : ከሪፖርተር ኮሌጅ በቅድሚያ አስተዳደርና የፌደራሉም
የሚስተዋሉ : ስለሚሰጣቸው የመገናኛ ተደርጎ ሥልጣንን ሐሳብበዓለም
ተፈጥሮአዊና : ለምክር ፍፁም ባህሪ መሪዎችን ሚዲያ
ሰው : ውስጥ በነፃነትና ስለማይችል ዴሞክራሲያዊ ሐሳብበዓለም
ሠራሽ : አደጋ ሳይሆን ማንም የውጭ የአፈና
ብዝኃነቶችን : ሲሆን የጋዜጠኞች የጋዜጣ መዋቅሮችን አስፈጻሚ
ማስተናገድ : ጳጳስ የተፈታ ይበጅ
ይጠበቅባታል : ከኢትዮጵያ ለማድረስም ይቀናቸዋል አልነበረም ተጭኗቸው
ከዴሞክራሲ : የሚገመተውን ዘገባዎች በብዙዎቹ ገድሏል በማያፈናፍን
እሴት : በቋንቋ በከፍተኛ የፖለቲካ ሚዲያን ሚዛናዊነትን
ከመረጃ : የሚሠሩ የማይችል ግን እዚህ ይበጅ
አኳያ : የማይመረምር ኒዮሊብራሊዝም ወደኋላ ተደርጎ ግን
የሚባለውም : እንደተሰጣቸው ባለቤት ብዙኃን አገር ዘመን
ጭብጥ : ኢንዱስትሪ የመንግሥት በሥልጣን ዘመን እዚህ
መዘንጋት : ሽብር መዝለፍ ማጋነን ሳንሱር ይበጅ
የለበትም : ይተቸዋል ይመርጣል አሉ ሚዲያ ግን
አሁን : የሚገነባውና እንደሌለው ሐሳብበዓለም ለመጠበቅ *
ባለው : ቢታወቅም በፊት ሚዲያዎች ይህ ቀዳሚው
እየተስተዋለ : እንዲገኝ ዕድል ናቸው አስሯል እንደተጀመረ
ከተፎካካሪዎች : በተጠንቀቅ በግልጽ በመቶዎች የኅትመትና ላይ
ተቃዋሚዎች : አስተሳሰባቸው የሚባለው ለመጠበቅ እዚህ ይበጅ
ሰፊ : የሚደፈቅበት ዘመን የሚባለው ለመጠበቅ እዚህ
ሲሰጠው : እንዲገኝ ሴራሊዮን አስሯል እንደቆሙ ሥልጣን
ድብልቅልቅ : የዲሞክራሲ በሙያተኛው በእንግሊዝ በ#ኛው ለመጠበቅ
እህል : ላይ ይበጅ
የሞላበት : ሁለት በረጅም ተመልካች የከተሞች አባልነትና
ጎተራ : በቋንቋ መልስ የፕሬስ የውጭ ብዙዎች
ይዘነጋና : የነፃነት ጠቃሚ ክፍለ ለመጠበቅ *
አቅጣጫ : ዋናዎቹ ቀዳሚው ይበጅ
ያዘነበለ : እንደሆነ እዚህ * ይበጅ
ድምዳሜን : ጉድለቶችን መገናኛ ብዙዎች ግን ላይ
ተናጋሪዎች : ጋዜጠኛና መሣሪያዎቹ ብለው መገለጫ እዚህ
ደጋግሞ : የሚጠቅም ዓለማዊ ብቻ ይበጅ
ማቅረብ : ምንዛሪ ያዘነበለ አደረጃጀት ሥነ እንደሆነ
የፍልስፍናው : የማይችል ንድፈ እዚህ ይበጅ
ሁልጊዜም : የነበሩበትን ህንድ መልስ የውጭ አስፈጻሚ
መስተናገድ : ሀብት ሚዲያን መለኮታዊነት በእንግሊዝ ሐሳብ
የተለየና : አኗኗሩ መቀነስ ትክክለኛ የሌለበት ጨምሮ
ይህን : የነፃነት አቀባይ የሐሳብ ዘመን የሚጣጣሩትን
ተፈጥሯዊ : በብዙዎቹ በማያፈናፍን ዛሬም ዴሞክራሲያዊ የሕዝብን
እንደሌለ : ፖሊሲው መኖር ባህሪ መገለጫ ለመጠበቅ
አድርጎ : ከኋላቀርነት የመስኩ የፕሬስ ያሉ ሚዛናዊነትን
ተዓማኒነትን : ባንኩ ኃላፊ አስሯል እንዳይኖር እንደተጀመረ
ያሳጣል : ተቀላቅለዋል ያደርጋል ይመስለኛል ይበጅ
በነገራችን : በንጉሡ የሐሳብ በሥልጣን እዚህ ይመስለኛል
ብዙኃንን : የሚወዳቸውን ቲ ለምክር የፕሬስ ንድፈ
በልቅነትና : በእስልምና ተነባቢነት ቢኖሩም በአሠራር ግንኙነትና
በነፃነት : ከፍተኛ ሠራሽ የሚያደርግ በብዙዎቹ መገናኛ
መልቀቅ : የበረታበት ይኼን መስተዳድርን ፖሊሲው ቢኖርም
ለግል : ከፍሎሪዳ ቤቶች የጋዜጠኞች የሚዲያ የሚጣጣሩትን
ባለሀብቱ : ሕይወታችን ጊዜም ስለማይችል ሌላ ወታደራዊ
መሣሪያ : ቀንዲላቸውን አንድ ቢኖርም በሥልጣን እዚህ
እንዲሆን : ክትትል እንዳይኖር ይበጅ
ስለዚህ : ተሰበረ አስተሳሰብ # ሚዲያ ንድፈ
መንግሥታት : ውጪ በመቶዎች በአንፃሩ ሚዲያን በመደገፍ
በመጠኑ : መኖር የብሮድካስት ቢሆን ያለበት በመደገፍ
ባለቤት : ዓመታት አለመላቀቁ ሚዲያን የውጭ በላቲን
ሊሆኑ : ዕድገት በራሳቸው የያዟቸው የተስማሙበት የሚወርደውን
ይገባል : የያዟቸው እንዳይኖር ማረጋገጥ እዚህ ይበጅ
አቀንቃኞች : አውጪ ጉድለትን ቀዳሚው አምባገነናዊ ላይ
የሚያነሱት : ጭምር ምርመራ በሥልጣን የሚባለው ለመጠበቅ
ጉዳይ : ባለሥልጣን ጉድለቶች ከድህነት በመደገፍ በሥልጣን
የኮሙዩኒኬሽን : መቀየሪያ ጉድለቶች የመሥራት እንዳጫወተኝ ወታደራዊ
ደኅንነት : ሁሉ ምክንያቱ አፋኝ ኤርትራን መገለጫ
ይኼውም : መነሻው የሚጣጣሩትን ለመጠበቅ ግን እዚህ
ድምፃቸው : አብረውት ብል ገለልተኝነትን ይታይ የአፈና
እንዳይሰማ : ወዳጄ መገልገያ የውጭ ለመጠበቅ ላይ
የሚታፈኑ : የማሻሻያ የአሜሪካ የአንዳንድ ሁለት የከተሞች
ወገኖችን : ሲል የውጭ የአፈና ለመጠበቅ ግን
መቀነስ : ለምርመራ ልማድ ሌላ በማያፈናፍን መገልገያ
ጉዳታቸውና : በቪዲዮ ወስደው የመስኩ መሆኑ አሠራር
ቅሬታቸው : ጥያቄዎች አቋም የልማታዊ መዋቅሮችን ሚና
ያልተገለጸ : መቶ በማያፈናፍን የአፈና ክፍለ ለመጠበቅ
አካላት : በሕገ ግን እዚህ ይመስለኛል ይበጅ
እንዲሰማቸው : የሚገነባ መገልገያ ያለበት ለመጠበቅ ላይ
ማድረግና : ማድረሳቸው ትችቶች ፍልስፍናን ያለበት መገለጫ
የአገርን : የሻረ ድምፅና እዚህ ይመስለኛል ይበጅ
ማስቀደም : እጅ በተግባራቸው አምባገነናዊ ለመጠበቅ ላይ
ዋጋው : ቀንዲላቸውን ወይም ባህል ቀብሯል አሳድዷል
ከፍ : ባይባልም ቢነሳም ዕገዳና መገለጫ መንግሥትንና
ያለ : እንደቆሙ የተስማሙበት ሥልጣን ሥልጣንን ቆራጭ
ስለሆነ : ያለ ድክመት እንደቆሙ የተስማሙበት ሥልጣንን
የነፃነት : አድልኦ ዋናው ዘመን የሚጣጣሩትን ለመጠበቅ
የሊብራል : ያነጋገራቸው ማፅናቱ የሙጭኝ በሥልጣን ለመጠበቅ
ሐሳብአሁን : የነበረችውን ከሕግ ሚዲያዎችን ዘመን አምባገነናዊ
ኒዮሊብራሊዝም : ዳይፐር የሌለበት ያለበት በመደገፍ ተደርጎ
የተባለውን : ሚዲያ ሚዛናዊነትን እዚህ ይመስለኛል ይበጅ
መንግሥትን : እሴትን ልማታዊነት ኢንዱስትሪውን መንግሥትንና እዚህ
የሚያዳክም : ተመን ከነምክንያቱ ሊሸፈን ላይ እዚህ
ጥቅምን : በብዛት የከተሞች ናቸው የፓርቲው እንዳይኖር
የሚጎዳና : የሚናገሩ መገልገያ አሜሪካና ላይ እዚህ
ሁሉ : ደኅንነት ምግባርና ኤርትራን መገለጫ ይህ
ለገበያና : ቲሸርት ሐቅን ቀደም በማድረግ ትንሽ
ለባለሀብት : ሊተች ተደርጎ የሚወርደውን ግን እዚህ
የሚሰጥ : ትቶት ኤመርሰን ለምክር እያደረገ ባህሪ
ሲል : ወገኖችን የዓለማችን የክልል የአፈና ለመጠበቅ
ይገልጸዋል : ሸሽቶት ይከለክላል ጽፈዋል አሳድዷል ደርግ
ፀረ : ከማጋለጥ ትውልድ ይህ ለመጠበቅ ይመስለኛል
ልማትና : ባለፉት መታየት ለምክር ቢያንስ በተስተካከለና
ኪራይ : የሚጠየፍና በተጨባጭ በከፍተኛ በኋላ መገልገያ
ሰብሳቢ : ዴሞክራሲ መገለጫ ሚና ለመጠበቅ እዚህ
ሲልም : የሌለበት የሚጋርጥ በሕገ በመደገፍ የፈላጭ
በድፍረት : ሊካድ በብዛት መስጠትና ቢሆን እንዳይኖር
ይተቸዋል : የለበትም ሚዲያ እዚህ ይመስለኛል ይበጅ
ልቅ : ጊዜ ሙሉ ያሉ ይህ ታሪክ
እንዲኖርም : ቫሉታ ሀብት እሴትን ልማታዊነት ኤርትራን
አለመፈለጉ : ሥልጠናዎችን በማያፈናፍን ለመጠበቅ ላይ እዚህ
ሳይታለም : ፊላደልፊያ ከአዘጋጁ ፈጥኖ ጥረት ቀጣይነት
የተፈታ : እየተገኘ ማረጋገጥ ይበጅ
በባለቤትነት : መርዶ በተግባራቸው አምባገነናዊ ላይ እዚህ
የያዛቸው : የብሮድካስት ፍልስፍናን ተደርጎ በ#ኛውና አምባገነናዊ
እንደዚያ : የመጡት መርሆአችን በላቲን እዚህ ይበጅ
አይችሉም : አይድንም አይደሉም ይነገራል አገር ክፍለ
ከ# : ጉምሩክ አውሮፓዊያኑ ሚዲያ ሚዛናዊነትን ይበጅ
በቅድሚያ : ዓ.ም. የሚንገታገቱ ዋናው ይህ ለመጠበቅ
ቀጥሎም : ባለፉት አንዳንድ በአንዳንድ አቀባይ በንጉሡ
በዩናይትድ : የሚኖረውም በመካከለኛው የፈላጭ በእንግሊዝ ሚዲያ
ስቴትስ : ምንዛሪ ያዘነበለ አደረጃጀት ሚና እዚህ
በሌሎችም : ከማጋለጥ ይህ ለመጠበቅ ይመስለኛል ይበጅ
የተስፋፋ : መሆናቸው እንዴት የሚወሰድ መርሆ እንዳልዘነጋሁ
በምሁራኑ : ፔንሲልቫኒያ ቶማስ ለውጥ መንገድ ፍልስፍናን
ጆን : የምንዛሪ ችግሩ ነፃ አፋኝ በ#ኛውና
ሚልተን : ተማሪ ሰብሳቢዎችና እንደሌለው ዘመን እንዳልዘነጋሁ
ሎክ : ፕሬስ መደበኛ የቦርድ የማይችል አፋኝ
ሚል : ጥሩ በሳይንስ ንገረኝ ገጽታዎች እየተከተሉ
እና : ፕላን ጨምሮ የሚጋርጥ የገዥው በነፃነትና
የዩናይትድ : ጽንፈኝነትን ከኋላቀርነት ፕሮፓጋንዳ ወደ ሚዛናዊነትን
ፕሬዚዳንት : በሚዛናዊነት የተሰማሩ ቢሆኑም ግንኙነት አገዛዝ
በነበሩት : በማተሚያ የዲሞክራሲ የፖለቲካ ቁጥራቸው በእንግሊዝ
ቶማስ : መስተዳድርን አባልነትና መዋቅሮችን ሚና ለመጠበቅ
ጀፈርሰን : የምንዛሪ የሚመሩ መመለስና የሳንሱር በ#ኛውና
ተቀንቅኖ : ከመጠን ባይሆንም ሚና እንዳልዘነጋሁ የሚጣጣሩትን
በፊውዳሊዝም : ጥቂት በመረጋገጡ መገልገያ በመደገፍ ለመጠበቅ
መፈራረስና : ለመጠበቅ እዚህ ይበጅ
ካፒታሊዝም : ከሙያዊ በገዥው ብዙዎች ንድፈ ግን
ማበብ : ተመን አስተሳሰባቸው የሚባለው ለመጠበቅ እዚህ
ጉልህ : ጉድለቶች ወታደራዊ በእንግሊዝ ለመጠበቅ ላይ
ተጫውቷል : ይቀላቀላል ተችሏል ይባላሉ አነብናቢነት ክፍለ
እምነቱ : በመመለስ ጫፍ የአፈና የሚሰብክና ክፍለ
ሊያሳውቅ : የነበረችውን እንቅፋቶች መርሆአችን የመሥራት ወዳጄ
ሊያዝናና : መርምሮ የክልል ሚዲያን አምባገነናዊ ገለልተኝነትንና
እንደማንኛውም : ተደንግጓል በከፍተኛ የፖለቲካ በማያፈናፍን የሙጭኝ
ሸቀጥ : የያዘበት ለመጠበቅ ላይ እዚህ *
ሊነግድ : ከኢትዮጵያ ኃይሎችን ተጭኗቸው እዚህ *
የሚል : ቲ ከ# የጋዜጠኝነት ህልውናዬ ያሉ
በዋናነት : አዎንታዊ ልማታዊነት እዚህ ይበጅ
በግል : ካልሆነው ነፃነት በሥልጣን ለመጠበቅ *
መያዝ : ሆረስ በአንፃሩ ትንሽ ሥልጣንን ቀዳሚው
እንዳለበት : በጅምር መሆን ይበጅ
ነፃና : ማድረሳቸው ደኅንነት መነሳትና መኖር መገለጫ
ከቅድመ : ቫይረስ እየገነጠለ ሙስናን መቶ የሕዝብን
ውጪ : እየጨመሩ መንግሥትን መንግሥታት ሚዲያን የአፈና
እንደ : መንስዔ የአፈና ለመጠበቅ ላይ *
አራተኛ : ሁኔታ ቀጣይነት መንግሥትንና ቀዳሚው የሚጣጣሩትን
አካል : ቲ የማተሚያ መንግሥታትም ዴሞክራሲያዊ ንድፈ
ከሕግ : ሐሳብአሁን ሚዲያዎችን የአፈና ለመጠበቅ *
አስፈጻሚና : ምሥራቁ ታሪክ እዚህ ይመስለኛል ይበጅ
ሕግ : ቢሊዮን መቀነስ ለምክር ሚዲያ ንድፈ
ተርጓሚ : ማየት ምሥራቁ ቢኖርም እዚህ ይመስለኛል
ተደምሮ : ጨምሮ ዜጎችን መገልገያ በመደገፍ ግን
መታየት : መቀነስ የክልል ጊዜም ብዙዎች የአፈና
ይቀነቀናል : ተረዳ አይድንም ከዓለም ጨፍልቋል አይደሉም
ገለልተኛና : ወይም አንድ በሕገ ዋነኞቹ ያለበት
እሳቤዎችን : በመመለስ ማግኘት የኤሌክትሮኒክና ወዳጄ የውጭ
ቢያቀነቅንም : የሚያደርግ ላይ እዚህ ይበጅ
ውግንናው : ሁነኛ ጉድለት በማስመሰል ባህሪ ፍልስፍና
ለሊብራል : አበርክቶው እንደሌለው ሚዲያ ሚና ገለልተኝነትንና
ሥርዓቱና : ሆኖ አገዛዝ ሚዲያ ግን ይበጅ
ለባለሀብቱ : በሰላም ተከናውነዋል ለመጠበቅ ላይ ይመስለኛል
የግልም : ሃይማኖቶች በሥልጣን ለመጠበቅ ላይ እዚህ
ይሁን : ፖሊሲ የሚንቀሳቀሱ ዋነኞቹ ተደርጎ ሥልጣንን
የአክሲዮን : ፖሊሲ የአንዳንድ የአፈና ለመጠበቅ ላይ
አልያም : የሚባለው ለመጠበቅ እዚህ * ይመስለኛል
የምዕራቡ : ማሪዋና በውስጡ የልማትና ሚዲያን መለኮታዊነት
ከርዕዮተ : እኔና መቶ መንግሥትና በኋላ በማያፈናፍን
ሊጋጭ : በንቃት ዋነኞቹ ያለውን አምባገነናዊ ለመጠበቅ
እንደማይችል : እንደተጀመረ ሚና እንዳልዘነጋሁ እዚህ ይበጅ
አስመስክሯል : ይናገራል አሉ ሐሳብ ንድፈ ግን
መረጃ : ስለነበረ ለዴሞክራሲ ወታደራዊ የመንግሥት ሚዲያ
በሸቀጥነት : አገዛዝ ንድፈ እንዳልዘነጋሁ ግን ይበጅ
ከቀረበ : ብዙ ተፈጥሮአዊና በማስመሰል ምግባርና መሆኑ
የሆነውን : ወደኋላ ደግ ሙሉ ፈቅደው የአምባገነን
ካልሆነው : ጫፍ ፕሮፓጋንዳ የሕዝብን የአፈና በእንግሊዝ
መርጦ : ሲያበቃ የሚሰብክና ለመጠበቅ * ይበጅ
የመውሰድ : አድናቆት ሲል በአመለካከት በማያፈናፍን #
የአንባቢውን : መርዶ አባልነትና በሥልጣን አምባገነናዊ ለመጠበቅ
የአድማጭና : ትገዛ በቋንቋ በ#ኛው ለመጠበቅ ሚዛናዊነትን
የተመልካቹ : ባህሪ ፍልስፍና እዚህ ይመስለኛል ይበጅ
መብቱ : የሚያውቁት አገናኛቸው ይቸገራሉ አነብናቢነት ያደርጋል
በሠለጠነ : ጳጳሱ ሠርቶ ኢሕአዴግ ዓ.ም. ዋነኛ
ማኅበረሰብ : በማላቀቅ የመረጃና መሪዎችን በ#ኛው የሚባለው
ጠቃሚና : ተነባቢነት ከልክ ሙያና መመለስና በሕገ
ተገቢ : ያለፈ የውጭ ብዙዎች በሥልጣን በ#ኛውና
ባለፉት : ከሕዝብ የሚጣጣሩትን ለመጠበቅ እዚህ ይመስለኛል
ሃያ : አገሪቱ የኢትዮጵያ አውሮፓዊያኑ የሚወሰድ አገዛዝ
ከሞላ : አባልነትና ሥራ ያለበት መዋቅሮችን በሥልጣን
ጎደል : የኢትዮጵያን የዴሞክራሲና ኢንዱስትሪውን ላይ እዚህ
የዚህን : አውጪ ግንኙነትና ብለው ይህም መንግሥትንና
የፍልስፍና : ቲ ጉምሩክ መሆኑን አውሮፓዊያኑ ዴሞክራሲያዊ
ሞዴል : የሚያደርግ ሚዲያን በላቲን ለመጠበቅ ላይ
አርዓያ : የሥርዓቱ የውጭ አስፈጻሚ የአፈና ይህ
የሚንቀሳቀሱ : ዳይፐር ከነምክንያቱ አንድ ሚዲያን ይህም
ጋዜጦችና : በህንድ የጋዜጠኝነት በገዥው ብዙዎች የፈላጭ
መጽሔቶች : ሲጣጣሩ መኖራቸው እየተገኘ የሚጠቅም ሊገቡ
ታይተዋል : ታይቷል ይባላሉ ከመጣ ይታወቅልኝ ግን
በኩል : ወር እሳቤዎችን ከ# የአፈና በእንግሊዝ
ሊብራሊዝምን : ለምን ተሳትፎ ለመጠበቅ * ይመስለኛል
እንደፍልሰፍና : በቋንቋ የሚያደርግ የሐሳብና ደርግ ላይ
በመከተል : ከየዓይነቱ ኃላፊነት መርጠው እንደመርግ ላይ
የሚያቀነቅኑ : ሊተች ድረስ አገር የሚጣጣሩትን ግን
ከዚያ : የተንሸዋረረ ተጭኗቸው የሚባለው እዚህ ይመስለኛል
የመሰላቸውን : ለዴሞክራሲ ዴሞክራሲያዊ መለኮታዊነት የፈላጭ ለመጠበቅ
አቋም : ጥያቄዎች ሚና እዚህ ይበጅ
የሚያብጠለጥሉ : መመንዘር መሆን ከሆነ ባለሙያዎች ድክመት
በሌላ : የአዲስ የሳንሱር የሚዲያ የሚጣጣሩትን ግን
የሚዛናዊነትና : የምታውቁ በኢትዮጵያ ማለት ይህ ቀዳሚው
የተዓማኒነት : በከፍተኛ የፖለቲካ መሪዎችን ሚዛናዊነትን ላይ
ፈጥኖ : የጋዜጠኞች የጋዜጣ ደርግ አስፈጻሚ ለመጠበቅ
መውጣቱ : አውጪዎችና ሰፊ በብዙዎቹ የብሮድካስት በማያፈናፍን
ያለከልካይ : ሃይማኖቶች የሚመልስ ክፍለ በ#ኛው ለመጠበቅ
አንባቢያን : ሚዲያን የውጭ የአፈና ሥልጣንን ለመጠበቅ
ማድረሳቸው : በፊውዳሊዝም በአሠራር አባልነትና ያለበት ለመጠበቅ
ሊባል : አምርሮ ሊፈርድ በሥጋት በ#ኛው ይበጅ
ጉድለታቸው : ያደረጉት ባለፉት ሥነ የሚጣጣሩትን እዚህ
በአብዛኛው : የበረታበት ይኼን ያደርጋል ይህም ይታወቅልኝ
የሚመስል : የሚገነባ ቢኖርም መዋቅሮችን አምባገነናዊ ለመጠበቅ
ጫፍ : ካልሆነው የአፈና ለመጠበቅ ላይ እዚህ
የወጣና : አለማወቅ አንድ እንዳልዘነጋሁ ግን እዚህ
የተቀናጀ : አለመላቀቁ ንድፈ ግን እዚህ *
ዘመቻ : ለባለሀብት ሊተች ተደርጎ ግን እዚህ
ማካሄዳቸው : መርሆ እንዳልዘነጋሁ እዚህ ይበጅ
እያደነቃቸው : ነፃነትና በሙያተኛው መገለጫ በ#ኛው ሚና
ጅምሮችና : ሰው ውስጥ በአዋጅ የኅትመትና የፈላጭ
ሥራዎችን : ሚዲያ ሚና ለመጠበቅ እዚህ ይመስለኛል
ጥላሸት : አለመፈለጉ በማያፈናፍን ይህ ለመጠበቅ ላይ
መቀባት : የጋዜጠኞች እንደመርግ ቀዳሚው ለመጠበቅ ግን
መደበኛ : ጨምሮ የሚያፍንና የሚዲያ ለመጠበቅ ግን
ሥራቸው : ከተማውን ዕይታ መርሆ እንዳልዘነጋሁ ይበጅ
ሆኗል : ተረጋገጠለት አይደለም ደርሰዋል ይሆናሉ አነብናቢነት
ጉዳዩን : ዜጎችን # ሥልጣንን የሚጣጣሩትን ግን
መርምረው : ሲጠጋው ኢንዱስትሪው ሚዲያን ሥልጣንን ገለልተኝነትንና
በሚዛናዊነት : የተሰማሩ መስተዳድርን የተቋሙ ያለበት ሚዲያ
በጥልቀት : በኢትዮጵያ በማድረግ የአፈና መለኮታዊነት በእንግሊዝ
ሠርቶ : ሳይሆን የጋዜጠኞች መቶ ከአገዛዙ ቀዳሚው
ከማቅረብ : ሃይማኖቶች ተቀባይነትና ኢንዱስትሪ በ#ኛው ለመጠበቅ
የለብለብና : ዳይፐር ኒዮሊብራሊዝም ጥረት ያለበት በመደገፍ
ያልተጨበጠ : ለምክር ፍፁም ፍልስፍና ሚዲያ ሚና
ዜና : ተጭኗቸው እዚህ ይበጅ
በረከተ : ተፈጥሯል አይደሉም ያደርጋል ነው ንድፈ
መርዶ : የተለያዩ በባለቤትነት የሚባለውን አባልነትና የሚናገሩ
ነጋሪዎች : በብዛት የሚታበል አገሮች በመደገፍ እንዳልዘነጋሁ
እንደሚላቸው : ወርዶ አይመስለኝም ሚዲያ እዚህ ይመስለኛል
ተሰበረ : በአስተሳሰብ አስተዳደርና አስተሳሰብ የጋዜጠኝነት ምግባርና
ሞተ : ባኖረ ሐሳቤን ዘገባዎች የሚደፈቅበት የሚገባው
አንዳንዴም : የምንዛሪ የጋዜጣ ነበር መሆኑ አስፈጻሚ
በሰላም : አገናኙን ለባለሀብቱ የከተሞች በ#ኛው ይህ
ጦርነት : ለገበያና ግን ይበጅ
ተቀሰቀሰ : አገናኙን የሚዘርፉ መነሳትና ፍፁም መገለጫ
በማለት : ያለፈ አገር የሚጣጣሩትን እዚህ ይመስለኛል
ሽብር : መዘንጋት የሚጠቅም ናቸው አስሯል ይበጅ
ይለቃሉ : ይታወቃል አሳድዷል አሉ ይታወቅልኝ *
መካብ : ፈጽሞ አንዳንዶች በግብርና አድልኦ ባይባልም
የተፈለገውንም : የሚያውቅ ቢገለጽም የሚባለውን ገለልተኝነትን ከፈላጭ
በባዶ : ቪክተር ከአንዳንድ የፓርቲው አፋኝ ያለበት
እያገዘፉ : የመንግሥት አምባገነናዊ እዚህ ይመስለኛል ይበጅ
ማደናገር : የሚያብጠለጥሉ ብቻ እንደቆሙ አገዛዝ ይበጅ
ተለመደ : ይነገራል ግን እዚህ ይመስለኛል ይበጅ
የተዛባና : ዋነኞቹ ሳንሱር መለኮታዊነት ሥልጣንን ለመጠበቅ
ከነፃ : የተለያዩ ፈቅደው አምባገነናዊ ላይ እዚህ
ያፈነገጠ : በሚናፈስበት በሥጋት እዚህ * ይበጅ
ድርጊትም : በሚገኝ አንድ ነበሩ የሚወሰድ ግን
አለፎ : መሀል አምባገነናዊ እንዳልዘነጋሁ ላይ እዚህ
አልፎ : ይኖርባቸዋል ያለው መመራታቸውና የተባለው የሐሳብ
መተላለፍ : ጂቡቲ የዚህን መሣሪያዎቹ መንግሥትንና የአፈና
የአገር : ግን እዚህ ይበጅ
መንካት : እዚህ ይመስለኛል ይበጅ
ሲሄድ : ዕርዳታ ተዓማኒነትን ማረጋገጥ እንዳልዘነጋሁ እዚህ
ታየ : ሸሽቶት ተከናውነዋል አይመስለኝም ያደርጋል ይታወቅልኝ
ለማጠቃለል : አንዳንድ የአዲስ በአፍሪካ የሚዲያ ዋናው
የሚመራባቸውና : መስፋፋት ቀፍድደው የከተሞች በሥልጣን ለመጠበቅ
እያለፋቸው : ፍፁም ያለበት መሪዎችን ለመጠበቅ ይበጅ
የመጡት : እንደዚያ በእርሱ የሆነ ዘመን እዚህ
ዋናዎቹ : ደርግ መንግሥትንና ቀዳሚው ለመጠበቅ ላይ
ሐሳቦች : አለማወቅ ድጋፍ ሊካድ ጎን የያዟቸው
ይመስሉኛል : ይበዛል አሳድዷል አይደሉም በሥልጣን ይታወቅልኝ
አንዳንዶች : ሁሉም የነፃነት ሲያበቃ ዋናው የአፈና
ከየዓይነቱ : በመከተል ሚዛናዊና ኃላፊነት የሚባለውን በክልልና
የሚጠቅማቸውን : ለምርመራ መስፋፋት ቆራጭ ዘመን ሚና
ወስደው : ቃል የመስኩ ሚዲያን ከአገዛዙ ሥልጣንን
በራሳቸው : የሚጠቅማቸውን የሚወርደውን ቆራጭ እዚህ *
ልቦናና : ማንም የውጭ ፍልስፍናው የአፈና በ#ኛውና
ታሪካዊ : የሰው ቀጣይነት ለመጠበቅ ላይ *
ቃኝተው : አደጋ የውጭ ብዙዎች ባህሪ ንድፈ
መልካም : የፈላጭ ለመጠበቅ እዚህ * ይመስለኛል
ጅምር : የኢኮኖሚ ክትትል የሕዝብ በሥጋት ቀጣይነት
ያሳዩም : ሊወጣ ተዓማኒነት እየታየ ማረጋገጥ የሚወሰድ
በአፍሪካም : ከኢንዱስትሪና ዋናው የሚጣጣሩትን ሚዛናዊነትን ላይ
እነ : ምርመራ የሚባለው ታሪክ ሚዲያ እዚህ
ጋና : ሠራሽ ማንም አሠራር የአፈና ሥልጣንን
ቦትስዋናና : ደክሞ ጉድለትን በአንፃሩ ትንሽ መለኮታዊነት
ደቡብ : ማድረሳቸው በቋንቋ ለመጠበቅ ላይ ይመስለኛል
አፍሪካ : እንዲሳተፍ መስጠትና አባልነትና በመደገፍ ከአገዛዙ
የዴሞክራሲና : መሠረት መንግሥትንና የአፈና ይህ ቀዳሚው
የመረጃ : የሴት መዝዞ የአንዳንድ የፈላጭ ለመጠበቅ
ቀንዲላቸውን : መሣሪያ ማጣትንም የ ቼክሊስት አልነበረም
አድርገው : ሮዚም ልማድ እየተከተሉ ዋነኛ ለመጠበቅ
እያበሩ : ማድረግ እንዴት ድክመት እንደቆሙ የተስማሙበት
የደረስንበት : አባልነትና ያለበት ቀጣይነት ቀዳሚው ለመጠበቅ
ክንድ : ለመገንባት ህልውናዬ በመቶዎች ትንሽ ቀዳሚው
የበረታበት : ይኼን ኃላፊዎችና የከተሞች በሥጋት የሥርዓቱ
የግሉ : በሚዛናዊነት ኒዮሊብራሊዝም በቋንቋ ያለበት መዋቅሮችን
የኮሰመነባት : ለብቻው ቁጥር ጨምሮ ሕዝቦች ነው
ብሮድካስት : ሐሜትን ኤመርሰን ለውጥ የማይችል ሜዳ
በፍልስፍና : ይኼ ሥርዓቱ የዚህ መንግሥትንና አስፈጻሚ
ረገድም : ሲልም የሌለበት በነፃነትና የኅትመትና በእንግሊዝ
በሊብራሊዝም : የተለየና አስተዳደርና የመናገር የሚያፍንና ሐሳብበዓለም
ልማትን : የለብለብና ለትችት በአሠራር ቤቶች ደርግ
የሚጠየፍና : ኪራይ ፍልስፍናዬ የሕዝብን ለመጠበቅ ላይ
ምንም : ተልዕኮውም ዋነኛ የሚዲያ ዋናው የሚሰብክና
በጎ : የድጋፍ በምዕራብ የተለያዩ ወገኖችን የውጭ
የማያይ : የውጭ ብዙዎች የአፈና ሥልጣንን ግን
በልማታዊ : መከናወን ግንኙነትና መገለጫ ቀዳሚው እዚህ
ዴሞክራሲና : ኢንዱስትሪ ለመጠበቅ እዚህ * ይመስለኛል
የሕግ : በአሠራር በላይ ቀዳሚው ላይ ይበጅ
የበላይነት : ጋዜጦችና ማፅናቱ የሙጭኝ የሚባለው ንድፈ
እንዳሉ : እንለወጥ ሰዓታት የአሁኑን በማድረግ በእንግሊዝ
የማይመረምር : ወደኋላ የሌለበት ተደርጎ በ#ኛውና ቀዳሚው
የተንሸዋረረ : ከዚያ ባህል ሚዲያን መሪዎችን ሚዲያ
ዕይታ : ሥራቸው መርሆ ይበጅ
ተፈጥሯል : አቋቋመ በረከተ እስከ የሚወርደውን መርሆ
ሁሉም : አንዳንዶች የነፃነት ሲያበቃ ዋናው የሚጣጣሩትን
ከሚያመቸው : ቢበዛም ያለውን ላይ እዚህ *
ቅንጣቢውን : በካሜራቸው እንኑር ከፍ ሚና የሚጣጣሩትን
እየገነጠለ : በተጠንቀቅ ሠርቶ ከቅድመ አኳያ የቦርድ
በእውነት : ነበሩ የሚወርደውን እዚህ ይመስለኛል ይበጅ
የማያሞግስና : ዕገዳና መዋቅሮችን አስፈጻሚ ለመጠበቅ ላይ
የማይተች : ባለመቻላቸው አምባገነናዊ ላይ እዚህ *
ቁጥሩ : እንለወጥ ጉድለቶች በማያፈናፍን በእንግሊዝ ለመጠበቅ
ቢበዛም : መርምሮ በንቃት የክልል ሚዲያው ያለውን
አድርባይነትና : ጥቂት በክልልና መስተዳድርን ሥራ በመደገፍ
አሻጥር : ያመሰጠረበት በሥጋት መዋቅሮችን ከአገዛዙ እዚህ
የሚጠልፈው : ተቀባይነት በብዙዎቹ የጋዜጣ ደርግ በላቲን
አይድንም : አይችሉም አይደሉም ይነገራል ክፍለ ይህ
እያየሁና : ማግኘት እንዳይሰማ ቀጣይነት በመደገፍ መለኮታዊነት
እየተገነዘብኩ : ጎረቤት ደክሞ ይታዩና ማፅናቱ የአፈና
ከአንዳንድ : ቪክተር የአንድ ፍልስፍናን ያለበት መሪዎችን
ሰዎች : ፀሐፊውን ብዙኃንን መሆኑን መርሆዎች ስለማይችል
ስነጋገር : ያልተለመደም መዝዞ ባህሪ * ይመስለኛል
መቼም : መቀነስ ሥርዓት ሚዲያ ለመጠበቅ ሚዛናዊነትን
ሪፖርተር : እንኑር ቅሬታቸው መሣሪያ የሚገነባ በሙሉ
ሐሳቤን : መኖር አገሮች ሚና ለመጠበቅ *
አይጥለውም : ከማል መመለስና የጋዜጣ መገልገያ አስፈጻሚ
በሚል : አልያም ማፅናቱ የሚባለው እዚህ *
ብዕሬን : ማጥናት መዘንጋት ይበጅ
ያነሳሁት : ገልጿል የሚያውቅ ምንድነው አይደሉም ያደርጋል
ኢንዱስትሪው : የኮሙዩኒኬሽን መስተናገድ ወታደራዊ ሚዲያን ሥልጣንን
በዕውቀትና : ፖሊሲ ወገኖችን በከፍተኛ በማያፈናፍን መገልገያ
በአገራዊ : ልማድ ፖሊሲው በ#ኛው ሚና እዚህ
አለመመራትና : ጉድለትን ሚዲያን የውጭ ያለውን በ#ኛውና
አለመገንባት : ማሊ ሊተች በገዥው ፈቅደው የውጭ
ሊያነጋግረን : ደግ የሚጋርጥ ሥራ ሊተች ፍፁም
ይባልልን : የሚገቡም ማሪዋና ማስፈን የተባለው ሐሳብ
ከአዘጋጁ : ለትራፊክና ሳይታለም ለዚህ ቀጣይነት የሚወርደውን
ፀሐፊውን : አካል መንግሥታትም ንድፈ እዚህ ይመስለኛል
በኢሜል : የውጭ ይህም ዋናው ሥልጣንን ንድፈ
አድራሻቸው : ወገን ቀዳሚው አምባገነናዊ ለመጠበቅ ላይ
ማግኘት : በመመለስ ወገን የአፈና ከአገዛዙ ለመጠበቅ
ይቻላል : ለማድረስም ታይቷል ምንድንነው ምንድነው ናት
የሮማው : በአፍሪካ ዋናው አሠራር ገለልተኝነትንና *
ካቶሊክ : በእንግሊዝ ለመጠበቅ ሚዛናዊነትን ላይ እዚህ
ቤተ : አደጋ መቶ የአፈና ላይ እዚህ
ክርስቲያን : ለመፍጠር አባልነትና ያለበት ቀጣይነት መዋቅሮችን
ጳጳስ : ማስተናገድ ሊኖረው ሊጤን ይበጅ
ከጥር : ቀርተውበታል የለውም ይከለክላል ይኖርባቸዋል ይናገራል
በፊሊፒንስ : አድልኦ የዚህ መንግሥትንና ዋናው የሚሰብክና
የሚያደርጉትን : ፍራንስ ሰጪ ጊዜም ጨምሮ የገዥው
ጉብኝት : በየትኛውም መሆኑን በነፃነትና አለመላቀቁ ሚዲያ
በማስመልከት : እጅ አገሮች በሥልጣን አምባገነናዊ ለመጠበቅ
ትራፊክ : ህንድ በገዥው የውጭ ብዙዎች አገር
ፖሊሶች : ከተፎካካሪዎች ቅሬታ ዋነኞቹ በ#ኛውና ላይ
ዳይፐር : ኒዮሊብራሊዝም ባለፈውና በመቶዎች በመደገፍ አምባገነናዊ
እንዲያደርጉ : እንዳጫወተኝ ሚዲያዎችን በሥልጣን ሐሳብ ለመጠበቅ
ትዕዛዝ : ውጭ ያልፈተሹትን ብዙዎቹ ያለበት መገለጫ
እንደተሰጣቸው : በኢኮኖሚው አደጋ ከመንግሥት የውጭ የአፈና
አጃንስ : ለአጃንስ የህሊና መሆኑ ለመጠበቅ እዚህ
ፍራንስ : ፍራንክሊን በየትኛውም የኅትመትና ሚዲያ እዚህ
ፕሬስ : ሎክ አሁን የሚገነባውና የፈላጭ ለመጠበቅ
ዘግቧል : ታይተዋል ይታወቃል አሳድዷል ደርግ መዋቅሮችን
የተሰጠው : ሥርዓት ይህም የአፈና የፈላጭ እዚህ
በጳጳሱ : የአሁኑን ሁለት በኤዲተርነትና የኅትመትና ላይ
ለረዥም : ባኖረ የሚንገታገቱ ይህ ሚዲያ ለመጠበቅ
ሰዓታት : እንለወጥ በእንግሊዝ ሚዲያ እዚህ ይበጅ
በሥራ : እንደመርግ ቀዳሚው ይበጅ
ገበታቸው : ተቀባይነትና በጥናት መንገድ መዋቅሮችን በ#ኛው
በተጠንቀቅ : ከተፎካካሪዎች ወደኋላ ስም የኅትመትና ላይ
እንዲገኙ : የምዕራቡ በውስጡ የልማትና እንዳጫወተኝ ሚዲያዎችን
ታስቦ : አለመያዙ የተስማሙበት የሚወሰድ መርሆ በ#ኛው
ዳይፐሩን : ስለሚሰጣቸው ዋናው የሚጣጣሩትን ለመጠበቅ ሚዛናዊነትን
ትራፊኮች : መቀባት ተመልካች ጥረት ደርግ ቀዳሚው
ሳይሆኑ : ለሚነገር የአፈጻጸም ሁለት አባልነትና ደርግ
የፀጥታ : የገንዘብ የሕዝብን በሥልጣን መለኮታዊነት የፈላጭ
አስከባሪዎችም : ማሪዋና አዎንታዊ እንደሆነ አለመላቀቁ ሚዲያን
ጭምር : የሚያነሱት ምርመራ የሚባለው ለመጠበቅ እዚህ
የሚያደርጉ : ታላላቅ አተገባበር መንስዔ እየተስፋፋ የውጭ
ሲሆን : መዋቅሮችን አስፈጻሚ ሚና ግን እዚህ
ፀጥታ : ፍቅር የቦርድ ሕዝቦች በመደገፍ ተደርጎ
አስከባሪዎቹም : ሕይወታችን መሆኑም መሥሪያ ስለማይችል በገዥው
ለተፈጥሮ : በመገናኘት መሣሪያ ሙያተኞች ለዴሞክራሲ ከፈላጭ
ጥሪ : መሣሪያ የሆኑ አለማዳመጥ ተጭኗቸው እዚህ
መፀዳጃ : ዓውደ የመገናኛ አገር የሚጣጣሩትን ግን
እንሂድ : በመቆጣጠር በቃላት በመረጋገጡ ሚዲያ ሚና
ሳይሉ : ቤቶች የጋዜጠኞች ይህ ቀዳሚው ለመጠበቅ
ቦታቸው : ፔንሲልቫኒያ ማኅበረሰብ አስተሳሰባቸው ብዙዎች የሚባለው
ማድረጋቸው : እንዳልሆነ ለባለሀብት ጥረት ውስጥ በመደገፍ
አስፈላጊ : ምርምር ስለማይችል ንድፈ ይታወቅልኝ እዚህ
ሆኖ : በቃላት ሥራዎችን ሚዲያ ሚና ለመጠበቅ
በመገኘቱ : የሚጠቁም አለመመራትና መርምሮ በመከታተያ ይታይ
ጉዳዩ : አድርገው ልማድ በእርሱ በሙሉ ቀጣይነት
የሚመለከታቸው : እንዳጫወተኝ አንድ ሚዲያዎችን የሐሳብ ያለውን
ኃላፊ : እንደተጀመረ እንዳልዘነጋሁ ይበጅ
ኤመርሰን : በገዥው ብዙኃን የአምባገነን ንድፈ የሚጣጣሩትን
ካርሎስ : ትውልድ ሥራ በመረጋገጡ ፍፁም መገልገያ
ለአጃንስ : አጃንስ ከርዕዮተ በኋላ የአመለካከት ላይ
ተናግረዋል : ዘግቧል ይታወቃል ነበር ይነገራል በ#ኛውና
ዕቅድ : ግንኙነትና ነፃነትና መንግሥትንና ላይ እዚህ
ከጳጳሱ : ስለኤሌክትሪክ ያለውን ላይ ይበጅ
ቀደም : በማድረግ የአፈና ሥልጣንን ይህ ለመጠበቅ
እንደሚሞከርም : ገለልተኝነትንና ላይ * ይበጅ
አስታውቀው : ደኅንነት በከፍተኛ የአመለካከት ኤርትራን ይበጅ
ጳጳሱ : ነበር ኢትዮጵያዊያንና ዋነኛ መንግሥትንና ዋናው
ከፍተኛ : ንግግሩ እንደ በነፃነት በተጨባጭ መገናኛ
አድናቆት : ሲል የዓለማችን በማያፈናፍን መገልገያ መዋቅሮችን
ስለሚሰጣቸው : በመከተል ወደኋላ ቃል የኅትመትና ተደርጎ
በጉብኝታቸው : ወገኖችን ፍፁም መገልገያ በላቲን ለመጠበቅ
ቁጥር : ሳይንቲስትም የሌለበት በነፃነትና የውጭ ይህም
እንደሚጠበቅ : ባፈቀረ ቢነሳም የሚቆጠሩ መኖር ዕገዳና
የገለጹት : በሥራ ሚዲያን ኤርትራን ያሉ ንድፈ
የሕዝቡ : የፍልስፍናው ደረጃ የማይችል ሊረጋገጥ የሕዝብን
ብዛት : ውጪ ዓመታት ፍልስፍናው ሐሳብ ንድፈ
ከልክ : ተነባቢነት የሚጠይቅ በመደገፍ የፈላጭ ለመጠበቅ
ስለሚችል : ኃላፊዎችና በሙያተኛው ለመጠበቅ እዚህ *
እንሰጣቸዋለን : ድክመት እንደቆሙ የተስማሙበት ማረጋገጥ የሚወሰድ
ብለዋል : ይቀነቀናል ሸቀጥ ጽንፈኝነትን ቆመው አካሄድ
ትራፊኮችንና : አለማየት በነፃነትና የግል ያለበት የፈላጭ
ኃይሎችን : ማየት የመንግሥት እዚህ * ይመስለኛል
የማስደረግ : በኢኮኖሚው ሲል ጉድለቶች በብዙዎቹ ሚዲያዎችን
ፕላን : ትክክለኛ የገዥው በገዥው ሚዲያ ንድፈ
በብዙዎች : እንደግ መቀነስ ወቅት አገሮች ባህሪ
ቀልድ : እየተጎዳ ድጋፍ አይደለንም የያዟቸው በሥጋት
ታይቷል : አረጋግጠዋል ታይተዋል ይባላሉ አሉ ይታወቅልኝ
ለትራፊክና : ከአዘጋጁ በአመለካከት ቢያንስ ለዚህ የሚጣጣሩትን
ለፀጥታ : ትይዩ ደኅንነት የሚያደርግ ኤርትራን የአፈና
አስከባሪዎች : መያዝ መሣሪያ በውስጡ የሚለውን በገዥው
እንደፌዝ : መሆናቸውን እንሰጣቸዋለን ሲሄድ ድክመት አለመላቀቁ
እብድ : በመካከለኛው ፍልስፍና የፈላጭ ሚዲያ ለመጠበቅ
የሰው : ቀጣይነት በመደገፍ መዋቅሮችን የፈላጭ ለመጠበቅ
አኗኗሩ : ትክክለኛ ባህሪ እንዳልዘነጋሁ እዚህ ይበጅ
ቢለይ : ትይዩ ይባልና ምግባርና ይህ ሚዛናዊነትን
ሐሳቡ : ነገሮች መቀነስ የተለየና ዴሞክራሲ በመረጋገጡ
ቢመጥቅ : በ#ኛውና ግን ላይ ይበጅ
ቢተኮስ : ወይም መሀል ንጉሣዊ በ#ኛውና አምባገነናዊ
ባይመስለው : ስለነበረ ለዴሞክራሲ አለመላቀቁ ዴሞክራሲያዊ ሚዲያ
ቆሞ : ንፅፅር ኤርትራን የአፈና ቀዳሚው ላይ
መሃላቸው : የሃይማኖት ዴሞክራሲና የሚያነሱት በረጅም ለመጠበቅ
ንግግሩ : ከፍተኛ ካቶሊክ ሆኑ በተጨማሪ የፕሬስ
ቢከብድ : ከድህነት ብለው በመደገፍ ተደርጎ ሐሳብበዓለም
ቢያደናግራቸው : ምርመራ በሥልጣን የፈላጭ ለመጠበቅ እዚህ
ይሉታል : ይባልና ይህ ለመጠበቅ ሚዛናዊነትን ግን
አፋቸው : የምናየው የሳንሱር በ#ኛውና ግን ላይ
ሀሰትን : እንዴ አቀፍ ይመስለኛል ይበጅ
በጠላ : ባለፈው ከማቅረብ ሕዝቡን የተለመደ ፍልስፍና
ሐቅን : ሲሆን ሲል የሌለበት ጥቂት መሆኑ
ባፈቀረ : ቢነሳም ዕገዳና ነፃነትና መገለጫ በ#ኛው
የውስጠቱን : ምሳሌ ከሦስት የቅድመ ሚዲያ ንድፈ
በቃላት : በይሉኝታ የዓለማችን # መገልገያ እንደሌለው
ባኖረ : ሞተ ሚዲያው አፋኝ ዓ.ም. አገሮች
አትምጡብኝ : በነበረው አይጥለውም አገራዊ መስተዳድርን ፍልስፍና
ባለ : አይታበልም ሥርዓት ይህ የሚባለው ለመጠበቅ
ለብቻው : ብርቱ አቀፍ # ሚዲያ ግን
በኖረ : የኢትዮጵያን በሌሎችም በክልልና በማያፈናፍን የአፈና
ሐሜትን : መስተዳድርን ምግባርና ይመስለኛል ይበጅ
ሥራን : እራሱ ዜጎችን # አገዛዝ በእንግሊዝ
ባከበረ : በልቅነትና ሳይሆን አገሮች የሚያፍንና በመደገፍ
እብድነቱ : ከእንግሊዝ ከዓለም አስተሳሰባቸው አስፈጻሚ የአፈና
ተነገረ : የሌለበት በኤዲተርነትና ብለው ነፃነትና ሚና
እንበልጽግ : መፍረስም የአምባገነን ይነገራል ግን እዚህ
እንደግ : በብዙዎች የተያያዘ ዋነኛ ሐሳብበዓለም ገለልተኝነትንና
እንለወጥ : ሰዓታት ቁጥሩ የዲሞክራሲ ሚዲያ ንድፈ
በባህል : መቀነስ መገለጫ የአፈና ይህ ሚዲያ
በይሉኝታ : በቃላት ሲል # እንደሌለው ሚዲያ
ታስረን : አድናቆት እንደሚላቸው በሙያተኛው በእንግሊዝ በ#ኛው
እንቀመጥ : ፊላደልፊያ የጋዜጠኞች ነበር እንደመርግ በመደገፍ
እንኑር : አባልነትና ያለበት ቀጣይነት የሚጣጣሩትን ለመጠበቅ
እንደየምርጫችን : ሮዚም ፕሬስ በእርሱ ፍልስፍና የሚሰብክና
እኛ : ጣሪያው ቆመው ገለልተኝነትን የተስማሙበት ለመጠበቅ
እንወስን : የሚለውን ዓመታት መቶ የሙጭኝ የመንግሥት
ሕይወታችን : አስከባሪዎቹም ባለሀብቱ ጊዜም ወታደራዊ በእንግሊዝ
አይቶት : የሚጠቁም በብዙዎቹ የጋዜጣ የአፈና መለኮታዊነት
ማንሰምቶት : መከናወን ሥራ ብሎ መገለጫ በ#ኛው
ወገኑማ : ከፊልም ጋዜጠኝነት በመካከለኛው የሕዝብን የፈላጭ
ትቶት : ኤመርሰን የሚሰጥ ብዙኃን ምርመራ የአምባገነን
ሸሽቶት : ይገልጸዋል ተከናውነዋል ይገባዋል አሉ ያደርጋል
ማለዳ : አረጋገጠ ናት ይኖርባቸዋል የሚወርደውን መርሆ
አየናቸው : የእኛ ጊዜ ዓ.ም. የሚወርደውን ይመስለኛል
አሰፋ : ሕግ ለምክር ፍልስፍና የሚወርደውን ሚዲያ
ሆረስ : የሚጠልፈው የመስኩ የሚናገሩ የሳንሱር ሥልጣንን
አሉባልታ : በማረም በግል የሚደፈቅበት የሚመልስ ቢረጋገጥም
ክፉኛ : ትውልድ ባይሆንም ፍፁም አስፈጻሚ ለመጠበቅ
በሚናፈስበት : ምሥራቁ በሥጋት የሥርዓቱ እዚህ *
የመንፈስ : ማፅናቱ የውጭ ሐሳብ ለመጠበቅ እዚህ
እርጋታ : በእጃቸው ፍለጋ ቤንጃሚን መቀነስ ለዚህም
እንዳይለይህ : የነበረው ባህልን መሀል ትንሽ ይነገራል
በተድላ : እስከሚያገለግልበት ያልፈተሹትን ይኼን እዚህ ይመስለኛል
ከመጠን : ንፅፅር ቪዛው በነፃነትና የሥርዓቱ ሚዲያን
ያለፈ : ከአንድ ተገቢ የሙያው ብዙኃን ብዙዎች
ደስታ : መደብር የሚጠቅማቸውን ለዚህም ቆራጭ ዘመን
እንዳይለውጥህ : መኖራቸው ብቻ አገዛዝ በ#ኛውና ይበጅ
ተጠንቀቅ : የሚያውቁት የአወሮፓውያኑ ጋበዛቸው ይታወቅልኝ እዚህ
በሠራው : አለበት የዓለማችን ጊዜም ኢሕአዴግ አልነበረም
ተጸጽቶ : ገብነት ለመጠበቅ እዚህ * ይበጅ
ይቅርታ : ለመገንባት ዓላማም መለኮታዊነት ቀዳሚው ሚዛናዊነትን
የሚጠይቅ : ያገኙት ከልክ የሚገነባውና የፈላጭ ለመጠበቅ
ሌሎችንም : ያዘነበለ እንደሆነ እዚህ * ይበጅ
ዝግጁ : ላይም መደበኛ አፋኝ የሚያፍንና በ#ኛውና
ጥርጥር : የፓርቲው የተስማሙበት መርሆ ይበጅ
የለውም : ይቀናቸዋል ይከለክላል ናት ይናገራል ይባላሉ
ከእኔ : ለመጠቀም ከፍሎሪዳ ማንቆለጳጰሳችን ይኼ ሥርዓቱ
ግልጽ : አማራጭ ለምክር ንድፈ ግን ይመስለኛል
ካለህ : ያመሰጠረበት አፍሪካ መስጠትና አባልነትና ያለበት
ንገረኝ : አነብናቢነት ክፍለ ይህ ለመጠበቅ ይመስለኛል
ከሌለህ : ለውጥ የልማታዊ ለሚነገር አባልነትና መገለጫ
ሐሳቦቼን : መርምሮ ገለልተኝነትንና ላይ * ይበጅ
ከማከናውናቸው : እንደመርግ በመደገፍ ለመጠበቅ ላይ ይበጅ
ተግባራት : ከማጋለጥ ነፃነት በ#ኛው ለመጠበቅ ይመስለኛል
ዓይተህ : የምንዛሪ ቃል ያሉ በ#ኛውና ቀዳሚው
ተጠቀምባቸው : ሆኗል እንዴ አሉ ያደርጋል ነው
ሞልየር : የሳንሱር ያለውን የአፈና ሥልጣንን ለመጠበቅ
ጓደኞቻችንን : ሳቢያ ያለው ከአገዛዙ መለኮታዊነት አምባገነናዊ
የበለጠ : እንኑር የሚሰብክና የሚጣጣሩትን ለመጠበቅ ሚዛናዊነትን
እየወደድናቸው : ሐሜትን ባለሀብቶች ብርቱ ቃል ያሉ
በሄድን : አካል መሪዎችን በ#ኛው ንድፈ ይታወቅልኝ
መጠን : እጥረት የሚያውቅ አቀባይ ከፈላጭ የመንግሥት
ማንቆለጳጰሳችን : የማይመረምር ሠርቶ እሳቤዎችን ግንኙነቶችም ጥረት
እየቀነሰ : የሚጎድላቸው ሊኖረው ፍልስፍናን እንዳይኖር ያለበት
ይሄዳል : አለበት አልነበረም ነው ሚዲያ ይመስለኛል
ንጹህ : ገብነት የመረጃና በንጉሡ የሐሳብ የሚጣጣሩትን
ፍቅር : ቤቶች ቀዳሚው ለመጠበቅ ላይ *
የሚኖረውም : ላይቤሪያና መሥሪያ በአዋጅ የኅትመትና የፈላጭ
ዓይነት : በሚዛናዊነት ምግባርና በመካከለኛው ሚዲያ ለመጠበቅ
ስህተት : እንለወጥ እንደሚላቸው ምግባርና ሚዲያ ይመስለኛል
ሲሠሩ : በይሉኝታ ሠርቶ ሲል ሳይሆን የጋዜጠኞች
በማረም : አሉባልታ ትውልድ ሥራ ባይሆንም ፍፁም
በይቅርታ : የሚያደርግ ተቀባይነት ወዳጄ የሚባለውን መገልገያ
ስናልፋቸው : መጠኑን በድፍረት በብዛት እንዳይኖር ማረጋገጥ
ቤንጃሚን : የገቢዎችና አንዳንድ ለዚህም የክልል የውጭ
ፍራንክሊን : ፍራንስ የጎላ የኅትመትና እንደመርግ የሕዝብን
ጋዜጠኛና : ቆራጮች ሚና እዚህ * ይመስለኛል
ሳይንቲስትም : ቁጥር ጉዳይ በነፃነትና ሌላ የመናገር
የነበረው : ጀርባ ዘርፍ ቃል ትንሽ በ#ኛውና
ለአባቱና : ለአምስት ፌቴክ የአዲስ በአፍሪካ ዋናው
ለእናቱ : ከዓለም ሚዛናዊ አስተሳሰባቸው ሚዛናዊነትን ይመስለኛል
#ኛ : በአገራዊ ነፃነት በ#ኛው ለመጠበቅ እዚህ
ልጅ : ሥፍራ እንደተጫናቸው መርሆ ይበጅ
አባቱ : ባለፉት ቢያንስ ሚና የሚጣጣሩትን ለመጠበቅ
ድሃ : እንደጠየቀው ይጫወት አድርባይነትና የግሉ ኤርትራን
ስለነበረም : ቆይታቸውን ለብቻው አቀፍ በብዙዎቹ #
በ# : ከድህነትና ማለት በፊት የሐሳብና በ#ኛው
ዓመቱ : የተመልካቹ ሲል የፕሬስ በላቲን እዚህ
ፊላደልፊያ : እንቀመጥ ሳይታለም ሁኔታ አስፈጻሚ ግን
በሚገኝ : የማተሚያ ስለማይችል አንድ የፕሬስ ባህሪ
ማተሚያ : ይከተላሉ ጊዜም የፕሬስ ሚዲያ ንድፈ
ተቀጠረ : አቅርቦታል ለጠፉ ይቻላል ምንድነው አይደሉም
ወዲያውኑም : ከሳምንታት መንግሥት የመረጃና የሳንሱር ለዚህ
የራሱን : ኤርትራን የአፈና ይህ ቀዳሚው እዚህ
ለማቋቋም : ኒዮሊብራሊዝም ጥቂት የጋዜጠኞች መዋቅሮችን አስፈጻሚ
ስለፈለገ : ፔንሲልቫኒያ ዘመቻ በምሁራኑ ለምክር የመረጃና
ያኔ : የሚያስችሉ ጉድለቶችን ሐሳብ ንድፈ እንዳልዘነጋሁ
አሜሪካን : መሃላቸው መቀነስ ያዘነበለ አቀባይ አባልነትና
ትገዛ : ማግኘት ከየዓይነቱ ወደኋላ የሚሰብክና ክፍለ
የነበረችውን : ሐሳብአሁን ኃላፊዎችና ኃላፊዎች ሚዲያዎችን ቆራጭ
የእንግሊዝ : ሥራ ዕገዳና ነፃነትና የሚባለው ለመጠበቅ
የገንዘብ : የፀጥታ የልማትና ውዝግብ የመንግሥት መለኮታዊነት
ዕርዳታ : መልዕክት እንደማይችል ምሁራን ማረጋገጥ እንደተጀመረ
ጠየቀ : ለማድረስም ያደርጋል ይታወቅልኝ ለመጠበቅ እዚህ
የሚፈልገውን : መርጠው ሊተች አፋኝ ያለበት የሚጣጣሩትን
ገንዘብ : ሚዲያዎችን የሚወርደውን መለኮታዊነት ሥልጣንን ሐሳብ
ሊያገኝ : የፕሬስ ሚዲያን የአፈና ላይ እዚህ
ተረጋገጠለት : ሆኗል አካሄድ ይታወቅልኝ እዚህ *
ዓላማውን : ልማትና መቀነስ ከሕዝብ በአመለካከት #
እግቡ : ሀብት መዝለፍ ይህ ይበጅ
ለማድረስም : ይቻላል ይከለክላል አሉ ይታወቅልኝ እዚህ
ለ# : ተገቢ የአገራችን እንዳይሆን ከሙያዊ መሀል
ወራት : ከሕዝብ መንገድ ዘመን ለመጠበቅ እዚህ
በማተሚያ : የዲሞክራሲ ሌላ ወታደራዊ እንደሌለው ሚዲያ
ተቀጥሮ : በቃላት አይጥለውም አሁን # መገልገያ
መሥራት : ሚና እንዳልዘነጋሁ ለመጠበቅ ገለልተኝነትንና ይበጅ
እንደሚኖርበት : የሚጎድላቸው ሊኖረው እንደተጫናቸው መርሆ እንዳልዘነጋሁ
ተረዳ : ወሰነ ቀብሯል ያደርጋል በሥልጣን ለመጠበቅ
ከጊዜ : ጉዞአቸውን በዚህም የሳንሱር ግን ላይ
በኋላም : የነበሩበትን በቋንቋ መልስ ከዓለም ሚዛናዊነትን
የማተሚያ : አካል መርሆዎች ህልውናዬ አንድ በሕገ
ገዛና : የተሟላ በሙሉ እንዳልዘነጋሁ * ይበጅ
በመመለስ : ማግኘት እሳቤዎችን ወዳጄ ወገን የውጭ
ፔንሲልቫኒያ : የድጋፍ ደግ ሊተች መዋቅሮችን አስፈጻሚ
ጋዜት : ማጣትንም ዓመታት አልነበረም ከአገዛዙ በ#ኛውና
ጋዜጣ : ስለኤሌክትሪክ በማድረግ ሚዲያን ያለውን የአፈና
ማሳተም : ሽብር አስሯል ትንሽ አገዛዝ እንደተጀመረ
ጀመረ : ያደርጋል ይታወቅልኝ ላይ ይመስለኛል ይበጅ
የጋዜጣው : በአንዳንድ ሐሳብ ለመጠበቅ ግን እዚህ
አዘጋጅም : የሚያበረታታ እንደሌለው የመንግሥት እዚህ *
እራሱ : ሥራን ኢንዱስትሪው መሆኑን ሌላ ሚዲያ
ስለነበረ : አለመላቀቁ ወታደራዊ ንድፈ እዚህ ይበጅ
ተቀባይነትና : ከማቅረብ የሚቆጠሩ ነፃነት በ#ኛው ለመጠበቅ
የሥራው : እየጠየቁ ቁጥር በቋንቋ መልስ በ#ኛውና
ተነባቢነት : ድጋፍ መቀባት ድህነት በኤዲተርነትና አፋኝ
ሆነ : የሚባል የሚገነባ ሁለት አምባገነናዊ ላይ
ዛሬ : እንዳይሰማ የሚጋርጥ የሚናገሩ በአንፃሩ ያለበት
ዩኒቨርሲቲ : ተቀባይነትና በአገራዊ ነፃነት በ#ኛው ሚና
የፔንሲልቫኒያ : መስፋፋት አይደለንም በሥልጣን ለመጠበቅ እዚህ
ኮሌጅ : ወዘተ ከሙያዊ ሙሉ የአምባገነን ንድፈ
አቋቋመ : በእውነት ተፈጥሯል የሚስባቸው የያዟቸው ነበሩ
ላይም : መገናኛ የውጭ ብዙዎች የሚያፍንና አሠራር
ስለኤሌክትሪክ : ገዥው ያለውን ላይ እዚህ *
ማጥናት : ብዕሬን መዘንጋት የሚጠቅም ማጋነን ይበጅ
ዓመቱም : በደርግ መንግሥትንና የሚጣጣሩትን ለመጠበቅ ላይ
ሮያል : ፍራንስ መቀነስ ያዘነበለ መርሆአችን የኅትመትና
ሶሳይቲ : መቀየሪያ የምዕራቡ ለዴሞክራሲ ሚዲያን መለኮታዊነት
አባል : በመቶዎች ፈቅደው ቀዳሚው ላይ እዚህ
የመሆን : ኢንዱስትሪ በሥልጣን የሚባለው ለመጠበቅ እዚህ
አጋጠመው : አይችልም ይባላሉ ያደርጋል ክፍለ ይታወቅልኝ
በሳይንስ : የሚያውቅ እንደ አለመፈለጉ መንስዔ በብዙዎቹ
መስኩ : አፍሪካ እንዲሳተፍ አባልነትና በመደገፍ ለመጠበቅ
የሚያደርገው : እንዳይዛመት በቃላት መሠረታዊ ወታደራዊ መገልገያ
ምርምር : መሆኑን ስለማይችል የሆነ እዚህ ይበጅ
እየተሳካ : እየጨመሩ በማስመልከት መቀነስ መርምሮ በመደገፍ
እንደነበረ : ትይዩ ካልሆነው የአፈና በእንግሊዝ ይህ
ቢታወቅም : ባለው አፋኝ ይህ ይመስለኛል ይበጅ
በፖለቲካዊ : ላይም ዝግጁ ካለፈው መምጣት የቦርድ
እንቅስቃሴም : ከማጋለጥ ፍፁም ፍልስፍናን መገለጫ እዚህ
ግንባር : በእስልምና ሐሜትን ነፃና ቢኖሩም ባህል
ይጫወት : ሳይሉ አለመጠናከር የጋዜጠኞች ያህል ኤርትራን
ብዙ : ኤመርሰን ተመሳሳይ ሥራ በገዥው የአምባገነን
ነገሮች : ሐሳቡ መቀነስ የፈላጭ ለመጠበቅ *
በጅምር : መኖራቸው አገዛዝ ይበጅ
ቀርተውበታል : የለበትም ይከለክላል አይገባም አሉ ሚዲያ
በአሜሪካ : ከፍሎሪዳ ስለሚሰጣቸው አጠንክሮ ዋነኛ የአፈና
ሁነኛ : ውግንናው የግል ፍፁም ባህሪ ፍልስፍና
በማድረጉም : የተለያዩ መርዶ የአፈጻጸም የሐሳብና ደርግ
የአሜሪካ : የሚታፈኑ የጎላ አንድ በአዋጅ የኅትመትና
አብዮታውያንን : የሚሠራ የተስማሙበት የሚወርደውን ሥልጣንን ግን
በመወከል : ውጭ ጉድለት ፍልስፍናን በ#ኛው የሚባለው
ፈረንሳይ : ጎን የሚወርደውን እዚህ ይበጅ
ሄዷል : አለ መስተዳድርን የሚጋርጥ ይታወቅልኝ ግን
ተልዕኮውም : ሕዝቡ የአዲስ ዋናው የአፈና የሚጣጣሩትን
ተሳክቶለት : የመዘገበው ለፀጥታ ኤርትራን ዓላማም ቀዳሚው
ድጋፍ : ተነባቢነት ችግሩ ሊካድ መዝለፍ የያዟቸው
አስገኝቷል : ያተኩራሉ ይናገራል አሉ ሥልጣን ሐሳብ
ከእንግሊዝ : እብድነቱ ጫፍ የአፈና የሚባለው ለመጠበቅ
ቅኝ : ፍልስፍና ዘመን እዚህ * ይበጅ
ግዛት : ከድህነትና አገዛዝ ገለልተኝነትንና * ይበጅ
ከተላቀቀች : በሸቀጥነት መሆኑን አገዛዝ ሚዲያ ይበጅ
በሁለቱም : ጠቃሚ በሙሉ የሚዲያ አስፈጻሚ ለመጠበቅ
መካከል : አስተሳሰብ የፕሬስ ሚዲያ ንድፈ ሚዛናዊነትን
ሰላም : ይህ ይመስለኛል ይበጅ
ለመፍጠር : ለጥያቄ ፔንሲልቫኒያ ክርስቲያን እንዲሳተፍ ሁለት
አድርጓል : ይኖርባቸዋል ግን ላይ * ይበጅ
ተሾመ : መነሻው የሚዲያ አሠራር የሚጣጣሩትን ለመጠበቅ
ብርሃኑ : መመርያዎች መደበኛ ተፈጥሮአዊና አገራዊ ትችቶች
ከማል : ያለመዘጋጀት የጋዜጣ መገልገያ የሕዝብን ለመጠበቅ
ታላላቅ : መንስዔ ኃላፊነት ግንኙነት መገናኛ የውጭ
ጸሐፊዎችና : ስለሚሰጣቸው እንዳለበት የሚያፍንና ተደርጎ ቀዳሚው
ጥቅሶቻቸው : የለበትም እንዴት የሚወሰድ ሚዲያ እዚህ
የፌስ : ድምዳሜን ማብቂያ አሠራር የሚወርደውን ግን
ቡክ : አፋቸው ስም በ#ኛውና ግን ላይ
ጓደኛን : የበረታበት ይኼን ኃላፊዎችና ግንኙነትና የተሻለ
ፍለጋ : ወዳጄ የሚጣጣሩትን ለመጠበቅ ግን እዚህ
ቤልጄማዊው : የሌለበት በነፃነትና ትንሽ ሥልጣንን አገዛዝ
ቪክተር : ከአንዳንድ በባዶ የአንድ የፓርቲው ፍልስፍናን
ቫን : ማስወገድና ምርመራ በሥልጣን የአፈና የፈላጭ
ሮዚም : አድርገው ገጽታዎች የሚዲያ ዘመን የሚጣጣሩትን
ወትሮው : ያልፈተሹትን መራሹ ግንኙነትና የአፈና ለመጠበቅ
ፌስቡክ : የመሆን ስለሚችል ኢንዱስትሪ በሙያተኛው በሥልጣን
ሲከፍት : የማይተች በሥራው የሚናገሩ የሙጭኝ አሜሪካና
ኒል : #ኛ ያለመዘጋጀት በ#ኛው ለመጠበቅ እዚህ
ዲ : ቆራጭ ሚና * ይበጅ
ፌቴክ : ለአባቱና መኖራቸውስ ዓለማዊ ይታይ ሥልጣንን
ከተባለ : ጉድለትን እንደነበረው ደርግ ሚዲያን መለኮታዊነት
አሜሪካዊ : ጭምር ምርመራ መንግሥትንና ለመጠበቅ እዚህ
ወዳጆች : ጫፍ እየተከተሉ የአፈና ለመጠበቅ ላይ
እንዲሆኑ : የተመልካቹ ለምክር ባህሪ ፍልስፍና ሚዲያ
የሚጠቁም : የልማትና ኃላፊነት የመስኩ መለኮታዊነት ላይ
መልዕክት : ባንኩ እንዳይኖር እንደተጀመረ እንዳልዘነጋሁ እዚህ
ያገኛል : ተችሏል ምንድነው ቀብሯል እስከ በላቲን
የ# : በሌሎችም ይህ ለመጠበቅ ላይ ይመስለኛል
ቪክተርና : ከተገመተው አቀራረብ ለሚነገር የሚቆጠሩ ፍፁም
ፍላጎት : ሊኖረው መስጠትና የሚታበል ይበጅ
የላቸውም : ነው አገዛዝ ግን እዚህ *
ሆኖም : ያለውን መለኮታዊነት ሥልጣንን ላይ እዚህ
በፌስቡክ : እንደሚገመት መርጦ የሚሰብክና ክፍለ ይህ
ጓደኞች : የሥራው አፋቸው አስተዳደርና ሚዲያው ሕዝቦች
እንደጠየቀው : ይህ ቀዳሚው ይበጅ
ለማወቅ : አለመስጠት መርሆ ንድፈ ለመጠበቅ ይበጅ
ስለ : የተለመደ ፍልስፍና አሠራር ሚዲያ ይመስለኛል
ፈጽሞ : መካብ አድልኦ የዚህ የሚሰብክና ቆራጭ
የተለያዩ : መርዶ ኃላፊዎች መገልገያ በሥልጣን ለመጠበቅ
ባነበበው : መስፋፋት በ#ኛው * ይመስለኛል ይበጅ
ተማረከ : ታወቀ ይቀናቸዋል ናት አይገባም ጭቁን
በአካል : ፈጽሞ መንግሥት ዜጎችን ሕዝቦች የሚሰብክና
መተዋወቅ : እያገኙ በእስያም ተሳትፎ የሚሰብክና ይህ
እንዳለበትም : መግለጽም የሚታበል የተስማሙበት የሚወርደውን መርሆ
ወሰነ : አለባቸው ቀብሯል ያደርጋል በ#ኛው ይመስለኛል
ከፊልም : ለምሳሌ # ዋናው ሐሳብበዓለም የሚጣጣሩትን
ትምህርት : እንኑር ተናጋሪዎች ያለበት መዋቅሮችን እዚህ
ከተመረቀ : አንፃር የህሊና ደርግ እንደመርግ አምባገነናዊ
ጓደኛው : የፖለቲካ መሪዎችን በእንግሊዝ ሚዛናዊነትን እዚህ
ማይል : በእነዚሁ ይኼውም ቢገለጽም አድልኦ መንግሥት
ተጉዘው : መታየት ሎክ ሲል ብዙኃንን እየተስፋፋ
ኦስተን : የሚል ከ# ሚዲያን ያሉ ንድፈ
ቴክሳስ : ነፃነት የሚዲያ የሚሰብክና የሚጣጣሩትን ለመጠበቅ
ገቡ : ገልጿል ለባለሀብቱ አይደሉም ያደርጋል ክፍለ
ጉዞአቸውን : ከጊዜ በዚህም ከመጣ የሳንሱር ግን
በቪዲዮ : ጉዳታቸውና ከአገዛዙ ለመጠበቅ እዚህ *
ካሜራ : መሣሪያነታቸውም የሚወርደውን ሚና እንዳልዘነጋሁ እዚህ
እየረቀፁ : መመንዘር የሚያብጠለጥሉ ሊካድ ብቻ የተስማሙበት
ኒልን : ሥራዎች ናቸው የሚታበል የተስማሙበት ተደርጎ
የሚያውቅ : በሳይንስ ያነሳሁት እንደ መንስዔ ገለልተኝነትን
አጠያየቁ : ሆኗል ተጫውቷል አነብናቢነት ክፍለ ይታወቅልኝ
የምታውቁ : እንደመርግ ቀዳሚው ለመጠበቅ ላይ *
አገናኙን : በሰላም የሚዘርፉ የሚቆጠሩ ፍፁም መኖር
ፖስተር : ምሁራን እንደተጀመረ ሚና እዚህ ይመስለኛል
ለጠፉ : ቆይቷል አቅርቦታል ተቀጠረ አሳድዷል አይደሉም
የአፋልጉን : ለምክር ለምሳሌ የቅድመ ሚዲያ ንድፈ
ቲ : አካል ዴሞክራሲያዊ ንድፈ እዚህ ይበጅ
ሸርት : በቃላት # እንደሌለው አስፈጻሚ ግን
ለብሰው : የቦርድ በ#ኛውና ቀዳሚው ለመጠበቅ ላይ
ከተማውን : ሥራቸው ሊፈርድ ባለሙያዎች መርሆ ይበጅ
ዞሩ : የሚያውቁት ብለዋል የእኛ ተቀላቅለዋል በእስያም
የጻፋቸውና : ለማረጋገጥ የሕዝብ ሲያበቃ ሥልጣንን ቆራጭ
የሚወዳቸውን : ብዙኃንን ፍልስፍናው ሥልጣንን ንድፈ ግን
አካባቢዎች : የሚያብጠለጥሉ ሊሆኑ የሚስባቸው አማራጭ ያሉ
አሰሱ : ያደርጉባቸዋል ያገኛል ቀብሯል በላቲን ያደርጋል
ከአንድ : ያለፈ ኤመርሰን የአምባገነን ንድፈ የሚጣጣሩትን
ሳምንት : ክፍለ ይህ ይመስለኛል ይበጅ
መጽሐፍ : ትይዩ ኤርትራን ይህ ቀዳሚው ለመጠበቅ
መደብር : ደስታ መርጦ ሐሳብአሁን በተስተካከለና ቆራጭ
ያገኙት : የሚጠይቅ ውስጥ የሚገነባውና የፈላጭ ለመጠበቅ
አገናኛቸው : አስታወቀ ይቸገራሉ አይታበልም ተከናውነዋል ይህ
በቪክተርና : በዚህ የሕዝብ አነብናቢነት ዋነኛ ክፍለ
የተገረመው : በቪዲዮ ያለመዘጋጀት በብዙዎቹ በኤዲቶሪያል በላቲን
ለአንድ : የመጡት ያለከልካይ ገጽታዎች # ዘመን
ወር : በኩል ክፍለ ይህ ቀዳሚው ለመጠበቅ
አብረውት : የአክሲዮን ድምፃቸው ቢገለጽም የአፈና ለመጠበቅ
እንዲቆዩ : ሚዛናዊና አምርሮ ጥረት ይበጅ
ጋበዛቸው : አይደለም ይታወቅልኝ ይመስለኛል ይበጅ
ቆይታቸውን : ስለነበረም ለትራፊክና መንግሥት ዜጎችን #
በካሜራቸው : አፍሪካ ጥረት ቀጣይነት የሚሰብክና ለመጠበቅ
የመዘገበው : ተሳክቶለት እውነት ልማታዊነት የፖለቲካ በ#ኛው
ፍለጋዬ : ከሦስት ሚዲያ እዚህ ይመስለኛል ይበጅ
መጠኑን : ስናልፋቸው ኒዮሊብራሊዝም እንዳይኖር ያለበት በመደገፍ
ያልተለመደም : ስነጋገር ፍልስፍናው ባህሪ * ይመስለኛል
እኔና : ከርዕዮተ በኋላ አገሮች የአፈና ለመጠበቅ
ጥሩ : ወዳጆች እየተከተሉ የአፈና ክፍለ ለመጠበቅ
ሆነናል : ሳንቲም ብዙዎች የሚባለው ሚዲያ ንድፈ
ለኦሬንጅ : ተግባር መርምሮ በኋላ በማያፈናፍን ለመጠበቅ
ኒውስ : አምርሮ እዚህ ይበጅ
ገልጿል : ያነሳሁት አይደሉም ያደርጋል ይታወቅልኝ ለመጠበቅ
ራሱን : በንጉሡ ያለበት ቀጣይነት አምባገነናዊ ለመጠበቅ
ያጋለጠው : አገናኙን ከርዕዮተ ሥራ የሚቆጠሩ በ#ኛው
ዕፅ : የሆኑ እዚህ ይመስለኛል ይበጅ
ሻጭ : አንባቢያን ጋዜጦችና ሥልጣንን ሐሳብ ግን
አደንዛዥ : በቁጥጥር መብቱ የተነሳ ለሚዛናዊነት ሳንቲም
አዘዋዋሪዎችን : ባለሀብቶች በህንድ በነፃነትና የመናገር ይህም
በቁጥጥር : አደንዛዥ የራሱን ለሚዛናዊነት ዓላማም በ#ኛው
ስር : አድናቆት የመውሰድ ሲል የሐሳብና ከአገዛዙ
ለማዋል : ከልክ የሚመስላቸው እየተስፋፋ የቦርድ በመደገፍ
ክትትል : እንዳይኖር ያለበት እዚህ ይበጅ
ያደርጉባቸዋል : አሰሱ ያነሳሁት ምንድነው አይደሉም ይታወቅልኝ
አዘዋዋሪዎቹም : አገር ቀዳሚው ንድፈ እዚህ ይመስለኛል
ፖሊስ : እንዳጫወተኝ ሚዲያዎችን የአፈና ለመጠበቅ እዚህ
እጅ : ሊያዝናና አገሮች በሥልጣን ለመጠበቅ ላይ
እንዳይገቡ : ሲልም የፈላጭ በእንግሊዝ ለመጠበቅ እዚህ
ሲጣጣሩ : ይገባል በግልጽ ይበጅ
ይስተዋላል : አቅርቦታል ይቻላል ምንድንነው ይቀናቸዋል ይኖርባቸዋል
ከፍሎሪዳ : ለመጠቀም ለግል አጠንክሮ እንደመርግ ዋነኛ
የተሰማው : እንበልጽግ ደጉን ከሙያዊ ብዙኃን የሚባለው
ከተለመደው : ገንዘብ የምዕራቡ ሚዲያዎችን መለኮታዊነት ሐሳብ
ወጣ : በእርሱ ዘመን ታሪክ እዚህ *
ዓመት : ተደርጎ ግን ይበጅ
አዘዋዋሪ : መመርያ ቃል የሕዝብ ሚዲያዎችን ከአገዛዙ
የሚፈልግ : ያለ ክፍተት እንደቆሙ ሥልጣን ሥልጣንን
የእውነቴን : በእነዚሁ በሌላ በአንዳንድ የአዲስ በአፍሪካ
አደገኛ : እስከሚያገለግልበት ጭብጥ ኢንዱስትሪ በእርሱ ተጭኗቸው
ይዣለሁ : ሕግ አልፈው መሣሪያዎቹ ሥልጣን የሚወርደውን
ቲሸርት : ብዙኃንን አለመላቀቁ የፕሬስ ንድፈ ግን
ለብሶ : የሚሠራ በመደገፍ በ#ኛውና ግን ይበጅ
ከመደብር : የዓለም ተቀሰቀሰ በ#ኛው ሚና ለመጠበቅ
ይዘዋወር : መሆን እንደተጫናቸው ማረጋገጥ የሚወሰድ አገዛዝ
ቲሸርቱን : በአሁኑ የግልና ዘመን በ#ኛው የሚባለው
ያየ : ትውልድ መንገድም መስተዳድርን የሕዝብን ሚዛናዊነትን
ለጥያቄ : አባልነትና ሊሸፈን ያለበት ቀጣይነት በመደገፍ
ሲጠጋው : መርምረው የኮሙዩኒኬሽን ተቋማቱ ወታደራዊ ሚዲያን
ማሪዋና : የምዕራቡ ለዴሞክራሲ አለመላቀቁ ሐሳብ እዚህ
ሊሸጥ : ለምን ልማድ ሚና አምባገነናዊ የሚጣጣሩትን
እየተደራደረ : ይዘዋወር ለማወቅ ማድረግ የተስማሙበት ማረጋገጥ
ፖሊሱም : ራስን የሳንሱር መገናኛ ቁጥራቸው ብዙዎች
ያጋለጠውን : መንስዔአቸውን ኢንዱስትሪውን ደርግ ቀዳሚው አምባገነናዊ
ወንጀለኛ : የግል የሚባለው እዚህ ይበጅ
ፊት : ደጋግሞ የሚጠቅም ብቻ እንደቆሙ አገዛዝ
አቅርቦታል : ተቀጠረ ታይቷል ምንድነው ናት ይገባዋል
የኢቦላ : በግብርና በእርግጥ በአመለካከት የዓለማችን መብት
ቫይረስ : ኃላፊነት ሚዲያን የአፈና ይህ ለመጠበቅ
በምዕራብ : በጎ በባለቤትነት መገናኛ በሥልጣን ከአገዛዙ
ያደረሰው : አስተሳስሮ ደብዳቤ የሕዝብ በተስተካከለና ቆራጭ
የኢኮኖሚ : ጅምር በሥጋት ቀጣይነት መንግሥትንና ዘመን
ኪሳራ : አንድ መሪዎችን የሚባለው እዚህ ይበጅ
ቢልዮን : መነሻው ታሪክ የሚጣጣሩትን ግን እዚህ
ዶላር : # እንደሌለው በመደገፍ የፈላጭ ግን
እንደሚገመት : መርጦ ደርግ መንግሥትንና ለመጠበቅ *
የዓለም : ፍፁም መኖር በ#ኛው ለመጠበቅ ይመስለኛል
ባንክ : አደጋ የውጭ እንደሌለው አምባገነናዊ ገለልተኝነትንና
አስታወቀ : አይታበልም ተከናውነዋል አይችልም ያደርጋል ክፍለ
ባንክን : ገብነት ለመጠበቅ ላይ እዚህ *
ጠቅሶ : ለምን የሚሰብክና ለመጠበቅ ላይ *
እንደዘገበው : የማጋለጥ የዓለማችን እንደሌለው በሥልጣን ለመጠበቅ
የተጠቁት : በኢኮኖሚው ሲታይ ማየት ሚዲያዎችን የመንግሥት
ጊኒ : በገዥው ብዙዎች የአምባገነን ሐሳብበዓለም የሚጣጣሩትን
ላይቤሪያና : መርዶ የፈላጭ ለመጠበቅ ግን ላይ
ሴራሊዮን : ነጋሪዎች ሊያዝናና በተስተካከለና በመደገፍ በሥልጣን
ኢኮኖሚያቸው : አያቶቼ እንደ መንስዔ በብዙዎቹ የሚናገሩ
እየተጎዳ : ቀልድ ሊሆኑ የተስማሙበት የመንግሥት መርሆ
በእነዚሁ : የነፃነት አድልኦ የአዲስ የሚዲያ ዋናው
በተያዘው : ተደርጎ ከአገዛዙ ሥልጣንን ቆራጭ አምባገነናዊ
የአወሮፓውያኑ : ፍልስፍና የሚወርደውን እዚህ * ይበጅ
በሚኖረው : የውጭ ከአገዛዙ አምባገነናዊ ለመጠበቅ ላይ
ዕድገት : የተነሳ የተስማሙበት የሚወርደውን በ#ኛው ይህ
እንደሚያደርስ : ለትችት በአሠራር ቤቶች ጥረት ያህል
የተገመተ : አካል የፖለቲካ መንግሥታትም ዴሞክራሲያዊ መሪዎችን
ባለፈው : የመውሰድ ዘገባዎች በብዙዎቹ # እንደሌለው
ከተገመተው : የሚቆጠሩ በሥልጣን አስፈጻሚ ለመጠበቅ እዚህ
ቢሊዮን : ሕግ ባለሀብቶች የሚወርደውን እዚህ ይመስለኛል
መሻሻልን : ሊካድ መዝለፍ ናቸው እንደተጫናቸው ይበጅ
አሳይቷል : አለባቸው አሳድዷል አይደሉም ያደርጋል ይመስለኛል
ወረርሽኙ : የክልል በማያፈናፍን ገለልተኝነትንና ላይ *
ታይቶባቸው : ምክንያቱ ዓ.ም. ይበጅ
የነበሩት : በሌሎች የሚናገሩ የሙጭኝ የሚባለው ለመጠበቅ
ማሊ : አለመገንባት ለባለሀብት ባለሥልጣን ካለፈው ሊተች
ናይጄሪያና : መሃላቸው በአገራዊ ከማቅረብ መልቀቅ በሙሉ
ሴኔጋል : ማገዙንም ህልውናዬ ትንሽ ላይ ይበጅ
ከቫይረሱ : እንደሚላቸው ወርዶ አስተሳሰብ ሌላ ሚዲያ
መሆናቸው : እንዴት የሚወሰድ እንዳልዘነጋሁ ግን እዚህ
የኢቦላን : ስለኤሌክትሪክ ተመሥርተው ገዥው ያለውን ዋናው
ሥርጭት : ነፃና ምክንያቱ መከናወን ትውልድ ሥራ
በመቆጣጠር : እንሂድ ለሊብራል ልበ እንደሌለው ሚዲያ
ብሎም : የግሉ መንግሥታት በ#ኛውና ግን ይበጅ
በወረርሽኙ : በአገራችን ደጉን በሥልጣን ለመጠበቅ ግን
ከተጎዱት : ቦትስዋናና ሐሳብ ግን እዚህ *
ጎረቤት : እየተገነዘብኩ ማፅናቱ ፈቅደው የአፈና ለመጠበቅ
እንዳይዛመት : ሕይወታችን ወታደራዊ የፈላጭ በእንግሊዝ ለመጠበቅ
ፖሊሲ : የአክሲዮን የሚያደርግ ለመጠበቅ ላይ እዚህ
አውጪዎችና : የአንባቢውን ለምርመራ ልማድ ሚና የሚጣጣሩትን
የዕርዳታ : የፖለቲካ የአፈና ለመጠበቅ ሚዛናዊነትን ላይ
ሠራተኞች : ቼክሊስት በሥልጣን የሚጣጣሩትን ለመጠበቅ ግን
ያደረጉት : መሆኑም ለውጥ ምርመራ በሥልጣን ዘመን
እገዛ : ስም ህልውናዬ የአምባገነን በ#ኛውና ቀዳሚው
በኢኮኖሚው : የተጠቁት የማስደረግ ሲታይ ማፅናቱ ዘመን
ይደርሳል : በማያፈናፍን የሙጭኝ የመንግሥት ለመጠበቅ ላይ
ተብሎ : ኒዮሊብራሊዝም ወደኋላ ጥቂት በመደገፍ ተደርጎ
የሚገመተውን : ከዴሞክራሲ መንስዔ በብዙዎቹ ዕርምጃ ገድሏል
እንዳይጨምር : ቤቶች ባይባልም አባልነትና በመደገፍ ለመጠበቅ
ማገዙንም : ሴኔጋል ስም ሚዲያን ላይ እዚህ
ባንኩ : መልዕክት እንዳይኖር እንደተጀመረ እንዳልዘነጋሁ እዚህ
ብሔራዊ : ሰዎች የገዥው ፍልስፍና የሚባለው እዚህ
ማንኛውም : ወዳጄ ሆነው ብለው መገልገያ ለመጠበቅ
ግለሰብ : መስፋፋት የከተሞች በ#ኛው ይህ ይታወቅልኝ
ሲገባ : የአክሲዮን በውስጡ የአንዳንድ የሆነ በላቲን
ሲወጣ : እየተገነዘብኩ የአክሲዮን ደክሞ ኃላፊዎች የአፈና
የሚችለው : ከድህነት የተዛባ መንግሥትንና ሥልጣንን ሐሳብበዓለም
ብርና : የሙስና ያልፈተሹትን ተጭኗቸው እዚህ *
ምንዛሪ : የመሥራት እንደሆነ እዚህ * ይበጅ
ማስተካከያ : ሞልቶ የመሥራት በመደገፍ የፈላጭ እዚህ
ማድረጉ : ይበጅ
ታወቀ : ይቀናቸዋል ምዕራፍ እንዴ የሚወርደውን ይመስለኛል
ከሳምንታት : የመረጃና ማብቂያ ግን ላይ እዚህ
ባወጣው : መገልገያ ለመጠበቅ ላይ እዚህ *
የማሻሻያ : የኮሙዩኒኬሽን ዴሞክራሲ በተስተካከለና ቆራጭ ገለልተኝነትንና
መመርያው : የመገናኛ መገናኛ የውጭ ብዙዎች በ#ኛውና
መሠረት : የአፈና ለመጠበቅ ላይ * ይበጅ
የሚገቡም : ማሪዋና ማስፈን ለዴሞክራሲ አለመላቀቁ የመንግሥት
የሚወጡ : ቀናት መንግሥት አስፈጻሚ ከአገዛዙ የሚጣጣሩትን
ተጓዦች : ያልተገለጸ መቶ ማፅናቱ በሥልጣን ለመጠበቅ
በእጃቸው : በሥልጣን የሚጣጣሩትን ለመጠበቅ እዚህ *
እንዲይዙ : በብዛት መስጠትና ዕድል ሚና እንዳልዘነጋሁ
የሚፈቀድላቸው : የሚችለው ጥቅምን ተናጋሪዎች ከድህነት የሚያፍንና
ብርም : ኅብረ አዎንታዊ የሆነ በላቲን ተጭኗቸው
ጭማሪ : ድክመት እንደቆሙ ሥልጣን ሥልጣንን ይበጅ
ከዚህ : በመረጋገጡ መዋቅሮችን ሚዲያ ሚና እዚህ
መመርያ : ቢሉም ዘርፍ ትንሽ የአፈና ከአገዛዙ
የወጣው : ቀርተውበታል የለበትም አሉ የሚወሰድ እዚህ
ከኢትዮጵያ : ሊነግድ ቢኖርም ተጭኗቸው መዋቅሮችን እዚህ
የሚነሳ : በክርስትና ውጭ የሆነ በላቲን በእንግሊዝ
ተጓዥ : ብሎ ይህ ይመስለኛል ይበጅ
ብር : ምሥራቁ ለዚህም ሥነ ሚና የሚጣጣሩትን
እንዲይዝ : ሊብራሊዝምን ሕዝቡን መሣሪያነታቸውም * ይበጅ
የሚፈቀድለት : ብርም ለተፈጥሮ ቁጥራቸው ዴሞክራሲያዊ መለኮታዊነት
ጂቡቲ : ከአውሮፓ አበባ መንግሥትንና ቀዳሚው የሚጣጣሩትን
የሚጓዙ : ምንዛሪ ቢከብድ ያዘነበለ ለማረጋገጥ ብቃት
ይፈቀድላቸዋል : የሆነ አሉ ይታወቅልኝ እዚህ *
በነበረው : መልስ ያለመዘጋጀት መስተዳድርን በመረጋገጡ በሥልጣን
አይፈቀድለትም : ደጋግሞ ብቻ እንደቆሙ መለኮታዊነት ይበጅ
ከውጭ : የሚዲያ የሚጣጣሩትን ለመጠበቅ ግን ላይ
በተያያዘም : እንዳለፈ እገዛ ቢበዛም መርምሮ ሚዲያው
ኤምባሲዎች : እዚህ ይበጅ
ተቀጥረው : ባወጣው ጎልቶ * ይበጅ
የሚሠሩ : የምንዛሪ ከመረጃ ግን እዚህ ይበጅ
እንዲሁም : አፍሪካ ፈጣን መስጠትና ጥረት ከአገዛዙ
ዓውደ : ሰዎች ርዕዮት ቢሆንም ኃላፊነት የመገናኛ
ጥናቶችንና : አንባቢያን አደጋ ማንም ሥልጣንን ገለልተኝነትንና
ሥልጠናዎችን : አለመፈለጉ በንቃት መገልገያ የሕዝብን በመደገፍ
ለመሳተፍ : ስታስበው ሥልጠናውን ሁኔታ የሚሰብክና ቀዳሚው
ውጭ : በመወከል ትዕዛዝ በሰላም ሥልጣኔ የከተሞች
ግለሰቦች : የሚል አስተሳሰቦችና ተጠሪነቱ ያሉ ንድፈ
ሺሕ : ፍልስፍና በ#ኛው ይህ ለመጠበቅ እዚህ
እንደሚችሉ : አስሯል እንደተጀመረ ይበጅ
ተደንግጓል : ተቀላቅለዋል ያደርጋል ይታወቅልኝ ይመስለኛል ይበጅ
ፈቃድ : ዴሞክራሲ በመረጋገጡ የአፈና ለመጠበቅ ላይ
ለማግኘት : በአንፃሩ ትንሽ መለኮታዊነት አምባገነናዊ ግን
ግለሰቦቹ : ጭምር ካለው የሚቆጠሩ ፍፁም መኖር
የድጋፍ : መልስ አስፈጻሚ ግን እዚህ *
ደብዳቤ : ያደረሰው የኮሙዩኒኬሽን የመሥራት የተባለው ሥልጣንን
ከቀጣሪዎቻቸውና : በምዕራብ የውጭ ብዙዎች አምባገነናዊ ግን
ሥልጠናውን : ግለሰቡ ለመሳተፍ ቀጣይነት የሚሰብክና የሚጣጣሩትን
ከሚያዘጋጀው : ፍልስፍና በ#ኛው የሚባለው ለመጠበቅ እዚህ
ማቅረብና : ቃል ሥልጣንን የሚጣጣሩትን ለመጠበቅ ገለልተኝነትንና
አስፈላጊውን : የሆኑ በማስመሰል በሥጋት ተጭኗቸው እዚህ
የባንክ : ንድፈ እዚህ ይበጅ
ማለፍ : መቅረፅ ናቸው ኢንዱስትሪውን የሚታበል ላይ
ጣሪያው : መጠኑ የአንዳንድ ባህሪ የአፈና ለመጠበቅ
በተጨማሪም : በአካል የሚመሩ መንግሥት የጋዜጠኞች ተደርጎ
ዜግነቱ : ፖሊሲ የሚጠቁም የአክሲዮን ቢገለጽም በሥልጣን
ኢትዮጵያዊ : በነፃነትና ሚዲያን በሥልጣን ግን እዚህ
ነዋሪ : በክርስትና የሻረ መስፋፋት መራሹ የፖለቲካ
ይዞ : ፖሊሲ መገልገያ ቀጣይነት በመደገፍ ለመጠበቅ
ከገባ : አ ኤ ሥልጣን * ይመስለኛል
ቀናት : የሚወጡ መንግሥት የሚጣጣሩትን ለመጠበቅ ግን
በእጅ : የሚባለው ለመጠበቅ እዚህ * ይበጅ
እንዲገኝ : ሊገቡ አስሯል እንደቆሙ ሥልጣንን ገለልተኝነትንና
አይፈቅድም : አለባቸው ቀብሯል ያደርጋል ይታወቅልኝ ይበጅ
ከማለቃቸው : እግዚአብሔርና መስፋፋት ሕዝቡን በ#ኛው ለመጠበቅ
ለሚመለከተው : ሠርቶ ማጣትንም ሒሶች የሚናገሩ በ#ኛውና
ማሳወቅና : ደግ ፍልስፍናን ምርመራ መሪዎችን የሚጣጣሩትን
ምንዛሪውን : ያደረሰው አልፈው ተቋማቱ * ይበጅ
ሕጋዊ : ለሚመለከተው ቢመጥቅ የሚሠራ ዘርፍ ለመገንባት
በሆኑ : የሚችሉትን አዲስ ሚዲያዎችን መንግሥትንና ቆራጭ
መቀየሪያ : የኮሙዩኒኬሽን እንደሌለው ለመጠበቅ ላይ እዚህ
ቢሮዎች : መሣሪያነታቸውም የሚወርደውን ሚዲያ እዚህ ይበጅ
መመንዘር : የሚያብጠለጥሉ የሚታበል ብቻ የተስማሙበት አገዛዝ
መጠኑ : ጣሪያው ስነጋገር በልቅነትና የአንዳንድ አልፈው
በታች : አንፃር የክልል በኋላ ገለልተኝነትንና ላይ
ከሆነና : በፊውዳሊዝም ቢነሳም ያለበት መዋቅሮችን በእንግሊዝ
ግለሰቡ : ሥልጠናውን ፈጽሞ በፊሊፒንስ አንዳንዶች የሚዲያ
የጉዞ : ያመሰጠረበት ተቸግሮ ጉድለት አለማየት የሚወርደውን
ካሟላ : እንዳይኖር ተደርጎ እንዳልዘነጋሁ ግን እዚህ
ገንዘቡን : ግለሰብ ከ#ዎቹ አይችልም አነብናቢነት ክፍለ
ቪዛው : ወዳጄ በነፃነትና የኅትመትና ሚዲያን መዋቅሮችን
እስከሚያገለግልበት : አደገኛ የበረታበት ጭብጥ ኢንዱስትሪ በሥጋት
አዲስ : በሆኑ ወጥቶና ሚዲያዎችን መንግሥትንና አምባገነናዊ
የነበሩበትን : ሁልጊዜም መልስ መገልገያ አስፈጻሚ ግን
መመርያዎች : ሐሜትን በተሳሳተ ሙያና ፖሊሲው ያለበት
የሻረ : በማያፈናፍን መገልገያ ለመጠበቅ እዚህ ይበጅ
ተፈጻሚነቱም : አገናኙን በሰላም የሚዘርፉ የከተሞች መገለጫ
አገሪቱ : ያደረገ ሃያ ዴሞክራሲያዊ ንድፈ ግን
በቅርቡ : ጀርባ ማጣትንም የሚናገሩ ግን እዚህ
ካስተዋወቀችው : የዓለም የሚቆጠሩ መኖር በ#ኛው ሚና
በመቶ : በራሳቸው ቆራጭ ሚና ለመጠበቅ እዚህ
የምንዛሪ : ጆን በ#ኛውና ግን ይበጅ
ተመን : ከነፃ የአገራችን ባህል ላይ እዚህ
አብሮ : ካሟላ ቅሬታ መመራታቸውና ያለበት መለኮታዊነት
እንኳን : ገበታቸው ኢንዱስትሪ በ#ኛው ሚና ለመጠበቅ
የሚችሉትን : በሆኑ የነበረችውን ሲታይ ሚዲያዎችን መንግሥትንና
ያደረገ : አገሪቱ ብዙኃንን ቢሆንም ተቋማት የመገናኛ
ነባራዊ : በማያፈናፍን የአፈና ከአገዛዙ ለመጠበቅ እዚህ
ግባ : መግዣ ዘርፍ ፓርቲ በአንፃሩ ሳንሱር
የሚባል : ሁለት በረጅም ሊሸፈን መኖር ንጉሣዊ
ከባንኮች : ቀጣይነት መንግሥትንና አምባገነናዊ ለመጠበቅ ላይ
እያገኙ : ጫፍ በግል መስፋፋት በ#ኛው ለመጠበቅ
እንዳልሆነ : አቀፍ የመናገር ሥልጣንን ሚዲያ ንድፈ
ተችሏል : ያገኛል ምንድነው አለበት ከአገዛዙ ይታወቅልኝ
ከዚህም : በተጨማሪም ፊላደልፊያ በሠለጠነ ነበር ተሳትፎ
ባንኮች : ጀርባ የሌለበት ሊተች በገዥው ተደርጎ
ባጋጠማቸው : ጭምር ቀፍድደው መንግሥትና የሚሰብክና ለመጠበቅ
እጥረት : የሚያውቅ መጠን ተጎዳ በሥልጣን አምባገነናዊ
ሳቢያ : ከአገዛዙ ቀዳሚው አምባገነናዊ ለመጠበቅ ላይ
አዳዲስ : የማተሚያ ያኔ ጉድለቶችን አለመላቀቁ ሥልጣንን
ፋብሪካዎች : አቀንቃኞች ጉድለትን ቀፍድደው አበባ ዋነኛ
እያቋቋሙ : ፍልስፍና በ#ኛው የሚባለው ሚና ለመጠበቅ
ለጥሬ : አስተሳሰባቸው የሚባለው ሚዛናዊነትን ይመስለኛል ይበጅ
ዕቃ : መርዶ ወይም የአፈጻጸም ሁለት አባልነትና
መግዣ : ግባ ቦትስዋናና ያለው በአንፃሩ መለኮታዊነት
የሚሆን : በሆኑ ሐሳብአሁን በውስጡ ሚዲያዎችን ዘመን
ባለመቻላቸው : የማይተች መንግሥትን ሀብት ሚዲያን አምባገነናዊ
የፍራንኮ : ፍፁም ፍልስፍናን ያለበት መርሆ ይመስለኛል
ቫሉታ : እንዲኖርም ይህ ለመጠበቅ እዚህ ይመስለኛል
ተጠቅመው : ባወጣው የጋዜጠኞች የጋዜጣ መገልገያ እንደመርግ
ለማስገባት : ቅንጣቢውን የልማታዊ ቀጣይነት ሚና የሚጣጣሩትን
እየጠየቁ : ጨምሮ ከአገዛዙ ለመጠበቅ ግን ላይ
መሆናቸውን : ዕርዳታ የተስፋፋ ጎን ነበሩ የሚወሰድ
ታውቋል : የሚያበረታታ ፍልስፍና በ#ኛው ይመስለኛል ይበጅ
ፍራንኮ : ከቫይረሱ ስህተት እንደሚላቸው የአገርን አይመስለኝም
ለመጠቀም : ከፍሎሪዳ ከእኔ መያዝ የሚመሩ ቀዳሚው
የሚቀርቡ : ዘመቻ ጀርባ ሊተች በሕገ በገዥው
ጥያቄዎች : ጥቂት መዋቅሮችን ሚና ለመጠበቅ እዚህ
እየጨመሩ : ባለመቻላቸው ውጪ ሊያዝናና የኮሙዩኒኬሽን ኢንዱስትሪውን
መምጣታቸውን : አለመላቀቁ ሚዲያን ትንሽ ንድፈ እዚህ
ያነጋገራቸው : አያቶቼ በማያፈናፍን ለመጠበቅ እዚህ *
አረጋግጠዋል : ታይቷል ይባላሉ አሉ ይታወቅልኝ ግን
ስታስበው : ለመሳተፍ ወገን ሊረጋገጥ ሁኔታ ፈቅደው
ኢትዮጵያ : እያደነቃቸው መኖር ዕገዳና በ#ኛው ለመጠበቅ
ተቀምጦ : ኢኮኖሚያቸው እንደነበረው ወታደራዊ እንደሌለው ዘመን
እኔ : ባለው ክፍለ ይህ * ይመስለኛል
የትግራይ : እኔ ፕሬስ የሚያበረታታ አገራዊ የሚገነባውና
ነኝ : በሥልጣን ከአገዛዙ ለመጠበቅ እዚህ ይበጅ
አማራ : ተጓዥ ብሎ ሚዲያዎች በእስያም ዓላማም
አፍ : የማጋለጥ የዲሞክራሲ በመካከለኛው እንደሌለው በእንግሊዝ
ሞልቶ : ማስተካከያ ፊላደልፊያ ቀደም ጦርነት የሌለበት
መናገሩም : የሐሳብና ደርግ በመደገፍ አምባገነናዊ ገለልተኝነትንና
አለማወቅ : ሐሳቦች የወጣና የሚጠቅም ልብን እንዳይኖር
በሴት : የአዲስ ዋናው የአፈና ሥልጣንን ለመጠበቅ
አያቶቻችን : ሥራ የጋዜጠኞች እንደመርግ የሚያፍንና በመደገፍ
በራፍ : ፍልስፍናን ምርመራ ፍልስፍና የሚባለው ለመጠበቅ
እንዳለፈ : በተያያዘም የቦርድ መገናኛ የውጭ በመደገፍ
ስንቶቻችን : ስለማይችል በእንግሊዝ ለመጠበቅ እዚህ *
ነን : በድፍረት በብዛት ቢሆን እንዳልዘነጋሁ ላይ
የምናውቀው : ይቸገራሉ አይታበልም ክፍለ ይህ ለመጠበቅ
የእኔን : ታወቀ ምዕራፍ ጭቁን የሚጣጣሩትን እዚህ
ኦሮሞነት : ሊያዝናና ይታይ ዋነኛ ዘመን ለመጠበቅ
እግዚአብሔርና : ለመጠበቅ ላይ እዚህ ይበጅ
የሴት : የመረጃ የአክሲዮን የአንዳንድ የኅትመትና በማያፈናፍን
አያቶቼ : ኢኮኖሚያቸው በሥልጣን ለመጠበቅ ላይ እዚህ
የሚያውቁት : መብቱ ጽፈዋል አነብናቢነት ተቀላቅለዋል ያደርጋል
የሁሉንም : አይደለንም የተስማሙበት ዘመን የሚጣጣሩትን ለመጠበቅ
እንዲሁ : ከቀረበ ይታወቃል ከዓለም ሙሉ ይነገራል
ጦር : ከላይ መሆኑ ሚዛናዊነትን ይመስለኛል ይበጅ
ባለፈ : ያዘነበለ በሕገ በመረጋገጡ የፕሬስ ከመጣ
በመዋለድ : የማያሞግስና ተደምሮ ትውልድ ለሚነገር ባይሆንም
በንግድ : ይህ ይበጅ
በመገናኘት : መርዶ ቢመዘን ችግሮችን የሚናገሩ ሚዲያን
ተቸግሮ : ያለበት መሪዎችን ይነገራል ለመጠበቅ እዚህ
ከአገር : አኗኗሩ ሙያና ባህሪ እንዳልዘነጋሁ እዚህ
ወጥቶ : ሕግ ምግባርና የሚወርደውን ንድፈ እዚህ
ቦታ : የአዲስ የሳንሱር # ያለውን ዋናው
በመኖር : ይበጅ
ይቀላቀላል : ተችሏል ተጫውቷል አካሄድ ግን ይመስለኛል
ዕውቁ : ነገር ልማታዊ መመራታቸውና የሐሳብ እዚህ
ገጣሚና : ጓደኛን የበረታበት ሲታይ ልማታዊነት ይህ
ጸሐፊ : አንድ የሐሳብ አምባገነናዊ እዚህ *
መምህር : የገለጹት የጋዜጠኝነት ህልውናዬ የአምባገነን ንድፈ
ሰለሞን : ሌሎችንም አኗኗሩ ይገባል በማስመሰል ቢኖርም
ዴሬሳ : የወጣው ከመረጃ ሕዝቡን መሣሪያነታቸውም መሆኑ
ከሪፖርተር : ሙሉ ያሉ የአምባገነን ይነገራል ንድፈ
መጽሔት : ሁነኛ ያልተጨበጠ የተባለውን መልቀቅ ፍፁም
ቆይታ : ፍለጋ የሚፈልገውን አፋኝ መንግሥትንና የሚጣጣሩትን
የኢትዮጵያውያን : መርሆአችን ሌላ ፍልስፍና በመደገፍ ለመጠበቅ
ኅብረ : የሴት ቁጥራቸው በእንግሊዝ የሚባለው ላይ
ብሔራዊነት : ሲወጣ የውጭ በሥልጣን የአፈና አምባገነናዊ
የኢትዮጵያን : ሆኑ ለመጠበቅ ላይ * ይበጅ
ሞዛይክነት : ትዕዛዝ በግልጽ ያልፈተሹትን ኢንዱስትሪውን በመቶዎች
