ይበጅ : ሊኖረው ሊፈርድ እንዳልዘነጋሁ ላይ እዚህ
ይመስለኛል : አውጥቷል ሰነባብቷል ያደርጋል ይታወቅልኝ እዚህ
* : ሊነግድ ማለት መፍረስም ገድሏል የሙጭኝ
እዚህ : ያልፈተሹትን በመረጋገጡ ቢኖርም በእንግሊዝ የሚጣጣሩትን
ላይ : ሚና ግን ይበጅ
ግን : ቢከብድ የአገሪቱ ነፃነትና ዘመን ሚና
ገለልተኝነትንና : ስለኤሌክትሪክ ስቶ ተመሥርተው ይታይ በፖለቲካ
ሚዛናዊነትን : ሥልጠናዎችን መሪዎችን በእንግሊዝ ንድፈ ይታወቅልኝ
ለመጠበቅ : ዘርፍ ኢንዱስትሪውን ወደ የሚሰብክና የሚጣጣሩትን
የሚጣጣሩትን : ዕቃ ባወጣው የአፈጻጸም ደግ በሥጋት
እንዳልዘነጋሁ : አትሞ እንዳለበት ይገባል መኖራቸው ከመሆን
ይታወቅልኝ : ምንድነው ይሆናሉ ተቀላቅለዋል ጨፍልቋል ያደርጋል
አምባገነናዊ : ለአማራጭ በዚህም ኢሕአዴግ ዋነኛ ዋናው
ሚና : ላይ እዚህ ይመስለኛል ይበጅ
ንድፈ : አካል ዴሞክራሲያዊ መሪዎችን ሥልጣንን በእንግሊዝ
ሐሳብበዓለም : ቆራጭ ሚና ላይ እዚህ ይመስለኛል
ሚዲያ : ቪዛው ካለው ባለፈውና ፈቅደው መርሆ
ታሪክ : እንዲኖርም መራሹ እንደነበረው ዘመን ሐሳብ
ቀዳሚው : በሕጋዊ ኢትዮጵያዊያንና የሐሳብ ዋነኛ ዋናው
የሚባለው : ጆን የሚያበረታታ ይኼ የቦርድ ምሥራቅ
ይህ : በሌሎችም የአፈና ክፍለ በ#ኛው ለመጠበቅ
ሐሳብ : ዕፅ ገንዘብ በተድላ ዓለም ተጭኗቸው
በ#ኛውና : የምንዛሪ ቢመጥቅ አስኪያጆች አንድ ነበር
በ#ኛው : ይግባኝ ፍፁም ነፃነት የሚሰብክና ይህ
ክፍለ : ማዳመጥ ብል የአፈና ይህ ቀዳሚው
ዘመን : ሚዛናዊነትና እንቅፋቶች የኤሌክትሮኒክና የአገሪቱ ግን
በእንግሊዝ : ከዚህ በመረጋገጡ ከመጣ መንግሥታትም እዚህ
አገር : ፍራንክሊን ከላይ በአሠራር የሚገነባውና መሣሪያነታቸውም
እንደተጀመረ : ተዓማኒነትን አስሯል ሥልጣን እንዳልዘነጋሁ ይበጅ
ይነገራል : ብለዋል ይቀነቀናል ይችላል ቀብሯል መንግሥታትም
መርሆ : አሁን ግንኙነትና ዋና ተቋማቱ ብለው
የፈላጭ : በአስተሳሰብ መገልገያ መዋቅሮችን ለመጠበቅ ሚዛናዊነትን
ቆራጭ : ሐሳብበዓለም ሚና ላይ እዚህ ይበጅ
ንጉሣዊ : የሚባል አብሮ ራሱን ጫፍ ተቀንቅኖ
አገዛዝ : በሸቀጥነት ወደነበሩበት ሕዝቦች የቅድመ የሚወሰድ
ሥልጣንን : ቢቀያየርም ተመስገን ይታይ ሥርዓት #
መለኮታዊነት : ማንቆለጳጰሳችን መያዝ በክልልና የሚቆጠሩ ሚዲያን
የሚሰብክና : ጭምር ደቡብ በግል ሊሸፈን ፍፁም
ከአገዛዙ : ዓላማ ቀፍድደው ዘርፍ ኢንዱስትሪውን ለመጠበቅ
የሚወርደውን : የሚፈቀድላቸው ጥረት አሁንም ቆራጭ ሐሳብበዓለም
የአፈና : ማስተዋል በሌሎችም በኢትዮጵያ ዓላማም ይህ
አሠራር : ሚዛናዊ ይህ የሚባለው ለመጠበቅ ይበጅ
አስፈጻሚ : ለማቋቋም ፈጥኖ ኃላፊዎችና ኃላፊዎች የብሮድካስት
ተደርጎ : የጎላ የፓርቲው የተሟላ የሚወርደውን ላይ
የሚወሰድ : እየታየ በኋላ ባህሪ እንዳልዘነጋሁ ይበጅ
ነው : በተካነበት ጽሑፍ በአስተሳሰብ የማይችል የአምባገነን
ዋናው : እርግጥ ለማጠቃለል ቀጥሎም የነፃነት መነሻው
ዓላማም : ትገዛ በኢትዮጵያ የአፈና ይህ ለመጠበቅ
በሥልጣን : የግልም መንግሥታት ዘገባ የብሮድካስት በሙያተኛው
ያለውን : ሊሸጥ በእስያ በመደገፍ የአፈና ይህ
መንግሥትንና : ከሕዝቡ ዳኝነት በባህል መሣሪያዎቹ ነፃነትና
የመንግሥት : በፍርድ አፍ የሚገመተውን ሲባል ሙያዊ
መዋቅሮችን : የመንግሥትና ፈጽሞ መገልገያ የሥርዓቱ መሆኑ
በመደገፍ : ሕጎች ሁለት ያለውን ለመጠበቅ ላይ
የአምባገነን : በክርስትና ተቋማት ስለማይችል ነው *
መሪዎችን : ስለነበረ ሚዛናዊነትን እዚህ * ይመስለኛል
ሥልጣን : ጎን መንግሥት አስሯል እንደቆሙ እንደተጀመረ
ቀጣይነት : እንዲገነዘብ ልማድ ጎልቶ በእርሱ የተሟላ
ማረጋገጥ : ነፃነትና መርሆ ሐሳብበዓለም ግን ላይ
የዚህ : ተማረከ ችግሮችን ፕሮፓጋንዳ ጭቁን የቅድመ
የሚዲያ : ገለልተኛ አለማዳመጥ እንደፈለጉ ዓለም ሐሳብ
ፍልስፍና : የሚንቀሳቀሱ ደግ በሥጋት ለመጠበቅ ግን
ዋነኛ : ካለፈው የሳንሱር መገናኛ በአፍሪካ ቀዳሚው
መገለጫ : በእስልምና እንደሌለ ብሎ የሚንገታገቱ ላይ
የቅድመ : አገሪቱ ሌላ ዴሞክራሲያዊ አገዛዝ ንድፈ
ምርመራ : ቪክተርና በሚናፈስበት ተጭኗቸው ሐሳብ ይታወቅልኝ
ሳንሱር : አዘዋዋሪ ሚዛናዊነትና በአንፃሩ ዘመን ታሪክ
ያለበት : ተቸግሮ ሪፖርተር አስተሳሰብ ኢንዱስትሪውን ፈቅደው
መሆኑ : የሙስና ወገን መዋቅሮችን ይታወቅልኝ እዚህ
ይህም : በመንግሥትና በመሆኑ መርሆዎች መገልገያ አስፈጻሚ
በሙያተኛው : በልማቱ ይኼን ዓመታት በሥልጣን ዘመን
ነፃነት : ዝንባሌና ባጋጠማቸው በ#ኛው ይህ ይመስለኛል
እንዳይኖር : ክትትል መሆኑን ያህል ይበጅ
ያደርጋል : ተቀላቅለዋል አሉ ይታወቅልኝ ይመስለኛል ይበጅ
የሐሳብ : ኢትዮጵያዊያንና የግልና ቀዳሚው ግን ላይ
ነፃነትና : ቢከብድ ባይባልም ማረጋገጥ ግን ላይ
የሕዝብን : ብሎም መንግሥትን በመከታተያ ጊዜም እንደሆነ
ተሳትፎ : ፊላደልፊያ በኢትዮጵያ ተመልካች አስፈጻሚ የአፈና
የሚያፍንና : የኅትመትና የሚንገታገቱ ቢሆን ያለውን ላይ
ዴሞክራሲያዊ : አካሄድ ንድፈ ይታወቅልኝ ሚዛናዊነትን ይመስለኛል
ባህሪ : ታስቦ የሚወሰድ እንዳልዘነጋሁ ይበጅ
እንደሌለው : ኢንዱስትሪው ሠራሽ የምናየው የሐሳብና አስፈጻሚ
ብዙዎች : ፍልስፍናና የመሰለውን ተፈጥሯዊ ለመገንባት ፍልስፍናዬ
የተስማሙበት : እየተጎዳ በኋላ የሚወሰድ እንዳልዘነጋሁ ይበጅ
ፍልስፍናው : በተጨማሪ በላቲን ብዙዎች ገለልተኝነትንና *
ዛሬም : ረገድም በነበሩት አይችልም ፍልስፍናዬ ብዙዎች
ቢሆን : ባለመቻላቸው ጋዘጠኝነትን በአሠራር አገሮች የሚያፍንና
እንደመርግ : ያጋለጠውን የምታውቁ ሕዝቡ በሕገ ደርግ
ተጭኗቸው : በድርጅቱ ሥርዓቱ ቢኖርም ሐሳብ ታሪክ
ያሉ : ያቀረባቸው ዝግጁ መምጣት መርጠው ማጋነን
አገሮች : ባለመቻላቸው ስናልፋቸው ጋዘጠኝነትን ተመሳሳይ ቢሆን
አሉ : ይፈሩ ይበዛል ይባላሉ አይመስለኝም ያደርጋል
በአፍሪካ : ተልዕኮውም በሠለጠነ መነሻው መገናኛ ዋናው
ኤርትራን : በንግድ መጽሐፍ ሚዛናዊና ወደኋላ በክልልና
የመሰሉ : ከሕገ ሊሸፈን ያለውን ለመጠበቅ ይበጅ
ጭቁን : የኢትዮጵያውያን መቀባት በዩናይትድ የፍልስፍናው ሚዲያዎች
ሕዝቦች : ተቀሰቀሰ አውሮፓዊያኑ አገዛዝ ገለልተኝነትንና ላይ
በመካከለኛው : የመግለጽ ሌላ ጭቁን የቅድመ የመንግሥት
ምሥራቅ : በፊት በእስያም የሚባለው አምባገነናዊ ለመጠበቅ
በላቲን : በሳይንስ ያለፈ የሚጠልፈው ቁጥራቸው ፍልስፍናው
አሜሪካና : መንግሥትን ማጣትንም በገዥው የመንግሥት የሚባለው
በእስያም : መድረሻ ሕዝቡን በፊት ያለውን ይህ
ቁጥራቸው : አረዳድ እንዲሁም በላቲን የአምባገነን አሠራር
ትንሽ : የተገነባ ማሳተም ቆራጮች ብዙኃን እንደተጀመረ
አይደሉም : ገልጿል ገቡ መረመረ አለበት አሳድዷል
የግልና : በደርግ የሐሳብ ቀዳሚው የሚጣጣሩትን ግን
የውጭ : ሥርዓት መሪዎችን ሥልጣንን ገለልተኝነትንና ግን
ሚዲያዎችን : ሐሳብበዓለም ሚና ላይ እዚህ ይመስለኛል
ፈቅደው : ኪሳራ የአንዳንድ ሚዲያን ሚዲያ ለመጠበቅ
ሚዲያን : አቀንቃኞች ስም ፈቅደው መሪዎችን መለኮታዊነት
የሥርዓቱ : ማየት የኅትመት መዋቅሮችን ንጉሣዊ እዚህ
መገልገያ : መዋቅሮችን የፈላጭ ሚዛናዊነትን እዚህ ይበጅ
በማድረግ : ወዘተ መንገድም ሲባል የመንግሥት በ#ኛውና
ፍልስፍናን : ቃል ድክመት የመናገር እንዳልዘነጋሁ ይበጅ
የሙጭኝ : ተቀምጦ ኢኮኖሚያቸው አስመስክሯል ባለቤት ሳንቲም
ብለው : አንስተን የሚመለከታቸው መሣሪያዎቹ ነፃነትና መርሆ
የሚንገታገቱ : ተቀርፆ ኒልን ጋዘጠኝነትን ማጋነን የኅትመትና
መንግሥታትም : እንደሚችልና ይከተላሉ አሉ ይታወቅልኝ ሚዛናዊነትን
መሀል : መቼ አለፎ ሕግ ተቃዋሚዎች ቢመዘን
መንገድ : ወራት መሃላቸው ዴሞክራሲና በእርግጥ በሙሉ
እንደቆሙ : ስለሆነ ክፍተት ድክመት የሚወሰድ እንደተጀመረ
ኢትዮጵያዊያንና : በሕጋዊ የሐሳብ ቀዳሚው አምባገነናዊ ግን
የአገሪቱ : እያየሁና ግን ላይ እዚህ ይበጅ
መገናኛ : መነሻው በአፍሪካ ዋነኛ ዋናው ቀዳሚው
ብዙኃን : ግንኙነቶችም ግንኙነትና ሚዲያን ትንሽ እንዳይኖር
እስከ : ሲሆን የበላይነት የምዕራቡ ጋዜጠኛን ፍልስፍናው
# : ቫይረስ የሚያደርጉ በተጠንቀቅ ተቀባይነት በተጨማሪ
ዓ.ም. : በአመለካከት ኢሕአዴግ ዋናው አምባገነናዊ እዚህ
ማብቂያ : ባንክን ተመልሶ ብል ክፍለ አምባገነናዊ
ድረስ : እንደተሰጣቸው ማየት ብለው መርሆ ሐሳብ
ሙሉ : በቁጥጥሩ ፈጽሟል መሣሪያ ይከተላሉ ዴሞክራሲያዊ
በሙሉ : የኢቦላ የመረጃና መንገድ የሐሳብ ዋናው
እንደተጫናቸው : ልጅ የሚገባው የሚንገታገቱ የተስማሙበት በ#ኛውና
ነበር : የህሊና አስኪያጆች ባይሆንም ቀዳሚው አምባገነናዊ
በንጉሡ : ባለፉት በአሁኑ በደርግ ለዚህ የግልና
ጊዜ : ሰው በፆታ ሕዝቡን ሊፈርድ የፓርቲው
በአንፃሩ : ባለሀብቶች የኤሌክትሮኒክና ይታይ ሳንሱር ሥልጣንን
የተሻለ : ሺሕ እንደሌለ የከተሞች መኖር ነፃነት
የሙያው : በጠበቃው በአይሁድ አውሮፓዊያኑ ሚዲያዎች ሕዝቦች
ቢኖርም : ከሞላ እንደፈለጉ ሥርዓቱ ተጭኗቸው ምርመራ
ደርግ : ፈጣን መምጣት እንደመርግ አሠራር ይህ
የተባለው : ቆራጭነት ደጉን ማረጋገጥ ሐሳብበዓለም ይታወቅልኝ
አፋኝ : የሚገነባውና አገሮች አገር ገለልተኝነትንና ላይ
ወታደራዊ : የተፈጠሩ በተጨማሪ ናቸው የሳንሱር ሥልጣንን
ሥርዓት : የፖለቲካ የውጭ ሥልጣንን ገለልተኝነትንና ግን
በማያፈናፍን : በፖለቲካዊ ጥላሸት ለባለሀብቱ እንደሆነ በማድረግ
ሁኔታ : የሚናገሩባቸው በክልልና የሚናገሩ ፍፁም ያለበት
የሐሳብና : ያለውን አስፈጻሚ ሚና የሚጣጣሩትን ላይ
የአመለካከት : አደጋ በከፍተኛ የሚቆጠሩ አገሮች እንደመርግ
ነፃነትን : ለማወቅ አኳኋን አማራጭ ድክመት በኋላ
ጨፍልቋል : ወሰነ ይቻላል ምንድነው አለበት ይታወቃል
ዜጎችን : ለአምስት ቢልዮን ለምሳሌ ቢያንስ መገናኛ
በፖለቲካ : የሚወዳቸውን ስቶ የመሥራት አውሮፓዊያኑ ገለልተኝነትንና
አስተሳሰባቸው : በኤዲቶሪያል ጋዜጠኝነት ሚዛናዊ ቁጥራቸው አሜሪካና
ብቻ : ቢሉም ኃላፊዎች የማለቱን የብሮድካስት ዓላማም
ገድሏል : አይቶት ጀፈርሰን ሳይሆን ይኼ የምናየው
አስሯል : ተዓማኒነትን እንደተጀመረ እንዳልዘነጋሁ ይበጅ
አሳድዷል : ጽፈዋል አይደሉም ያደርጋል ይመስለኛል ይበጅ
ዕገዳና : ባይባልም የአገሪቱ ነፃነትና ግን ላይ
የመናገር : ወንጀሎች ግለሰቦች ፍልስፍናን ባህሪ ሥልጣን
ቀብሯል : አለባቸው ይታያል ጨፍልቋል ይነገራል ይታወቅልኝ
ለዚህ : ለትራፊክና ጉድለታቸው ባለፉት በንጉሡ በሙሉ
ደግሞ : በመነሳት እጅ ለምን ደረጃ ቢነሳም
ዋነኞቹ : ጸሐፊ ባለሀብቶች ውስጥ ነፃነትና ማረጋገጥ
መሣሪያዎቹ : የነበረችውን ብለው ነፃነትና ግን ላይ
የኅትመትና : ድክመቶች ተቀርፆ ለአጃንስ የሚያፍንና ያለውን
የብሮድካስት : ብሔራዊነት የማለቱን አስፈጻሚ የሚጣጣሩትን ለመጠበቅ
ሚዲያዎች : በመጠየቅ በጠበቃው እንኳን ፍለጋዬ የሚጠይቅ
ነበሩ : እንዴ አማራጭ አካሄድ ያደርጋል ይታወቅልኝ
የሳንሱር : ካለፈው ዋነኛ አምባገነናዊ ገለልተኝነትንና ግን
መኖር : በባዶ ከፍ በመጠኑ ካለው የተሻለ
የጋዜጣ : ወገን የግል መሆኑ አገር ሚዲያ
ተቋማቱ : ዋና ብለው መርሆ እንደተጀመረ ሐሳብበዓለም
በገዥው : በፍርድ ሲሠሩ መንግሥትን የመንግሥት አምባገነናዊ
ፓርቲ : የተቀናጀ መፈናቀል ዓለም ድረስ ዴሞክራሲያዊ
ርዕዮተ : የሚጠየፍና በቋንቋ የርዕዮተ ፍፁም ዛሬም
ዓለም : እንደነበረው ሥርዓቱ ሐሳብ ታሪክ ሚዲያ
ክፍል : የሚቃረኑ ጋና የዴሞክራሲ ማንም የምናየው
መመራታቸውና : መንካት በቀጣዩ እዚህ * ይመስለኛል
ፍፁም : ደቡብ በ#ኛው ይህ ለመጠበቅ እዚህ
የሆነ : መርሆአችን መሥሪያ በእርሱ በላቲን ይታወቅልኝ
የፖለቲካ : ሥርዓት የውጭ ሥልጣንን ክፍለ ንድፈ
መሣሪያነታቸውም : መንግሥትንና አገር ሐሳብበዓለም ሚና ላይ
የሚታበል : አለመያዙ መሆን በኋላ የተስማሙበት ይበጅ
አልነበረም : ይሄዳል አይድንም ጨፍልቋል አይደሉም አሉ
ኢሕአዴግ : የአዲስ በዚህም አምባገነናዊ * ይመስለኛል
ወደ : መርምሮ ለመጠበቅ እዚህ * ይበጅ
ከመጣ : ልበ በእንግሊዝ ይታወቅልኝ ሚዛናዊነትን *
በኋላ : የተፈታ የተስማሙበት የሚወሰድ እንዳልዘነጋሁ ይበጅ
የመረጃና : በማረም አሉባልታ በሙሉ መንገድ የሐሳብ
የፕሬስ : ሊያገኝ መርምረው መነሳትና ሚዲያን መሪዎችን
በመረጋገጡ : የተፈቀደው መስፍንበዚህ በመሆናቸው መጽሔት ከሆነ
በሕገ : ሕዝቡ ምግባርና እንደመርግ ይህ ቀዳሚው
መንግሥትና : የከተሞች ፖሊሲው መኖር የተሻለ መገለጫ
በአዋጅ : መርዶ አኳያ ትኩረት ጨምሮ አገር
ማፅናቱ : መስፋፋት በሥጋት የማለቱን በእርሱ ከአገዛዙ
አንድ : መምጣት ደርግ እንደመርግ በ#ኛውና ይህ
ዕርምጃ : ከዴሞክራሲ ካለፈው ህንድ ራስን አስኪያጆች
በዚህም : ጉዞአቸውን አምባገነናዊ * ይመስለኛል ይበጅ
በተስተካከለና : ሞተ በእስያ ላይ ይመስለኛል ይበጅ
ሚዛናዊ : አሠራር ይህ የሚባለው ለመጠበቅ ይበጅ
በሆነ : ብናጤን አስገኝቷል ተጠሪነቱ እየተስፋፋ የዚህ
ሜዳ : ከ#ኛው ይዘነጋና በ#ኛው እዚህ ይመስለኛል
ባይሆንም : እንጂ መርጠው በሕገ ነበር በሙሉ
በመቶዎች : ነፃነትና ማረጋገጥ ግን እዚህ ይበጅ
የሚቆጠሩ : ለማብጠልጠልስ የሚሠራ በክልልና መለኮታዊነት በ#ኛውና
የግል : አቋም ባለሥልጣን ጉድለት መርሆ ሚዲያ
የኅትመት : የአንባቢውን መዋቅሮችን ንጉሣዊ የሚጣጣሩትን እዚህ
ኢንዱስትሪውን : የተጠቀሱት ማድረግና ከአገዛዙ ለመጠበቅ ይበጅ
ተቀላቅለዋል : ያደርጋል ይታወቅልኝ ይመስለኛል ይበጅ
መነሳትና : አገናኙን እርጋታ ባህል የፕሬስ አገሮች
የተቋሙ : ዓመታትን የተጠናከረ ትችቶች የኅትመትና የመሰሉ
መፍረስም : አልነበረም አይደሉም አሉ ይታወቅልኝ *
ሌላ : ፕሮፓጋንዳ በመካከለኛው የቅድመ የዚህ አገዛዝ
ሊሆን : ደጉን ብለው ማረጋገጥ ቆራጭ ታሪክ
ይችላል : ተለመደ ያተኩራሉ ይነገራል ይታወቅልኝ *
ሥርዓቱ : ጉዳዮች የሚመስል ተጭኗቸው ይታወቅልኝ ሚዛናዊነትን
የተሟላ : ከልክ የሚጋርጥ ፖሊሲው ያህል እንዳይኖር
ዴሞክራሲ : ኮሙዩኒኬሽን ልማታዊ መንግሥትንና ላይ ይበጅ
የሚገነባውና : አፋኝ አገር ላይ ይበጅ
ህልውናዬ : ርዕዮት ነፃነትን ዴሞክራሲያዊ ንድፈ እንዳልዘነጋሁ
በእርሱ : ብሮድካስት ወገን ጎልቶ ፖሊሲው ማፅናቱ
ካልሆነ : አዘዋዋሪ የሕዝብ ሳንሱር እንደተጀመረ ግን
ሊረጋገጥ : ከአውሮፓ ያለውን ይህ ላይ ይበጅ
ስለማይችል : ቤትን እንደ የሚያስችሉ የተባለው የአምባገነን
የማለቱን : ከሕግ የብሮድካስት በሥልጣን አስፈጻሚ የሚጣጣሩትን
ያህል : ሊዘነጉ ስናልፋቸው ምሁራን እንዳይኖር ይበጅ
ከፈላጭ : ባህልን በኤዲቶሪያል መገልገያ የፈላጭ ለመጠበቅ
አለመላቀቁ : ስለነበረ ሳንቲም መብት ዴሞክራሲያዊ ንድፈ
ሊተች : ሁለት አቀፍ አባልነትና በመደገፍ ያለውን
የሚገባው : እንዳለበትም የመጣ ደጋፊነት እንደተጫናቸው የተስማሙበት
ቢያንስ : ቴክሳስ ዜጎችን ዋናው ሚና ላይ
ፍልስፍናዬ : ጎተራ ድብልቅልቅ ብዙዎች መሪዎችን ሚዛናዊነትን
ልማታዊ : ማንሰምቶት ወጥቶና ኮሙዩኒኬሽን ዴሞክራሲ የመናገር
ጋዜጠኝነት : ይቅርታ ውጪ ለመገንባት አስተሳሰባቸው በ#ኛውና
ብሎ : ምንም መገለጫ ሥልጣን የሚወርደውን እንደተጀመረ
ሲያበቃ : ለማዋል ዳይፐሩን ጠቃሚ ቢያንስ በሙሉ
አውሮፓዊያኑ : አስተዳደርና የሙያው ሕዝቦች አገዛዝ ገለልተኝነትንና
ከሦስት : ከአንድ ለዴሞክራሲ ልበ መንግሥታትም ብዙዎች
መቶ : ተጠባቢነቱ ከአገራዊ ሚዲያዎች እንደሌለው ከአገዛዙ
ዓመታት : እንዲገኙ ሐሳብአሁን በልማቱ ይኼን ሊሆን
በፊት : ባለው ምሥራቅ አሠራር ይህ የሚባለው
ወደነበሩበት : ተገቢ ሕዝቦች አገዛዝ የሚባለው ሚና
መመለስና : የጠነከረ አይደሉም የመንግሥት የሚባለው ይታወቅልኝ
የምናየው : አፋቸው ልቦናና ዘገባዎች ካለፈው ሳይሆን
ልማታዊነት : የማተሚያ ኃላፊነት ሚዲያን ፈቅደው መሪዎችን
ሊሸፈን : በግል የመሰሉ የሚሰብክና ለመጠበቅ እዚህ
የማይችል : ሙያና ጎልቶ የሚያፍንና የሚወርደውን እንዳልዘነጋሁ
ድክመት : መረጃ የተስፋፋ ክፍተት የሚወሰድ እንዳልዘነጋሁ
ለምሳሌ : ለአምስት የአፋልጉን ከፊልም ዜጎችን መገናኛ
ቢነሳም : የሚንደቀደቅ አስረድተው ባቀረቡት ልማትን በረጅም
የጋዜጠኞች : በፌስቡክ አሜሪካ መልስ እንጂ ቅሬታ
በነፃነትና : ልብን ተቋማቱ መርሆ እንዳልዘነጋሁ ገለልተኝነትንና
በኤዲቶሪያል : የመስኩ አስተሳሰባቸው ይነገራል * ይበጅ
ፖሊሲው : ውግንናው በመጠኑ በጥናት ደረጃ የተሟላ
የመጻፍ : እየፈጸመ መካከል ድምፅና ከሦስት የሙጭኝ
መብት : ባለሀብቱ አይችልም ተቋማት አለመላቀቁ ሥልጣንን
ቢረጋገጥም : ሙያዊ እንደሆነ የመንግሥት በ#ኛውና የሚባለው
አሁንም : ሥልጠናውን የዘገበ ጥረት እንዳይኖር የሚወርደውን
በመንግሥት : ክሱ ራስን አምባገነናዊ * ይመስለኛል
የመገናኛ : እየወደድናቸው የመንፈስ አንባቢያን ጋዜጦችና የሚል
ውስጥ : ባይባልም ነፃነትና ግን እዚህ *
የገዥው : ትክክለኛ ሌላ የጋዜጣ የቅድመ አገር
ጣልቃ : ጉዳይን መሣሪያዎቹ የአገሪቱ ብለው ግን
ገብነት : የህሊና ነበር ዋነኛ ቀዳሚው አምባገነናዊ
ጎልቶ : ብሮድካስት ምዕራፍ ቀጣይነት ሐሳብበዓለም የሚጣጣሩትን
እየታየ : ያሳዩም የሚወሰድ እንዳልዘነጋሁ ይበጅ
በደርግ : በአሁኑ የግልና የሐሳብ ቀዳሚው ታሪክ
ይታይ : በጻፏቸውና ባለሀብቶች በአንፃሩ ሥልጣንን ገለልተኝነትንና
እንደነበረው : ዓለም ዋነኞቹ ታሪክ ግን እዚህ
የፓርቲው : ሥልጠናውን የበለጠ እንኑር የሚገነባ ጋር
የርዕዮተ : እንዳይሆን እንደሆነ ጋዜጠኝነት ርዕዮተ በእንግሊዝ
ኃላፊዎች : አብረውት የብሮድካስት አስፈጻሚ ግን እዚህ
የቦርድ : ጆን ምሥራቅ የሚባለው ገለልተኝነትንና ይበጅ
ሰብሳቢዎችና : የተመልካቹ ሚልተን አስተዳደርና ባህሪ የሚወሰድ
ዋና : ተቋማቱ ቆራጭ መርሆ ሐሳብበዓለም ግን
ሥራ : መግለጽም እንዳልዘነጋሁ ይበጅ
አስኪያጆች : በ#ኛውና አምባገነናዊ * ይበጅ
ከመሆን : አስሯል እንዳልዘነጋሁ ይበጅ
አልፈው : ከተሰኘው መጠኑን ብሎ መንግሥትና የሐሳብና
የሚመልስ : ሃይማኖቶች መንግሥታት ሜዳ በሥልጣን የሚሰብክና
አካሄድ : ዴሞክራሲያዊ ንድፈ ይታወቅልኝ ሚዛናዊነትን ይመስለኛል
እየተከተሉ : ቀደም ብቻ ክፍለ ግን ላይ
እንደሆነ : አቋሙ ከማል መንገድም ሙያዊ ቢረጋገጥም
በሥጋት : የበረታበት ሲታይ ደግ ለመጠበቅ እዚህ
የሚናገሩ : ባወጣው በማድረጉም ሰጪ ጽሑፍ ሁኔታ
የመስኩ : በኤዲቶሪያል አስተሳሰባቸው በላቲን * ይመስለኛል
ባለሙያዎች : በባለሥልጣናት የተስማሙበት የሚወሰድ እንዳልዘነጋሁ ይበጅ
በኤዲተርነትና : ማኅበረሰብ የመውሰድ ሚዛናዊነትና ግን ላይ
በከፍተኛ : በሥራው የከፋው የሚሠራ እንደመርግ ያለበት
ሙያተኛ : ዘገባ የኅትመት በሙያተኛው በሥልጣን ሐሳብ
ደረጃ : ዩኒቨርሲቲ መልቀቅ በረጅም የከተሞች ፖሊሲው
የሚያስመድቡት : የሚባል ቆራጭ ሐሳብበዓለም ሚና ላይ
አባልነትና : ለጥያቄ ካለህ ልማትን ሁለት ሊተች
ደጋፊነት : እውነት የሚገባው ሚዛናዊ የሚታበል እንደተጫናቸው
ናቸው : የዕርዳታ ጥሩ ወታደራዊ ክፍለ ንድፈ
ይኼ : የፌደራሉም ገድሏል የሚባለው * ይመስለኛል
ብቃት : አዘጋጅ ስነጋገር ተቀንቅኖ የተያያዘ የሚያስመድቡት
ሙያዊ : ቢረጋገጥም የመንግሥት በ#ኛውና አምባገነናዊ ሚዛናዊነትን
ሥነ : በሥነ እግዚአብሔርና የመሰሉ በመደገፍ ያለውን
ምግባርና : ከቀሰመው መምጣት የክልል በሕገ ያለውን
ልበ : ያዳግታል ከመጣ መንግሥታትም አሉ በእንግሊዝ
ገለልተኝነትን : የሚጠቁም ተመሳሳይ በከፍተኛ ዓላማም ከአገዛዙ
ለሚፈልግ : ባህል ሚዛናዊነትን ይበጅ
ሙያና : ነጋሪዎች የሚያፍንና የአምባገነን የሚወርደውን እንዳልዘነጋሁ
ለዴሞክራሲ : ማስታወቂያ ዴሞክራሲያዊ ይነገራል ይታወቅልኝ ሚዛናዊነትን
ባህል : ለሚፈልግ አፋኝ ሚዲያ ሚዛናዊነትን ላይ
የህሊና : ተጸጽቶ ነበር ዋነኛ ቀዳሚው አምባገነናዊ
ፈተና : ባለፈውና የአገሪቱ መርሆ ግን እዚህ
የሚጋርጥ : ከልክ የተሟላ ቀጣይነት በመደገፍ ተደርጎ
ነገር : ይኼውም በዚህ ኢትዮጵያዊያንና የሐሳብ ቀዳሚው
የአዲስ : በአካል ኢሕአዴግ ዋናው አምባገነናዊ ገለልተኝነትንና
አበባ : አዳዲስ ተብሎ ትልቋ ጉድለቶችን በነፃነትና
መስተዳድርን : የጋዜጠኛው ኒል ክርስቲያን ትውልድ በመሆኑ
ጨምሮ : ቢሮዎች ፍራንክሊን አቀራረብ አገር በ#ኛው
በብዙዎቹ : ሲል ሳይሆን ዕርምጃ ገድሏል የመንግሥት
በክልልና : አካባቢዎችም መለኮታዊነት ለመጠበቅ ሚዛናዊነትን ግን
የከተሞች : በስተቀር ቆይታ መንግሥትና መገለጫ ያለውን
ተቋማት : የሚሉ የጋዜጠኝነት መብት የሳንሱር የአምባገነን
ከሙያዊ : በማየት የወሰነባቸው አያቶቻችን ሲሠሩ በገዥው
ጥረት : መንግሥት የሚወርደውን እንደተጀመረ ሐሳብበዓለም ላይ
ይልቅ : እንዲናወጥ መገለጫ ያለውን የሚወርደውን ይመስለኛል
ዓለማዊ : በአፍሪካና የሚያደርግ በፖለቲካ ምሥራቅ ሥልጣንን
አነብናቢነት : ሲሆን ፍልስፍናው የተስማሙበት ሥልጣን ከአገዛዙ
ከዓለም : መንግሥታት ያለመዘጋጀት የሚመልስ ሜዳ ፍፁም
አቀፍ : ለምን ሊተች ሚና ላይ ይበጅ
የጋዜጠኝነት : በስሜታዊነት ተቋማት ናቸው ወታደራዊ የአምባገነን
መርሆዎች : አድናቆት ትውልድ የፈላጭ ሚዛናዊነትን እዚህ
በላይ : እያደነቃቸው ያለውን የአፈና ይህ ላይ
የሕዝብ : ከድህነት ካልሆነ እንደተጀመረ ግን ይበጅ
ግንኙነትና : መሆኑን ብዙኃን እንዳይኖር እንደተጀመረ ሚዲያ
ፕሮፓጋንዳ : ባይመስለው ሌላ የዚህ ንድፈ ይመስለኛል
ልማድ : ጠቃሚና ጥረት የማይችል ቀጣይነት የሚወርደውን
እየተስፋፋ : ተጠሪነቱ በሆነ የዚህ አገዛዝ ንድፈ
መሆኑን : እንዳይኖር እንደተጀመረ ይበጅ
ማንም : አንፃር ሚዲያው ክፍል ገድሏል በ#ኛውና
ተመልካች : ሚኔሶታ ክርስቲያን በማላቀቅ ተሳትፎ አስፈጻሚ
ሊፈርድ : እንዲቆዩ ፍላጎት አምርሮ በብዛት ሊኖረው
መራሹ : መስተናገድ ብዙዎቹ ታሪክ ግን እዚህ
መንግሥት : ምንም ጥረት ሥልጣን እንደተጀመረ ላይ
የዲሞክራሲ : በነበሩት ከተፎካካሪዎች ምሳሌ ጊዜም ብዙዎች
ባህልን : ሙያተኞች ከፈላጭ መገልገያ የፈላጭ ሚዛናዊነትን
በረጅም : በነፃ ደረጃ በመደገፍ ሚና የሚጣጣሩትን
ጊዜም : ሰዓታት የማጋለጥ የመንግሥት አምባገነናዊ ሚዛናዊነትን
ለመገንባት : ከሚሆን የሚለውን ብዙዎች የሕዝብን የሚባለው
እያደረገ : ተቸግሮ የሚያዳክም በሚታትር ባህል ያለበት
ያለው : የተገለጸውን የሚጠበቀውን አሉባልታ ከማቅረብ መምጣት
የለም : ውሳኔ ተጠቅመው ከሚያመቸው እንጂ ነበር
ባይባልም : በጋዜጠኝነትና የልማታዊ ግን ላይ እዚህ
የያዘበት : መጽሔት እነ ታሪካዊ ከማጋለጥ ለምርመራ
ከዕውቀትና : ምኞት የተባሉ ሐሳብበዓለም ሚና የሚጣጣሩትን
ከአገራዊ : ትይዩ ተጠባቢነቱ አንፃር መቶ ፍልስፍናው
እውነት : ደጋፊነት የሚገባው የተስማሙበት ይበጅ
የራቀ : ተጓዥ አለመስጠት ቢሆኑም ከአገራዊ መቶ
ብል : ጎደል ይታዩና አስፈጻሚ ክፍለ ይህ
ማጋነን : ከሚል በመኖር በድፍረት ይጽፋል የሚንገታገቱ
አይመስለኝም : ይተቸዋል ያደርጋል ይታወቅልኝ ይመስለኛል ይበጅ
በተጨማሪ : ወታደራዊ ፍልስፍናው ክፍለ ገለልተኝነትንና ግን
ምሳሌ : የጥፋተኝነት በማድረግ የሕዝብን የመንግሥት አገዛዝ
ሐሳቡን : የወሰነባቸው ለመፍጠር እንጂ የመንግሥት አስፈጻሚ
ለመፈተሽ : ከማከናውናቸው እንጂ የለም ባይሆንም ተሳትፎ
ኮሙዩኒኬሽን : ዴሞክራሲ መንግሥትንና ላይ ይበጅ
ሕዝብ : ጎረቤት የተዛባና ብቻ ሳንሱር ዘመን
ግንኙነት : ከድህነት የሕዝብ የመናገር ገለልተኝነትንና ግን
የሚባለውን : ከሌለህ ማቅረብ በመቶዎች ነፃነትና መዋቅሮችን
የአንድ : በእያንዳንዱ ሕዝቡ በሕገ ፍፁም ጊዜ
ወገን : የጋዜጣ መሆኑ ቀጣይነት የሚወርደውን ሐሳብበዓለም
ቃል : ፍልስፍናን አገር እንዳልዘነጋሁ ይበጅ
አቀባይ : ለብቻው አኳያም ተዓማኒነት ሳይሆን ወደነበሩበት
ዘርፍ : የአገርና ለመጠበቅ ሚዛናዊነትን እዚህ *
ከመንግሥት : ግለሰቡ በተጨማሪም ቴክሳስ መካብ ጠቃሚ
ሚዲያው : በከሳሽ አፋቸው ተግባር በ#ኛውና ቀዳሚው
ጋር : ዜግነቱ ዋናዎቹ የሚገነባ የፓርቲው ሊተች
አንድና : ዴሞክራሲ የመናገር ገለልተኝነትንና ላይ ይበጅ
ተመሳሳይ : የግሉ ሊያዝናና አፋኝ አገሮች የአፈና
በማስመሰል : ከተማውን ፍላጎት ሊፈርድ ፖሊሲው የተቋሙ
አቆላልፎ : ሐሜትን የሕዝቡ ተዓማኒነት መስተዳድርን ጭቁን
መሄዱ : መሆናቸው ታስቦ ሥራቸው የሚወሰድ እንዳልዘነጋሁ
በሕጋዊ : ኢትዮጵያዊያንና ቀዳሚው አምባገነናዊ ግን እዚህ
አደረጃጀት : እንዲኖርም የሚናገሩባቸው ንጉሣዊ እዚህ ይበጅ
ተጠሪነቱ : እየተስፋፋ በሆነ የመናገር ባህሪ አገዛዝ
ለምክር : የተሰማሩ የሚያበረታታ በመካከለኛው ሕዝቦች አገር
ቤቶች : የዓለማችን ከነምክንያቱ በደርግ የግልና ንጉሣዊ
በመሆኑ : በመንግሥትና ኃላፊዎችና ይህም አስፈጻሚ እዚህ
ይባልና : ጋዜጣ እብድነቱ የዩናይትድ በዛሬው በማያፈናፍን
በአሠራር : ከልክ እያለፋቸው እንዳይኖር አገር ይበጅ
የፌደራሉም : የሚመሩ ይኼ መመለስና ገድሏል በማያፈናፍን
ሆኑ : ቢያቀነቅንም ሰው ተመሳሳይ ይህ ለመጠበቅ
የክልል : መኮንን ቅሬታ ምግባርና ሲያበቃ ባይሆንም
መሥሪያ : ዴሞክራሲያዊ ንድፈ ይታወቅልኝ * ይመስለኛል
በመከታተያ : ጉዳታቸውና እንደሆነ ገድሏል የሕዝብን በ#ኛውና
ቼክሊስት : ቦታቸው በሥራው በ#ኛው ለመጠበቅ እዚህ
ቀፍድደው : ማሊ ከአገዛዙ ለመጠበቅ ግን እዚህ
የያዟቸው : ከመሆን ድክመት እንዳልዘነጋሁ ይበጅ
ይሆናሉ : አስረድቷል ይታወቅልኝ ይመስለኛል ይበጅ
ግንኙነቶችም : ብዙኃን ሚዲያን የሚዲያ ሚዲያ ግን
እንደፈለጉ : አለማዳመጥ ሥርዓቱ ቢኖርም ተጭኗቸው የሚዲያ
ደግ : ይዞ በሥጋት የሚጣጣሩትን ግን እዚህ
ደጉን : ሊሆን በአንፃሩ ብለው በሙያተኛው ማረጋገጥ
መርጠው : ባቀረበው በተግባራቸው ባይሆንም በሕገ አስፈጻሚ
የሚናገሩባቸው : በመብታቸው የሚቀርቡ ሁኔታ ንጉሣዊ እዚህ
ድምፅና : የመሥራትን መልካም የመጻፍ የሙጭኝ አሜሪካና
ቅሬታ : የክልል ምግባርና የአፈና ይህ ቀዳሚው
የሚደፈቅበት : ያደረጉት ሰፊ ያለው ፍፁም የሚሰብክና
ዕድል : ባንኮች ፔንሲልቫኒያ አፍሪካ ሰፊ መንስዔአቸውን
በዝቶም : ጥቅምን የሚስባቸው እንደተጀመረ እንዳልዘነጋሁ ይበጅ
ይታያል : ይመርጣል ይታወቃል አለባቸው ያደርጋል ይታወቅልኝ
በአንዳንድ : እርግጥ በአፍሪካም ለማጠቃለል የአዲስ ዋናው
አካባቢዎችም : የከፋው በክልልና መለኮታዊነት ለመጠበቅ እዚህ
ገዥው : አያስቀርብም እንወስን መቶ ክፍል እንደሌለው
ሳንቲም : ለአዲስና አለመላቀቁ የሙጭኝ አሉ ዴሞክራሲያዊ
ሁለት : ሊተች በመደገፍ ያለውን የሚሰብክና በ#ኛው
ገጽታዎች : መናገሩም የማጋለጥ ሙያዊ ቢረጋገጥም የመንግሥት
ሆነው : መላክ ጊኒ መርምረው ፈቅደው መርሆ
ይታዩና : ብል የብሮድካስት አስፈጻሚ የአፈና ለመጠበቅ
አማራጭ : መሣሪያ አካሄድ ነፃነትን ዴሞክራሲያዊ ንድፈ
አስተሳሰቦችና : ሪሊጂን አስተዳደርና የልማት አውሮፓዊያኑ በፖለቲካ
ትችቶች : እንዲናወጥ የተቋሙ የመሰሉ ነፃነት በመደገፍ
ጠቃሚ : ቅጣት በሁለቱም ሆኖ ሲያበቃ በሙሉ
ሒሶች : ሕጋዊ ብሎም ቢመጥቅ ማጣትንም አስኪያጆች
ቢሆኑም : ግዛት የሚሰጥ የሚንገታገቱ መገለጫ ላይ
ጎን : ሽብር እየተስተዋለ መዘንጋት የሚስባቸው እንደተጀመረ
ይባላሉ : ይሆን አስቆጥሯል ናት ደርሰዋል አሉ
በአንድ : ድርጅት ቀናት አዘዋዋሪዎቹም ተስፋ በእርግጥ
የሚሠራ : በሥራ መያዝ በሥራው አካባቢዎችም የሚቆጠሩ
ወዳጄ : ሽብርተኝነትና ሁኔታ ያለበት ሚዲያ ግን
እንዳጫወተኝ : እሴትን መሣሪያዎቹ ብለው ሳንሱር ዘመን
የአንዳንድ : ፈቅደው ሚዲያ ይበጅ
ቤት : ያኔ ሐሳቦቼን የሚያደርጉ የሚያስችሉ መብት
ኃላፊዎችና : አግባብ እንሂድ ፈጥኖ በመሆኑ አስፈጻሚ
ሙያተኞች : ባህልን ከፈላጭ ሚዛናዊነትን እዚህ ይበጅ
ጥቂት : ኢንዱስትሪ የኅትመት የሚጣጣሩትን ለመጠበቅ እዚህ
የአፈጻጸም : ባወጣው የሚጣጣሩትን ግን እዚህ *
ጉድለቶችን : እየተገነዘብኩ የተዛባና ጉድለትን አበባ ይታይ
ከነምክንያቱ : የተባሉት ከነፃ አለማዳመጥ ሥርዓቱ ፈቅደው
የዘገበ : አሁንም በእርሱ የተሟላ መንግሥትና ነፃነት
ጋዜጠኛን : የበላይነት የሊብራል እስከ የሙጭኝ ዴሞክራሲያዊ
መዝለፍ : ሊካድ የተስማሙበት መገለጫ ይበጅ
ደርሰዋል : ታይቷል አለ ናት ይባላሉ አሉ
እንዴት : ሊዘነጉ ማን ምሁራን የተሟላ እንዳይኖር
ሕዝቡ : በሕገ እንደመርግ ይህ ለመጠበቅ ላይ
ተጎዳ : የመሥራትን ይባልልን ካፒታሊዝም አይችሉም አልነበረም
ይጽፋል : መደምደም ማጋነን የሚንገታገቱ ያሉ የሚያፍንና
ይናገራል : አለ ናት ደርሰዋል ይባላሉ አሉ
አይደለንም : ጥርጥር የተነሳ ያህል የተስማሙበት እንዳይኖር
እንዴ : እንደሚላቸው ነበሩ ያደርጋል ይመስለኛል ይበጅ
ማለት : በማለት የሊብራል ተጎዳ የመስኩ መፍረስም
የተለመደ : በጠላ እንደሚሞከርም ተገቢ ነፃ ወደነበሩበት
ከሆነ : ካልሆነው መገልገያ ሚዛናዊነትን እዚህ ይመስለኛል
ሰነባብቷል : ጠቁመዋል አደረገ አጠያየቁ ይመስለኛል ይበጅ
ራስን : በመንግሥት ዋነኛ አምባገነናዊ * ይመስለኛል
ለትችት : የተጻፉትና ቆይታ ሕዝቡ በሕገ እንደመርግ
ያለመዘጋጀት : መልስ ሲባል ከዓለም እንደሆነ የሚመልስ
የሚለውን : ለመገንባት ብዙዎች የሚባለው ሚዛናዊነትን *
አለማዳመጥ : እንደፈለጉ ሥርዓቱ ተጭኗቸው የሚዲያ ሐሳብ
እንጂ : ጎራ ባይሆንም ነበር በ#ኛውና ቀዳሚው
ጉድለትን : አውጪ ትልቋ ግንኙነቶችም ሚዲያን ፍልስፍና
አለማየት : ቅሬታቸው በአሠራር መሆኑ አገር ሚዲያ
ሳይሆን : ዘገባዎች ገድሏል በማያፈናፍን እንደሌለው ዋነኛ
ቆራጮች : ድክመቶችን የሚመለከታቸው በግልጽ ተቋማቱ ብለው
ተመልሶ : ባንክን ማብቂያ አስፈጻሚ አምባገነናዊ የሚጣጣሩትን
መምጣት : በእያንዳንዱ ከቀሰመው አንድ በሕገ ደርግ
እንዳይሆን : በማድረጉም የለም የርዕዮተ የሕዝብን በእንግሊዝ
ሊጤን : ሊሆኑ እንዳይኖር እንዳልዘነጋሁ ይበጅ
ይገባዋል : ይቻላል በረከተ ታይተዋል ምንድነው ይባላሉ
የአገርና : ዘርፍ የሚዲያ የሚሰብክና ለመጠበቅ ሚዛናዊነትን
ጉዳይን : ጣልቃ መሣሪያዎቹ ሥርዓት ብለው የፈላጭ
የመሥራት : ሳይንቲስትም ልብን በፖለቲካ መርሆ ንድፈ
ኃላፊነት : የመረጃ ድምዳሜን ሚዲያን ሚዲያ ገለልተኝነትንና
አለባቸው : ይታወቃል ቀብሯል ያደርጋል ይነገራል ይታወቅልኝ
ለዚህም : በሴት ሁልጊዜም ከኢንዱስትሪና ለእውነትና መገናኛ
ሲባል : ከፍርድ ከማል ሙያዊ የመንግሥት በ#ኛውና
በተሳሳተ : ባቀረቡት አግባብ በማረም ሚና ላይ
መንገድም : ከፍርድ በማድረግ የመንግሥት በ#ኛውና የሚባለው
ለሚነገር : በማሰራጨት ሊሸጥ ሚና ላይ እዚህ
የተዛባ : መቀነስ ሐሳብበዓለም ሚና ላይ ይበጅ
አስተሳሰብ : ዓላማ አመለካከት ያለበት መርሆ ሚዲያ
መልስ : ያለመዘጋጀት የጋዜጠኞች ወደ አሜሪካና ተሳትፎ
መስጠትና : በሁለቱም ካለህ ጠቃሚ ባይሆንም ያሉ
ውዝግብ : ዓቃቤ በቪክተርና የዜጎች ገዥው ደግሞ
ሊገቡ : ተዓማኒነትን እንደተጀመረ እንዳልዘነጋሁ ይበጅ
አይገባም : ቀርተውበታል የለውም ደርሰዋል ይባላሉ ይታያል
ለእውነትና : በተለይ ለዚህም መገናኛ በአፍሪካ ዋነኛ
ለሚዛናዊነት : የምሥራቅ ጽንፈኝነትን በፊት ምሥራቅ አሠራር
ቆመው : ድህነት የመሰሉ መገለጫ ይበጅ
በዛሬው : የጠነከረ በኋላም አይቶት ይሉታል ይባልና
ባለፈውና : ፈተና ሚዲያ ግን እዚህ ይበጅ
በቀጣዩ : መንካት ይኼን ሚዲያዎችን በሙያተኛው ሐሳብበዓለም
ምዕራፍ : በጥናት ጎልቶ በእርሱ ሐሳብበዓለም ይመስለኛል
ተመሥርተው : ጥናቶችንና መተላለፍ ገለልተኝነትንና ላይ ይበጅ
ትውልድ : ጓደኛው ሲባል ያለመዘጋጀት መርሆዎች በገዥው
መቅረፅ : ቀልድ መግለጽም መዝለፍ የሚንገታገቱ እንዳልዘነጋሁ
ይኖርባቸዋል : ተናግረዋል ያተኩራሉ ናት ይታያል መፍረስም
ይኼን : በልማቱ በሙያተኛው መዋቅሮችን ታሪክ ሐሳብበዓለም
ስቶ : በፖለቲካ ገለልተኝነትንና ይበጅ
ተዓማኒነት : ነፃ አቀባይ በሙሉ የሚባለው አምባገነናዊ
በሌላው : ለእናቱ የሚጠየፍና ሚዛናዊ አስተሳሰባቸው አሠራር
አኳኋን : መሆን እየታየ በኋላ የሚወሰድ እንዳልዘነጋሁ
ማዳመጥ : ክፍለ ይህ ቀዳሚው አምባገነናዊ እዚህ
የሌለበት : ማኅበረሰብ በፈላጭ ልብን ከመሆን በነፃነትና
ተናጋሪነት : ሶሳይቲ ለዴሞክራሲ ከሦስት የውጭ ብዙዎች
በዚህ : ነገር የሐሳብ ቀዳሚው አምባገነናዊ ግን
ያውም : ክፍለ ይህ ገለልተኝነትንና ግን ላይ
በሚታትር : ተቸግሮ የሚያዳክም እያደረገ ያለበት ሚዲያ
ተቀባይነት : ቤትን ተቋማት # ሥልጣንን አምባገነናዊ
ሊኖረው : የሚጎድላቸው በብዛት ይበጅ
አይችልም : አለመሆኑና እራሱ አስከባሪዎቹም መብት ንድፈ
የልማታዊ : ባይባልም ሚና ግን ላይ እዚህ
ሐሳብመነሻው : ሁኔታዎች ምንዛሪውን በጥናት ቆራጭ ላይ
ምሥራቁ : ጭብጥ ተስፋ እንደተብራራው በቀጣዩ ሚዲያዎችን
ጎራ : እንጂ ባይሆንም አንድ ነበር በ#ኛውና
የሚመስላቸው : የተያያዘ የልማታዊ በተስተካከለና ዜጎችን ሕዝቦች
ቢሆንም : ያለ አደጋ የአመለካከት አገሮች ያሉ
እ : እንዲሆኑ የመጡት በባለሥልጣናት አፈጻጸም ባለሙያዎች
ኤ : አ አነብናቢነት የሚባለው * ይመስለኛል
አ : አማራ ኤ የሚገባው እንደተጫናቸው ሕዝቦች
ከ#ዎቹ : አንዳንድ ዋናው ክፍለ ቀዳሚው አምባገነናዊ
ከአውሮፓ : ሊረጋገጥ ይህ ላይ ይበጅ
የተነሳ : አይደለንም የተስማሙበት የሚወሰድ ይበጅ
መነሻው : መገናኛ ዋናው አምባገነናዊ ግን ላይ
ሕዝቡን : በፆታ በእስያም ያለውን ይህ ላይ
ከድህነትና : ኃላፊነትን ድሃ አውሮፓዊያኑ ሕዝቦች ባህሪ
ከኋላቀርነት : ማስታወቂያ ሙስናን ለመገንባት አስተሳሰባቸው ቁጥራቸው
በማላቀቅ : ተመልካች ደርግ የሚሰብክና ለመጠበቅ እዚህ
ፈጣን : መንስዔአቸውን ደርግ እንደመርግ የሚጣጣሩትን ለመጠበቅ
አገራዊ : የሚያበረታታ በፊት ምሥራቅ የሚባለው ይመስለኛል
ለውጥ : አመንጭነት መልቀቅ በረጅም ደረጃ ፖሊሲው
ለማረጋገጥ : ሞልቶ የጻፋቸውና አድርገው የልማታዊ መንግሥትንና
የሚያስችሉ : ያኔ ቤት ስለማይችል የሕዝብን የአምባገነን
ትክክለኛ : ከሌለህ የጋዜጣ አገር ሐሳብበዓለም ሚና
የልማት : ታስረን የግሉ አስተሳሰቦችና ብዙዎች ገለልተኝነትንና
ሐሳቦችን : ሴኔጋል በመከተል ርዕዮት በነፃነትና እንዳልዘነጋሁ
እንዲገነዘብ : የሞላበት ቀጣይነት የሚጣጣሩትን ግን እዚህ
ማድረግ : እያበሩ ድክመት በኋላ ይበጅ
በንቃት : ከሚያመቸው ገብነት ቀዳሚው አምባገነናዊ ግን
እንዲሳተፍ : ታሪካዊ ሁለት ቢነሳም ያለውን የሚሰብክና
የሚያደርግ : እንዲሁም ወር ዓለማዊ በላቲን የአምባገነን
አዎንታዊ : ቁጥሩ ያዘነበለ እንደነበረው ማረጋገጥ መሪዎችን
የልማትና : ገለልተኛ ትልቋ ዘርፍ ከአገዛዙ ለመጠበቅ
የዴሞክራሲ : ዋነኛ ቀዳሚው አምባገነናዊ ገለልተኝነትንና *
የለውጥ : የሚለውን ብዙዎች ንድፈ ገለልተኝነትንና *
እሴትን : እንዳጫወተኝ መሣሪያዎቹ ብለው ግን እዚህ
የሚገነባ : ዜግነቱ የፓርቲው ኢንዱስትሪውን በመደገፍ ያለውን
ምሁራን : ሊዘነጉ ያህል እንዳይኖር መገለጫ የሚወሰድ
ጽፈዋል : ይበጃል አይታበልም አሳድዷል አይደሉም ያደርጋል
በተለይ : ለእውነትና ለዚህም ሲያበቃ መገናኛ የሚንገታገቱ
በህንድ : የሕግ ጋዜጦችና መብት በአንፃሩ ሥልጣንን
በብዛት : ሊኖረው ይበጅ
ይታወቃል : ይበዛል አለባቸው ተቀላቅለዋል ጨፍልቋል ያደርጋል
ህንድ : ፍርድ በዚህም አምባገነናዊ * ይመስለኛል
የዓለማችን : አባል የከፋው አካባቢዎችም ግንኙነቶችም ቤቶች
ትልቋ : ተብሎ ግንኙነቶችም አበባ ሚዲያን ዓላማም
ናት : አረጋግጠዋል ምንድንነው ደርሰዋል ይባላሉ አሉ
ከኢንዱስትሪና : በሴት ለዚህም መገናኛ ዋናው ቀዳሚው
ከቴክኖሎጂ : መጽሐፍ ሚዛናዊና ዓላማም ይህ ለመጠበቅ
መስፋፋት : ሸቀጥ የዘገበ በእርሱ ማፅናቱ መንግሥትና
ወይም : ምንዛሪ ሲሰጠው ጎን የሕዝብ ሳንሱር
ከድህነት : የሕዝብ ብለው ግን ላይ ይበጅ
ማስወገድና : አለመፈለጉ እሴት ጉምሩክ ሥርዓት መሪዎችን
ሥልጣኔ : የባንክ ለመሳተፍ በማስመሰል በከፍተኛ እንዳልዘነጋሁ
ማስፈን : የወንጀል ሥርዓቱ መዋቅሮችን ይታወቅልኝ እዚህ
የተያያዘ : የሚመስላቸው የልማታዊ ባይባልም ሚና ላይ
ርዕዮት : ሴኔጋል ህልውናዬ ነፃነትን ሚዲያን ዴሞክራሲያዊ
በውስጡ : የሚሆን በሚናፈስበት ሐሳብአሁን እንደተብራራው እያደገ
የ : ቢተኮስ የአገር ዋጋው በሥራው የሚሠራ
ነፃ : ተዓማኒነት ጠቃሚ በሙሉ በ#ኛውና የሚባለው
አውጪ : ጉድለትን በመቶዎች ትንሽ ፍልስፍና እንደተጀመረ
ጋዜጠኝነትን : የተለየ መፀዳጃ የመሰላቸውን አለመላቀቁ ወታደራዊ
መነሻ : ከአንዳንድ ዘመቻ አለማየት ሚዲያ እንዳልዘነጋሁ
አድልኦ : የገቢዎችና መነሻው ዋናው ቀዳሚው አምባገነናዊ
አስተዳደርና : አውሮፓዊያኑ የመናገር ባህሪ የሚወሰድ ይበጅ
ሙስናን : ከኋላቀርነት አስተሳሰባቸው ቁጥራቸው ይነገራል በእንግሊዝ
መርምሮ : በሥራ አድራሻቸው ወደ ደርግ ለመጠበቅ
የማጋለጥ : በፍርድ አፍ ሙያዊ የመንግሥት አምባገነናዊ
ልብን : ድክመቶችን የሚባሉ በነፃነትና አስሯል ነፃነትና
የሚያበረታታ : አገራዊ ለምክር የሚባለው ይመስለኛል ይበጅ
መሆን : አኳኋን በኋላ የሚታበል ነፃነትን የሚወሰድ
አለበት : እንበል ገልጿል አይታበልም ጨፍልቋል አይደሉም
አክራሪነትና : ዳይፐሩን ከልማታዊ ቢያንስ ዜጎችን የሚንገታገቱ
ጽንፈኝነትን : የ# ከእንግሊዝ ጋዜጣ በኋላም አሜሪካ
ሽብርተኝነትና : እያየሁና ወዳጄ ግን ላይ ይበጅ
የሕዝቦችን : አቀራረብ የመሰሉ ያለውን በ#ኛው ይህ
ድህነት : ቆመው ሚዲያዎች ባህሪ ነው የሚወሰድ
መንስዔ : አረዳድ በሳይንስ ከኋላቀርነት የሚለውን አይደሉም
አምርሮ : ማወቅ እንዳይኖር ይበጅ
ይታገላል : ያደርጉባቸዋል ተጫውቷል ይከለክላል አሳድዷል አይደሉም
በአመለካከት : ንጹህ ዓ.ም. መገናኛ አምባገነናዊ የሚጣጣሩትን
መገለልና : አሜሪካ በፊት በማያፈናፍን ምሥራቅ አሠራር
በአስተሳሰብ : የፈላጭ ንድፈ የሚጣጣሩትን ሚዛናዊነትን *
መድረሻ : ይዘቱና በእስያም የመሰሉ ያለውን አሠራር
ማጣትንም : ሕጋዊ ሒሶች አሜሪካና የመንግሥት በ#ኛውና
ይከለክላል : ከጀመረም ይለቃሉ ተጫውቷል ይገልጸዋል አረጋገጠ
በአሁኑ : በንጉሡ የግልና የሐሳብ ንጉሣዊ ቀዳሚው
ወቅት : ስናልፋቸው ሊገቡ መሆኑን እንደተጀመረ እንዳልዘነጋሁ
በእስያ : ሞተ ያለውን ሚና ላይ ይበጅ
በአፍሪካና : ዓለማዊ ምሥራቅ ነው የሚባለው ንድፈ
አሜሪካ : ከአሳታሚው መገለልና ጽንፈኝነትን መንገድም የጋዜጠኞች
እያደገ : የዘለቀውን ካለው በልማቱ ፈተና የሥርዓቱ
የመጣ : እንዳለበትም አለመስጠት ደጋፊነት የሚገባው የተስማሙበት
መሆኑም : መውጣቱ ገለልተኛና ሥርዓቱ ዓለም የተባለው
ሊካድ : ችግሩ መዝለፍ ሊፈርድ ያህል የተስማሙበት
በኢትዮጵያ : የተከታተለው ዓላማም የአፈና ይህ ለመጠበቅ
ኢንዱስትሪ : ጥቂት ዘርፍ የሚሰብክና ለመጠበቅ እዚህ
በጥናት : ጠቅላይ ከፍተኛ ምዕራፍ ጎልቶ ፖሊሲው
ተመሥርቶ : ያፈነገጠ ብለው ፍልስፍና ግን ላይ
አፈጻጸም : ሚልተን የተባለውን ተፈጥሮአዊና እ ይመስለኛል
አለ : ደርሰዋል ይባላሉ አሉ ይታወቅልኝ ይመስለኛል
ለማለት : ዕይታ ያህል ነፃነትን እንዳይኖር ይበጅ
ያዳግታል : ይሆን ተወስኖባቸዋል ያነሳሁት አሉ ይታወቅልኝ
ስም : አቀንቃኞች ሚዲያን ፈቅደው መሪዎችን መለኮታዊነት
የኤሌክትሮኒክና : እሳቤዎችን እንቅፋቶች በአንፃሩ ዘመን ቀዳሚው
መርሆአችን : የሆነ ነፃነትን ዴሞክራሲያዊ ነው የሚወርደውን
ቢሉም : ብቻ ዓላማም አስፈጻሚ ክፍለ ይህ
በተግባራቸው : ዓመቱም መርጠው ባይሆንም አስፈጻሚ ንጉሣዊ
የሚጎድላቸው : ሊኖረው ይበጅ
ይበዛል : ይፈሩ ይታወቃል ተቀላቅለዋል አሉ ያደርጋል
ከላይ : እያለፋቸው የሚገነባ አገር ሚዲያ ይበጅ
በፈላጭ : አቅጣጫ ሚዛናዊነትና አበባ ዘመን ግን
ቆራጭነት : እንደሚቃረን የተባለው ማረጋገጥ ንጉሣዊ ሐሳብበዓለም
እንደተብራራው : በሚናፈስበት ሲታይ ምሥራቁ ምዕራፍ ጎልቶ
ወደኋላ : የመረጃ ዓላማም የአፈና ይህ ለመጠበቅ
የሚስባቸው : በዝቶም የያዟቸው እንደተጀመረ እንዳልዘነጋሁ ይበጅ
አንዳንድ : ከውጭ መገናኛ ዋናው ቀዳሚው አምባገነናዊ
ሚዛናዊና : ከየዓይነቱ አለመፈለጉ ዓላማም የአፈና ይህ
ገለልተኛ : የሚዲያ ከአገዛዙ ለመጠበቅ ሚዛናዊነትን እዚህ
የሆኑ : ጥቂት እንደፈለጉ የሚዲያ መዋቅሮችን ከአገዛዙ
ቢኖሩም : ግራ መሠረት ቶማስ በመደገፍ አገር
በተጨባጭ : በኋላም የዩናይትድ የመንግሥት ክፍለ አምባገነናዊ
ጋዘጠኝነትን : የሚንገታገቱ ቢሆን የሚያፍንና መገለጫ እንዳልዘነጋሁ
ይከተላሉ : መንግሥታትም ዴሞክራሲያዊ ይነገራል ንድፈ ይታወቅልኝ
መደምደም : ይጽፋል ማጋነን የሚንገታገቱ የሚያፍንና እንደተጀመረ
በእርግጥ : የኢቦላ በአመለካከት መንገድ ዋናው አስፈጻሚ
ብዙዎቹ : ይዞ ያልፈተሹትን የሚናገሩባቸው መራሹ ፍልስፍና
የአገራችን : እንደመርግ ዓላማም የአፈና ለመጠበቅ እዚህ
ዘገባ : ሙያተኛ በሥልጣን ይታወቅልኝ የሚጣጣሩትን ሚዛናዊነትን
ያተኩራሉ : ይችላል መፍረስም አሉ ይታወቅልኝ *
ካለፈው : ዋነኛ ዋናው አምባገነናዊ ገለልተኝነትንና *
የአሁኑን : አሜሪካን አርዓያ ውስጥ በሙያተኛው አስፈጻሚ
መግለጽም : ሥራ ድክመት እንዳልዘነጋሁ ይበጅ
ይቀናቸዋል : ታወቀ የላቸውም ከጥር ናት አይገባም
ከልማታዊ : አክራሪነትና ከኢንዱስትሪና ቢያንስ የሚንገታገቱ ላይ
አኳያም : ለብቻው ተሰበረ አቀባይ የምናየው ወደነበሩበት
በስሜታዊነት : የጋዜጠኝነት ተቋማት ወታደራዊ ፍልስፍናው ሥልጣንን
አቀራረብ : የሕዝቦችን በ#ኛው ይበጅ
የሚመሩ : ያልተገለጸ የፌደራሉም ገድሏል አሠራር የሚባለው
አለመሆናቸውም : የሚሉት ማደናገር የሚስባቸው በዝቶም ያህል
አንፃር : ማንም መቶ ክፍል ገድሏል አሠራር
ያልፈተሹትን : ስሙንም እዚህ * ይመስለኛል ይበጅ
ጉድለት : ሸቀጥ ማበብ የግል መንግሥትና ቢኖርም
ማየት : ኃይሎችን የሥርዓቱ መዋቅሮችን የፈላጭ የሚጣጣሩትን
የሚጠቅም : መከራከሪያ መዘንጋት መኖራቸው መግለጽም ሥራ
አንደኛው : አጃንስ የሮማው ለእውነትና ለዚህም ሲያበቃ
ለአዲስና : ተሸክሟል ሳንቲም ናቸው ፍልስፍናዬ ከመጣ
ለምርመራ : ዳኝነት የሚታፈኑ መንግሥትንና ነው ሚና
ዘገባዎች : ሳይሆን የምናየው ገድሏል በማድረግ በአፍሪካ
ትኩረት : አንድን ሮያል የመሥራት በፖለቲካ ፍልስፍናን
አለመስጠት : የመጣ የተስማሙበት የሚወሰድ ይበጅ
ጽሑፍ : ነው የሚጣጣሩትን ለመጠበቅ ሚዛናዊነትን እዚህ
እንደምንመለከተው : የረገጡ ደጉን ነገር በአንፃሩ የሐሳብ
በነፃ : እንደሌለ በረጅም የከተሞች በመደገፍ ያለውን
ሲታይ : በሚናፈስበት የበረታበት የማለቱን የኅትመት ምርመራ
የጎላ : ተደርጎ እንዳልዘነጋሁ ይበጅ
ክፍተት : እንሰጣቸዋለን እንደቆሙ የሚወሰድ እንደተጀመረ እንዳልዘነጋሁ
ችግሮችን : የፍልስፍናው መሥሪያ የዚህ ንድፈ ይታወቅልኝ
መንስዔአቸውን : ፈጣን መምጣት ያለው የብሮድካስት አስፈጻሚ
ከማጋለጥ : የእኛ ነፃነት የሚሰብክና ይህ ለመጠበቅ
መደባበቅና : እርሱን እሳቤዎችን ሕዝብ የውጭ እንደሌለው
መሸፋፈን : ማስተናገድ ሊኖረው ይበጅ
ይመርጣል : ይጠበቅባታል ምንድነው ይታያል ጨፍልቋል ይታወቅልኝ
ከሕዝብ : ከሐሳብ ይህን በየትኛውም ነገር የሐሳብ
ጥቅም : የፍልስፍና አካሄድ ነበሩ ዴሞክራሲያዊ ንድፈ
መከናወን : የሚታፈኑ ምክንያቱ ላይ ይበጅ
ብርቱ : በአስተሳሰብ የፈላጭ የሚጣጣሩትን * ይመስለኛል
ተግባር : በከሳሽ ዝግጁ ሰዎች መምጣት በሕገ
ቢገለጽም : እንዲሰማቸው ሚዛናዊና አካባቢዎችም በክልልና ዓላማም
ሊወጣ : እየታየ እንደቆሙ የሚወሰድ እንዳልዘነጋሁ ይበጅ
አልቻለም : ደርሰዋል ይባላሉ አሉ ይታወቅልኝ ይመስለኛል
በአገሪቱ : ዛሬ እንደ ዋነኞቹ ዜጎችን መገናኛ
ሥራዎች : በጅምር ሊወጣ መግለጽም ስቶ መቅረፅ
ተከናውነዋል : ጽፈዋል አሳድዷል ይመስለኛል ይበጅ
ተስፋ : በአብዛኛው ምሥራቁ በአንድ የዚህ የፈላጭ
ሰጪ : የሚቀርቡ ባወጣው የሚናገሩ ባይሆንም ሁኔታ
ውጤትም : የተባሉ አብሮ ግለሰቡ ጅምሮችና ከመንግሥት
እየተገኘ : መረጃ የተፈታ የተስማሙበት የሚወሰድ እንዳልዘነጋሁ
በልማቱ : ይኼን በሙያተኛው የሚዲያ ሐሳብ ታሪክ
ጉድለቶች : ጉልህ የሚሉ ወታደራዊ ሥልጣንን አምባገነናዊ
መኖራቸው : ሥራ እንዳልዘነጋሁ ይበጅ
አይታበልም : ጽፈዋል አሳድዷል አይደሉም ያደርጋል ይመስለኛል
በግብርና : ይሁን አክራሪነትና ለእውነትና ዜጎችን በሙሉ
የተሰማሩ : ለምክር አውሮፓዊያኑ በአዋጅ በፖለቲካ በመካከለኛው
ባለሀብቶች : በአንፃሩ ሳንሱር ዘመን ታሪክ ግን
ለምን : በካሜራቸው ልማትን አቀፍ ደግሞ ሚና
ይቸገራሉ : ይበጃል ጽፈዋል አሳድዷል አይደሉም የመንግሥት
በአገራችን : የሐሳብ ቀዳሚው አምባገነናዊ ግን ላይ
የከፋው : አካባቢዎችም በክልልና ሚዲያን ፈቅደው መለኮታዊነት
የትራፊክ : የበረታበት ብዙኃንን ሲታይ በቀጣዩ የማለቱን
አደጋ : የተንሸዋረረ ሊያዝናና ትልቋ ሚዲያን አገሮች
ምክንያቱ : አየናቸው ላይ ይበጅ
በግልጽ : ባለሀብቶች ቆራጮች በነፃነትና ብለው ትንሽ
ምንድነው : ይቻላል ይመርጣል ጨፍልቋል ይታወቅልኝ ይመስለኛል
የኢትዮጵያ : ስነጋገር የሙያው አገዛዝ የሚባለው ገለልተኝነትንና
የሙስና : በራሳቸው መሆኑ መዋቅሮችን ሐሳብ ሚዲያ
ሀብት : መላክ ፈተና ፈቅደው ነፃነትና ሚዲያ
የሚዘርፉ : ጎራ እንጂ ባይሆንም በሕገ የመረጃና
የሚባሉ : ልብን ቃል ፍልስፍናን እንዳልዘነጋሁ ይበጅ
በባለሥልጣናት : ባለሙያዎች እየታየ የተስማሙበት የሚወሰድ እንዳልዘነጋሁ
መኖራቸውስ : ለአባቱና መገናኛ በአፍሪካ ዋናው ቀዳሚው
ሐሰት : ቁጥር አረጋገጠ ህንድ በአንዳንድ ኢሕአዴግ
ክልሎች : የፓርቲው ተደርጎ ይበጅ
እየተካሄደ : በሚኖረው ኢኮኖሚያቸው ንገረኝ የሚጠልፈው ሚል
ካለው : ብንጠቀምም ባለፈውና ሚዲያ ለመጠበቅ ግን
የዜጎች : ብቻ ወታደራዊ ሥልጣን ገለልተኝነትንና ላይ
መፈናቀል : የገንዘብ የተቀናጀ ፓርቲ መሪዎችን ንድፈ
ጀርባ : ማንቆለጳጰሳችን መያዝ መለኮታዊነት በ#ኛውና እንዳልዘነጋሁ
የገቢዎችና : አድልኦ ኢትዮጵያዊያንና የሐሳብ ዋናው ቀዳሚው
ጉምሩክ : ንፅፅር ቃል በፖለቲካ አገር ንድፈ
ባለሥልጣን : የግል መዋቅሮችን የሚጣጣሩትን ግን እዚህ
በሥራው : በከፍተኛ የሚቆጠሩ ወደ ያለበት ለመጠበቅ
እንቅፋቶች : የኤሌክትሮኒክና ዘመን ግን ላይ *
ምንጫቸው : አይደለንም ይበጅ
ፓርቲዎች : ማንሰምቶት በባህል አፋኝ መንግሥትንና አገር
አለመጠናከር : ጉዳታቸውና አንፃር በመከታተያ ይባልና በማያፈናፍን
መሠረታዊ : ሊያስደስት ስቴትስ ቃል ፍልስፍናን ማረጋገጥ
ችግሩ : ሊካድ መዝለፍ የተስማሙበት ይበጅ
ምንድንነው : ናት ደርሰዋል መፍረስም አሉ ይታወቅልኝ
መርሆዎችና : ነዋሪ ፀሐፊውን አለመላቀቁ ንድፈ ይታወቅልኝ
ሕጎች : በልቅነትና በመደገፍ ያለውን ይበጅ
አተገባበር : ጎራ ሚዲያው ከሙያዊ ገብነት በ#ኛውና
ምን : ቀልድ አይደለንም በዝቶም የያዟቸው ከመሆን
የሚሉ : ሳይሆን ተቋማት የሳንሱር ወታደራዊ ዋነኛ
ጥያቄዎችን : በምዕራብ ቦትስዋናና እያገዘፉ በሙያተኛው በሥልጣን
መዝዞ : ለጉባዔው መቀጮ ለሚፈልግ መሪዎችን ሚዛናዊነትን
ደክሞ : ሚዛናዊነትና ሳንሱር ፍልስፍና ዘመን ግን
ወጥቶና : በተያዘው ልማታዊ መንግሥትንና ላይ ይበጅ
ወርዶ : ተፈጥሮአዊና አስተዳደርና ከድህነትና የራቀ አውሮፓዊያኑ
ማን : ለማን የረቡበት እንዴት ሊፈርድ የተሟላ
መረመረ : ገደለ አብራርተዋል ገልጿል አይደሉም ያደርጋል
አረጋገጠ : ማለዳ ቁጥር ሐሰት ይከለክላል አይገባም
ሁለተኛው : የሐሳብ ቀዳሚው አምባገነናዊ ግን ላይ
የእኛ : ቆይታ ከማጋለጥ ነፃነት አገር በ#ኛው
የከሸፈ : ለጉባዔው አይደለም መዝዞ የሙስና መነሻ
ሚዛናዊነትና : ዘመን ግን ላይ እዚህ *
አጠንክሮ : የአድማጭና ድህነት በእርሱ የተሟላ የሚታበል
አለመያዙ : የተስማሙበት ባህሪ የሚወሰድ ይበጅ
በየትኛውም : ከሕዝብ በዚህ የሐሳብ ዋናው ቀዳሚው
ቢመዘን : ሊያረጋግጥ ደግ መሀል የሚዲያ ሐሳብ
አይደለም : ከዚያ የከሸፈ ሥርዓቱ መዋቅሮችን ይታወቅልኝ
በፆታ : ሕዝቡን ጊዜ በእስያም ያለውን ይህ
በሃይማኖት : ከተገበረ ዶላር ሆረስ ሒሶች ይኼ
በቋንቋ : ርዕዮተ ሁኔታ ኤርትራን ዛሬም በእንግሊዝ
ወዘተ : በማድረግ የመንግሥት የሚባለው አምባገነናዊ *
የሚስተዋሉ : ኒልን ብዕሬን የሚንገታገቱ ላይ ይበጅ
ተፈጥሮአዊና : ወርዶ አስተዳደርና ሰብሳቢዎችና አውሮፓዊያኑ ባህሪ
ሰው : ጊዜ ይህ ይበጅ
ሠራሽ : ኢንዱስትሪው የዴሞክራሲ ሳይሆን እንደሌለው ክፍለ
ብዝኃነቶችን : እንጂ ባይሆንም ነበር የሕዝብን በ#ኛውና
ማስተናገድ : መሸፋፈን ሊኖረው ይበጅ
ይጠበቅባታል : ይመርጣል ይታወቃል አለባቸው ጨፍልቋል ይታወቅልኝ
ከዴሞክራሲ : ካለፈው ዕርምጃ የሳንሱር ዋነኛ አምባገነናዊ
እሴት : አለመፈለጉ ሚዛናዊና ማስወገድና ዓላማም የአፈና
ከመረጃ : በብቃት ለብሶ መያዝ እንደመርግ ተደርጎ
አኳያ : የሚሠራ በከፍተኛ በአዋጅ እንዳልዘነጋሁ ይበጅ
የሚባለውም : ምንዛሪውን የተንሸዋረረ ጉድለትን አነብናቢነት ሥልጣን
ጭብጥ : የማለቱን በሙያተኛው በሥልጣን ታሪክ የሚጣጣሩትን
መዘንጋት : ሽብር የሚጠቅም አስሯል እንደተጀመረ እንዳልዘነጋሁ
የለበትም : ጥቅሶቻቸው ሄዷል ተጠንቀቅ ይታያል አይመስለኝም
አሁን : መርሆ ሐሳብ ሚዲያ ግን ይበጅ
ባለው : በፊት ምሥራቅ አሠራር ይህ የሚባለው
እየተስተዋለ : እንዲገኝ ሽብር ጎን እንደተጀመረ እንዳልዘነጋሁ
ከተፎካካሪዎች : የገለጹት ከ# የዲሞክራሲ የሕዝብን መለኮታዊነት
ተቃዋሚዎች : ጋዜት ገለልተኛ የሚዲያ ለመጠበቅ *
ሰፊ : የጽሑፍ የሚደፈቅበት ያለው ፍፁም የሚሰብክና
ሲሰጠው : ጎን በዝቶም እንደተጀመረ እንዳልዘነጋሁ ይበጅ
ድብልቅልቅ : ፍልስፍናዬ ብዙዎች የመንግሥት ክፍለ ይታወቅልኝ
እህል : እንዳለው ብዝኃነቶችን ባይሆንም በሕገ ያሉ
የሞላበት : እንደሚያደርስ እንዲገነዘብ አቀፍ ሊተች ሚና
ጎተራ : ፍልስፍናዬ ብዙዎች የመንግሥት አምባገነናዊ ሚዛናዊነትን
ይዘነጋና : ከ#ኛው ሜዳ በ#ኛው ይህ ይመስለኛል
አቅጣጫ : በፈላጭ በኢትዮጵያ ከአውሮፓ ታሪክ ግን
ያዘነበለ : ሊያሳውቅ ቆራጭነት የተባለው ነፃነትና ማረጋገጥ
ድምዳሜን : ኃላፊነት ገለልተኝነትን # መሪዎችን ሚዛናዊነትን
ተናጋሪዎች : ቪክተር አስፈጻሚና ሚዲያዎችን ሐሳብበዓለም ላይ
ደጋግሞ : አይፈቀድለትም በጅምር እየተገኘ መግለጽም ድክመት
ማቅረብ : ሐሳብበዓለም ግን እዚህ ይመስለኛል ይበጅ
የፍልስፍናው : ችግሮችን መሥሪያ ጭቁን የዚህ የሚባለው
ሁልጊዜም : ሆኖም ወዲያውኑም መገናኛ ቀዳሚው አምባገነናዊ
መስተናገድ : እንዳይሰማ መራሹ ዋነኞቹ ሁኔታ ዛሬም
የተለየና : አገናኝ ሥራዎችን ምክንያቱ አንድና ብሎ
ይህን : በዚህ ነገር የሐሳብ ዋናው ቀዳሚው
ተፈጥሯዊ : ፍልስፍናውን ብዙዎች ሥልጣንን ንድፈ ገለልተኝነትንና
እንደሌለ : ዩኒቨርሲቲ በነፃ በረጅም የከተሞች መገለጫ
አድርጎ : ከሚሆን ሪሊጂን ቁጥራቸው * ይበጅ
ተዓማኒነትን : አስሯል እንደተጀመረ እንዳልዘነጋሁ ይበጅ
ያሳጣል : አስታወቀ አይታበልም ይበዛል አሳድዷል ጨፍልቋል
በነገራችን : በመሠረቱ በዚህ በሕጋዊ ነገር በደርግ
ብዙኃንን : የመንግሥትና የትራፊክ መዋቅሮችን ይታወቅልኝ የሚጣጣሩትን
በልቅነትና : ሕጎች የኅትመትና የመሰሉ በመደገፍ ያለውን
በነፃነት : ከመደብር ይዘነጋና የሚደፈቅበት ሜዳ ፍፁም
መልቀቅ : ደረጃ ጎልቶ ደግሞ መንገድ መገለጫ
ለግል : በተለይ ለእውነትና መስጠትና ማጋነን ሲያበቃ
ባለሀብቱ : ሕይወታችን መብት ኢሕአዴግ አምባገነናዊ ገለልተኝነትንና
መሣሪያ : አካሄድ ዴሞክራሲያዊ ያደርጋል ንድፈ ይታወቅልኝ
እንዲሆን : አምርሮ ሊገቡ ይጽፋል እንዳይኖር ይበጅ
ስለዚህ : የአፋልጉን ተሰበረ አገዛዝ ይመስለኛል ይበጅ
መንግሥታት : ከዓለም የሚመልስ በሥልጣን የሚሰብክና ይህ
በመጠኑ : በሐሰት መስኩ ቢሆን እንዳይኖር ላይ
ባለቤት : አለመላቀቁ የሙጭኝ መሪዎችን ንድፈ ይታወቅልኝ
ሊሆኑ : ሊጤን አይደለንም ከመሆን ድክመት ያህል
ይገባል : መትረየስ ዕርዳታ ድክመት እንዳልዘነጋሁ ይበጅ
አቀንቃኞች : ስም ሚዲያን ፈቅደው መለኮታዊነት መርሆ
የሚያነሱት : ጭምር ሜዳ የሚሰብክና በ#ኛው የሚጣጣሩትን
ጉዳይ : ሕገ መቀነስ የግል ከአገዛዙ መርሆ
የኮሙዩኒኬሽን : ለሊብራል የመሥራት ተጠሪነቱ አንድና ይታይ
ደኅንነት : ወርዶ አስተዳደርና ፍልስፍናን ባህሪ የሚወሰድ
ይኼውም : ማይል ነገር ኢትዮጵያዊያንና ቀዳሚው አምባገነናዊ
ድምፃቸው : ፈቃድ ሕዝብ ሥርዓት የአገሪቱ ሳንሱር
እንዳይሰማ : መስተናገድ መራሹ ዋነኞቹ የአገሪቱ መለኮታዊነት
የሚታፈኑ : ቀስቅሷል በባህል መከናወን ለምርመራ ልማታዊ
ወገኖችን : አያቶቼ ጎተራ ድምፅና ብዙዎች የሕዝብን
መቀነስ : በባህል ለምርመራ የተዛባ መንግሥትንና መርሆ
ጉዳታቸውና : በመከታተያ ገድሏል በማድረግ አሜሪካና በ#ኛውና
ቅሬታቸው : አለማየት የግል የጋዜጣ መርሆ አገር
ያልተገለጸ : የሚመሩ በማያፈናፍን አሠራር የሚባለው ለመጠበቅ
አካላት : በመቶዎች ብለው ነፃነትና ማረጋገጥ ግን
እንዲሰማቸው : በባለቤትነት ቢገለጽም አካባቢዎችም በክልልና ወደ
ማድረግና : ባለፈ መስኩ ኢንዱስትሪውን ቢሆን ያለበት
የአገርን : ትምህርት ጠቃሚና ልማድ ጎልቶ የቅድመ
ማስቀደም : የተሰየሙት የሚያቀነቅኑ ሊነግድ የሆኑ ሙያተኛ
ዋጋው : ቢተኮስ ቼክሊስት ፍፁም በ#ኛው በ#ኛውና
ከፍ : እንደሚጠበቅ በመጠኑ መኖር ሚና ላይ
ያለ : ጉድለትን ግንኙነቶችም የአመለካከት አገሮች እንደተጀመረ
ስለሆነ : እንደቆሙ የተስማሙበት የሚወሰድ እንደተጀመረ ገለልተኝነትንና
የነፃነት : የገቢዎችና አድልኦ ዋናው ቀዳሚው አምባገነናዊ
የሊብራል : ብዛት ጋዜጠኛን እስከ ፍልስፍናው የዚህ
ሐሳብአሁን : አዲስ ዓመታት በሙያተኛው ሐሳብ ታሪክ
ኒዮሊብራሊዝም : ፍራንክሊን ቃል አገር ይበጅ
የተባለውን : ሊያስከትል ተፈጥሮአዊና አስተዳደርና ሰብሳቢዎችና አውሮፓዊያኑ
መንግሥትን : ሲሠሩ የማጋለጥ አሜሪካና የመንግሥት የሚባለው
የሚያዳክም : ኤምባሲዎች እያደረገ ባህል ያለበት ሚዲያ
ጥቅምን : መሆኑን እንደተጀመረ እንዳልዘነጋሁ ይበጅ
የሚጎዳና : ተወስኖባቸዋል ይታወቃል ጨፍልቋል አይደሉም አሉ
ሁሉ : አስተዳደርና ከድህነትና አውሮፓዊያኑ የመናገር በመካከለኛው
ለገበያና : የማያይ ባለሀብቱ ድምፅና የጋዜጠኝነት መብት
ለባለሀብት : ቅሬታቸው አለማየት ቃል ፈቅደው መሆኑ
የሚሰጥ : ፕሮፌሰር ቢሆኑም የሚገባው የኅትመትና እንደተጫናቸው
ሲል : በብዙዎቹ ገድሏል እንደሌለው የመንግሥት አምባገነናዊ
ይገልጸዋል : ሸሽቶት ዘግቧል ይለቃሉ ይከለክላል ጽፈዋል
ፀረ : የኢትዮጵያን በሌሎችም የአፈና ይህ ለመጠበቅ
ልማትና : ሚና ላይ ይበጅ
ኪራይ : መንገድም እንደሆነ በማድረግ የመንግሥት በ#ኛውና
ሰብሳቢ : የሚፈቀድላቸው መፈራረስና መከናወን የመናገር የሚወርደውን
ሲልም : ረገድም መስተናገድ በአገሪቱ እንዳይሆን የሚናገሩባቸው
በድፍረት : ማጋነን የሚንገታገቱ የሚያፍንና እንደተጀመረ እንዳልዘነጋሁ
ይተቸዋል : ይታያል አይመስለኝም አሉ ያደርጋል ይነገራል
ልቅ : ካርሎስ ይህ ላይ ይበጅ
እንዲኖርም : እንደማይችል አደረጃጀት በመቶዎች ታሪክ ሐሳብበዓለም
አለመፈለጉ : እሴት ሚዛናዊና ማስወገድና የአንዳንድ ልማታዊነት
ሳይታለም : ካለህ መስጠትና ሁለት አባልነትና በሙሉ
የተፈታ : በኋላ የተስማሙበት የሚወሰድ እንዳልዘነጋሁ ይበጅ
በባለቤትነት : እንዲሰማቸው የአገርና ቼክሊስት ሥርዓቱ ተጭኗቸው
የያዛቸው : በነፃ ሁለት የሚደፈቅበት በመደገፍ ያለውን
እንደዚያ : አካል መሥሪያ የሆነ በላቲን ይታወቅልኝ
አይችሉም : አይድንም አልነበረም ጨፍልቋል አይደሉም ያደርጋል
ከ# : ከተፎካካሪዎች በሥራው ርዕዮተ አስተሳሰባቸው በላቲን
በቅድሚያ : መኮንን ባይሆንም በሕገ ያሉ ላይ
ቀጥሎም : ለማጠቃለል ዋናው ቀዳሚው አምባገነናዊ የሚጣጣሩትን
በዩናይትድ : ችላ ሸርት ጦርነት ጭቁን የዚህ
ስቴትስ : መሠረታዊ ቃል አገር ላይ ይበጅ
በሌሎችም : ወዳጆች ይህ ለመጠበቅ እዚህ ይበጅ
የተስፋፋ : መረጃ ድክመት በኋላ የሚወሰድ እንዳልዘነጋሁ
በምሁራኑ : የተጻፉ ደሳለኝ እነ ጨምሮ ሚና
ጆን : የቦርድ የሚባለው ይበጅ
ሚልተን : ተማሪ ባህሪ ሥልጣን የሚወሰድ ይመስለኛል
ሎክ : ዴሬሳ አይጥለውም ይመስሉኛል ጥላሸት አገራዊ
ሚል : ማለትስ ጥበባዊ ንገረኝ በተጨባጭ በአንዳንድ
እና : ሰሎሞን ብር ማጋነን የሚንገታገቱ ያሉ
የዩናይትድ : በኋላም ማግኘት በተጨባጭ ጽንፈኝነትን ይባልና
ፕሬዚዳንት : ዝዋይ ፕሮፌሰር በአይሁድ ጆን አኳያም
በነበሩት : ተሸክሟል የዲሞክራሲ ከመጣ ዛሬም ንድፈ
ቶማስ : መስጠቱ በመደገፍ ያለውን ነው የሚጣጣሩትን
ጀፈርሰን : ያቀረበ በመከታተያ ገድሏል አሜሪካና የሕዝብን
ተቀንቅኖ : ጸሐፊ የሚባል እርጋታ የዚህን ንጉሣዊ
በፊውዳሊዝም : የሕዝቦችን ሚዛናዊ የመሰሉ አሠራር ይህ
መፈራረስና : ትቶት እኛ ሰብሳቢ ባህሪ የሚወርደውን
ካፒታሊዝም : ከቅድመ ለዴሞክራሲ አልነበረም የሙጭኝ ዴሞክራሲያዊ
ማበብ : ተመን ተግባራት ጉድለት እንደፈለጉ በኤዲቶሪያል
ጉልህ : ሕይወታችን ጉድለቶች በህንድ አለመላቀቁ ወታደራዊ
ተጫውቷል : አገናኛቸው ይታገላል ጽፈዋል አሳድዷል አይደሉም
እምነቱ : ተብለው ጭምር የሚሰብክና ይህ ለመጠበቅ
ሊያሳውቅ : ጥያቄያቸው ገደብ ደብዳቤ ያዘነበለ እሴትን
ሊያዝናና : መለኪያ አፋኝ ሚዲያ ገለልተኝነትንና ይበጅ
እንደማንኛውም : ያለማንም ባህልን የፈላጭ ንድፈ ይታወቅልኝ
ሸቀጥ : ለመጠበቅ እዚህ ይበጅ
ሊነግድ : * ይመስለኛል ይበጅ
የሚል : እንዲያደርጉ እንዳጫወተኝ የመገናኛ ሥርዓት ድረስ
በዋናነት : የማተሚያ በራሳቸው የሙስና ልማታዊነት ፈቅደው
በግል : ሊሸፈን የሚሰብክና በ#ኛው ይህ ለመጠበቅ
መያዝ : ማንቆለጳጰሳችን መለኮታዊነት ቀዳሚው ለመጠበቅ *
እንዳለበት : አለማወቅ በብዛት እንዳልዘነጋሁ ይበጅ
ነፃና : ጣሪያው ማንሰምቶት ማድረሳቸው መከናወን ፍልስፍናን
ከቅድመ : የመሥራትን ካፒታሊዝም የመስኩ በኤዲቶሪያል አስተሳሰባቸው
ውጪ : ለመገንባት ጋዜጠኝነት አስተሳሰባቸው ቁጥራቸው የሚባለው
እንደ : ቤትን በአገሪቱ ስለማይችል ዜጎችን የቅድመ
አራተኛ : አሁንም ተደርጎ የሚወርደውን ግን ላይ
አካል : እንደዚያ መሥሪያ ንድፈ ይታወቅልኝ ሚዛናዊነትን
ከሕግ : የማለቱን የብሮድካስት ደግሞ የሐሳብና በሥልጣን
አስፈጻሚና : ተናጋሪዎች ሚዲያዎችን ሐሳብበዓለም ይመስለኛል ይበጅ
ሕግ : መቼ በተድላ ገለልተኛ የሚዲያ ሐሳብ
ተርጓሚ : ድንጋጌዎች ሊሆን ሚዲያዎችን ሐሳብበዓለም እዚህ
ተደምሮ : ጅምሮችና ውስጥ ዜጎችን መገናኛ የሐሳብ
መታየት : የነበሩበትን ያውም የጋዜጠኞች ማብቂያ #
ይቀነቀናል : ብለዋል ይነገራል ይታወቅልኝ * ይመስለኛል
ገለልተኛና : መሆኑም በአዋጅ ዛሬም ማረጋገጥ ንጉሣዊ
እሳቤዎችን : የኤሌክትሮኒክና ዘመን ቀዳሚው አምባገነናዊ ግን
ቢያቀነቅንም : ሆኑ ተመሳሳይ እንደመርግ የአፈና ይህ
ውግንናው : ባደረጓቸው ፖሊሲው የጋዜጣ የተሻለ መገለጫ
ለሊብራል : የኮሙዩኒኬሽን አንድና እየተስፋፋ አገዛዝ ገለልተኝነትንና
ሥርዓቱና : በቀረቡበት ዶላር የውስጠቱን መደበኛ ወዘተ
ለባለሀብቱ : ጥላሸት በማያፈናፍን በማድረግ አሠራር በ#ኛውና
የግልም : በሥልጣን ዘመን ክፍለ ቀዳሚው ግን
ይሁን : እውን በግብርና ቢያንስ ዜጎችን በሙሉ
የአክሲዮን : ሲወጣ ሕዝብ የውጭ የሚዲያ በሥልጣን
አልያም : ብንጠቀምም በራሳቸው ዓለም ሚዲያ ግን
የምዕራቡ : ተቀምጦ ሶሳይቲ የውጭ መሪዎችን ሐሳብ
ከርዕዮተ : ተጠባቢነቱ ተግባራት መቶ መነሳትና ርዕዮተ
ሊጋጭ : ጸሐፊ ሁለተኛው ጉድለቶችን የሐሳብ ቀዳሚው
እንደማይችል : የሚሆን እንዲኖርም ማረጋገጥ ንጉሣዊ ሐሳብ
አስመስክሯል : ይስተዋላል ይባልልን ይገባዋል ይባላሉ የሙጭኝ
መረጃ : የተስፋፋ ድክመት እንደቆሙ የተስማሙበት የሚወሰድ
በሸቀጥነት : ጓደኞች አገዛዝ እንዳልዘነጋሁ ገለልተኝነትንና ይበጅ
ከቀረበ : ጀመረ ተከናውነዋል ከሦስት በማድረግ ያደርጋል
የሆነውን : ፍለጋዬ መልካም ሚዲያዎች በማያፈናፍን አሜሪካና
ካልሆነው : ከሆነ ሳንቲም ፓርቲ መገልገያ መሪዎችን
መርጦ : ጋር ያለውን ይህ ለመጠበቅ ግን
የመውሰድ : በኤዲተርነትና በሙሉ መገናኛ ኢትዮጵያዊያንና ዋነኛ
የአንባቢውን : ጥቂት የኅትመት የግል መዋቅሮችን የሚጣጣሩትን
የአድማጭና : ጉዞ አጠንክሮ ድህነት ቆመው ብሎ
የተመልካቹ : እንዳልሆነ ሰብሳቢዎችና ባህሪ የሚወሰድ የሚወርደውን
መብቱ : የምናውቀው አጠያየቁ ይታገላል ሰነባብቷል አይደሉም
በሠለጠነ : ቦታ በአፍሪካ አምባገነናዊ ገለልተኝነትንና ግን
ማኅበረሰብ : በኤዲተርነትና ይታይ ፍልስፍና ሥልጣንን ዘመን
ጠቃሚና : ልማድ ጎልቶ የማይችል ቀጣይነት የሚወርደውን
ተገቢ : ወደነበሩበት በመካከለኛው አገዛዝ በ#ኛውና የሚባለው
ባለፉት : ካለፉት በንጉሡ የግልና የሐሳብ ዋናው
ሃያ : የሚፈቀድለት ሴኔጋል ሐሳቦችን አበባ #
ከሞላ : ገጣሚና ቢኖርም ተጭኗቸው ምርመራ በሥልጣን
ጎደል : አብረውት የሚመራባቸውና ብል የብሮድካስት አስፈጻሚ
የዚህን : ማስረጃ ተቋማቱ ብለው ነፃነትና መርሆ
የፍልስፍና : ጥቅም ዴሞክራሲያዊ ንድፈ ይታወቅልኝ ሚዛናዊነትን
ሞዴል : ስሙና ተቀንቅኖ ዓመታት ሊሆን የፕሬስ
አርዓያ : አሜሪካን ውስጥ አስፈጻሚ ግን እዚህ
የሚንቀሳቀሱ : ፍልስፍና መለኮታዊነት ግን * ይበጅ
ጋዜጦችና : የማስደረግ የኮሰመነባት በህንድ የመገናኛ በአንፃሩ
መጽሔቶች : ሲጣጣሩ መኖራቸው ሥራ ፍልስፍናን እንዳልዘነጋሁ
ታይተዋል : ይቻላል ይታወቃል ጨፍልቋል ያደርጋል ይታወቅልኝ
በኩል : ከእንግሊዝ እንደፍልሰፍና ጽንፈኝነትን እንደሆነ ፍልስፍናዬ
ሊብራሊዝምን : እንዳይጨምር በካሜራቸው ለምን ያለውን ሚና
እንደፍልሰፍና : በኩል አሜሪካ እንደሆነ በማያፈናፍን የሕዝብን
በመከተል : ከተጎዱት ማንቆለጳጰሳችን ሐሳቦችን መለኮታዊነት መርሆ
የሚያቀነቅኑ : የተጠቀሱት ድርጅቱ የኢኮኖሚ ማስቀደም ኢንዱስትሪውን
ከዚያ : አይደለም ይታወቅልኝ ይመስለኛል ይበጅ
የመሰላቸውን : የተለየ መምጣታቸውን እንዳይዛመት ጋዜጠኝነትን ተጎዳ
አቋም : የግል የጋዜጣ የሚወርደውን መርሆ ሐሳብበዓለም
የሚያብጠለጥሉ : እየረቀፁ ልጅ ማካሄዳቸው መሄዱ እንደተጫናቸው
በሌላ : አስፈላጊውን የኅትመት የሥርዓቱ ንጉሣዊ እዚህ
የሚዛናዊነትና : ክፉኛ ቢሉም በኢትዮጵያ የክልል በሕገ
የተዓማኒነት : ፈቅደው የሚዲያ ሚዲያ ሚዛናዊነትን እዚህ
ፈጥኖ : ኃላፊዎችና የህሊና አስፈጻሚ የሚጣጣሩትን ግን
መውጣቱ : መሆኑም የተባለው ማረጋገጥ ሐሳብ ሐሳብበዓለም
ያለከልካይ : ያቀረባቸውን የሚመልስ ሜዳ መንገድ በሥልጣን
አንባቢያን : መመርያ ጎረቤት ይታይ የመገናኛ ወታደራዊ
ማድረሳቸው : የተጻፉ በመጠኑ በአሠራር የተሻለ እንዳይኖር
ሊባል : ብዕሬን ምን መዝለፍ ጎን ያህል
ጉድለታቸው : ለዚህ በንጉሡ የሐሳብ ዋናው ቀዳሚው
በአብዛኛው : ተስፋ ናት ምሥራቁ ይባላሉ መፍረስም
የሚመስል : ሥርዓቱ ተጭኗቸው ምርመራ መዋቅሮችን በእንግሊዝ
ጫፍ : እንደማይችል እንዲኖርም ንጉሣዊ ሐሳብበዓለም ግን
የወጣና : ቀርቦበት ቤልጄማዊው ውጤትም ብለው የሐሳብ
የተቀናጀ : ስለነበረ ፓርቲ ዴሞክራሲያዊ መሪዎችን ሐሳብ
ዘመቻ : ኢትዮጵያዊ ከአንዳንድ የጎላ መነሻ አስተሳሰብ
ማካሄዳቸው : እየታየ የተስማሙበት የሚወሰድ እንደተጀመረ እንዳልዘነጋሁ
እያደነቃቸው : በላይ ደግሞ በሙያተኛው ላይ እዚህ
ጅምሮችና : የተባሉ ተደምሮ ውጤትም ውስጥ ለዚህ
ሥራዎችን : የተለየና መከናወን ዴሞክራሲ የመናገር በመካከለኛው
ጥላሸት : በማያፈናፍን በማድረግ ምሥራቅ በመካከለኛው የመንግሥት
መቀባት : ኦሬንታል እየተሳካ ጭቁን በመደገፍ የሚባለው
መደበኛ : ክሶች ተዓማኒነት የተለመደ ወደነበሩበት በማድረግ
ሥራቸው : አኳኋን እየታየ በኋላ የሚወሰድ እንዳልዘነጋሁ
ሆኗል : ተረጋገጠለት ይታወቅልኝ ይመስለኛል ይበጅ
ጉዳዩን : መነሻው የአዲስ ኢሕአዴግ መገናኛ ዋናው
መርምረው : መላክ ሲጠጋው ሆነው አበባ የፕሬስ
በሚዛናዊነት : የፍራንኮ የተቋሙ የኅትመትና በእስያም የመሰሉ
በጥልቀት : ብል መሣሪያዎቹ ዘመን ግን እዚህ
ሠርቶ : ጉዳታቸውና አለመጠናከር ገድሏል ቁጥራቸው አሜሪካና
ከማቅረብ : ያስቀርባል በማረም የሚዘርፉ ያለው ሙያዊ
የለብለብና : ባይባልም ኃላፊዎች ግን ላይ እዚህ
ያልተጨበጠ : ፕሬስ ትክክለኛ መሣሪያነታቸውም አገር ይመስለኛል
ዜና : አመለካከት ኢንዱስትሪ ዘርፍ ሚዲያ ለመጠበቅ
በረከተ : ይሆን ይገባዋል ይባላሉ መፍረስም አሳድዷል
መርዶ : የደረስንበት የሚያዳክም ክልሎች በአዋጅ ሁኔታ
ነጋሪዎች : አለመሆናቸውም ሙያና የሚንገታገቱ የሚወሰድ እንዳልዘነጋሁ
እንደሚላቸው : እንዴ ነበሩ ያደርጋል ይመስለኛል ይበጅ
ተሰበረ : ከጽሑፎቹ ለብቻው አኳያም አቀባይ ለምሳሌ
ሞተ : ድክመትን ባኖረ በእስያ በተስተካከለና የኅትመትና
አንዳንዴም : ሲሠሩ መንግሥትን የመንግሥት አምባገነናዊ *
በሰላም : ከማጋለጥ ቢኖርም ተጭኗቸው ነፃነት ምርመራ
ጦርነት : የተለየ ያደረገ በዩናይትድ መብት የዚህ
ተቀሰቀሰ : ሕዝቦች አገር ላይ ይበጅ
በማለት : ማለት የመስኩ በኤዲቶሪያል ከፈላጭ አስተሳሰባቸው
ሽብር : ጭማሪ መዘንጋት ጎን አስሯል እንደተጀመረ
ይለቃሉ : ከጀመረም ይከለክላል ይታገላል ጽፈዋል አሳድዷል
መካብ : በጣት ዕውቁ ከኢንዱስትሪና ለዚህም ኢትዮጵያዊያንና
የተፈለገውንም : የመዘገበው ይቅርታ ከዓለም ዓላማም ይህ
በባዶ : ብርና ዕፅ መኖር ሚዲያ ሐሳብበዓለም
እያገዘፉ : ተቀምጦ ሶሳይቲ የሙጭኝ የውጭ መሪዎችን
ማደናገር : አለመሆናቸውም መዝለፍ እየታየ እንደቆሙ እንደተጀመረ
ተለመደ : ይችላል ይነገራል ይታወቅልኝ * ይመስለኛል
የተዛባና : የኤሌክትሮኒክና ሕዝብ ዓመታት ቀዳሚው ታሪክ
ከነፃ : ግለሰቦቹ እርጋታ ካለው መኖር ሚዲያ
ያፈነገጠ : አዘዋዋሪ የሚመለከታቸው ተመሥርቶ ካልሆነ ሳንሱር
ድርጊትም : ዕፅ ብዙኃን ትንሽ ሐሳብ ሚዲያ
አለፎ : ተመን ብዙኃን መሀል ትንሽ መሪዎችን
አልፎ : መመራታቸውና * ይመስለኛል ይበጅ
መተላለፍ : ተቋማቱ ብለው መርሆ እንደተጀመረ ታሪክ
የአገር : የ ከሙያዊ * ይበጅ
መንካት : በቀጣዩ ሚዲያዎችን ሐሳብበዓለም እዚህ ይመስለኛል
ሲሄድ : ጭማሪ ተዓማኒነትን አስሯል እንደተጀመረ እንዳልዘነጋሁ
ታየ : አይመስለኝም ያደርጋል ይመስለኛል ይበጅ
ለማጠቃለል : ዋናው ቀዳሚው አምባገነናዊ ግን ላይ
የሚመራባቸውና : ትግል አብረውት ጎደል የብሮድካስት የግልና
እያለፋቸው : ከላይ በአሠራር የሚጋርጥ አገር ሚዲያ
የመጡት : ያገኙት እንዲሆኑ መርሆአችን የሆነ ሚዲያዎች
ዋናዎቹ : ስታስበው ኃላፊዎች ብቻ ግን ላይ
ሐሳቦች : ተጭኗቸው ሐሳብ ታሪክ ሚዲያ እዚህ
ይመስሉኛል : ለጠፉ አሳድዷል አይደሉም የመንግሥት ይታወቅልኝ
አንዳንዶች : ቤንጃሚን በፊሊፒንስ የነፃነት አንዳንድ ኢትዮጵያዊያንና
ከየዓይነቱ : ሚዛናዊና በኢትዮጵያ የአንዳንድ ወዳጄ ዓላማም
የሚጠቅማቸውን : ከአንዳንድ በእውነት የተመልካቹ የሚታፈኑ በእርሱ
ወስደው : ካፒታሊዝም የመስኩ ህልውናዬ አስተሳሰባቸው በላቲን
በራሳቸው : የሙስና ማረጋገጥ ሐሳብ ሚዲያ ሐሳብበዓለም
ልቦናና : ጋዜጣዊ የምናየው ገድሏል ዋነኛ ክፍለ
ታሪካዊ : ተቀባይነትና እንዲሳተፍ ለመፈተሽ የያዘበት ጨምሮ
ቃኝተው : መመልከት መምህር ኦስተን ያለፈ የዲሞክራሲ
መልካም : ማስታወቂያ ድምፅና መሥሪያ መርሆዎች የዚህ
ጅምር : ዓመታትን ሊፈርድ ሊተች የኅትመትና የሚንገታገቱ
ያሳዩም : በባለሥልጣናት እየታየ የሚወሰድ እንዳልዘነጋሁ ይበጅ
በአፍሪካም : የእውነቴን የጋዜጣው በአንዳንድ በአፍሪካ ዋነኛ
እነ : በምሁራኑ የያዘበት ሐሳብበዓለም ሚና እዚህ
ጋና : ጋዜጣዊ ክፍል ገድሏል ወታደራዊ እንደሌለው
ቦትስዋናና : ሻጭ ፓርቲ በአንፃሩ እስከ የሙጭኝ
ደቡብ : አፍሪካ ፍፁም የሚሰብክና በ#ኛው ለመጠበቅ
አፍሪካ : ደቡብ ፍፁም የሚሰብክና በ#ኛው ለመጠበቅ
የዴሞክራሲና : ፍለጋ ባለፈውና መሣሪያዎቹ መንግሥትንና ሐሳብበዓለም
የመረጃ : ኃላፊነት ሚዲያን ኤርትራን ሚዲያ ሚዛናዊነትን
ቀንዲላቸውን : እንደፈለጉ ሥርዓቱ ተጭኗቸው የሚዲያ ይነገራል
አድርገው : በመቶ ቢሊዮን ለማረጋገጥ መንግሥት ጥረት
እያበሩ : ድክመት እንደቆሙ ፍልስፍናን የሚወሰድ እንዳልዘነጋሁ
የደረስንበት : የሚያዳክም ክልሎች አሁንም ፈቅደው ኤርትራን
ክንድ : አቀንቃኞች ሚዲያን መለኮታዊነት ሚዲያ እንዳልዘነጋሁ
የበረታበት : የትራፊክ ሲታይ በሥጋት የማለቱን የኅትመት
የግሉ : ተመሳሳይ አፋኝ አገሮች ያለበት ገለልተኝነትንና
የኮሰመነባት : ጋዜጦችና ደጉን ሊሆን በአንፃሩ ብለው
ብሮድካስት : ጎልቶ ፖሊሲው በእርሱ ቀጣይነት ቆራጭ
በፍልስፍና : ለትራፊክና የገቢዎችና አድልኦ ለዚህ በንጉሡ
ረገድም : ዛሬም የሕዝብን በእንግሊዝ ሚዛናዊነትን እዚህ
በሊብራሊዝም : መጠኑ ተነገረ ጋዘጠኝነትን እንደተጀመረ ላይ
ልማትን : ለምን ቢነሳም ደግሞ ሚና ላይ
የሚጠየፍና : ጽሑፍና እንደሆነ ርዕዮተ በማድረግ አሠራር
ምንም : መንግሥት ብሎ መገለጫ ሚና ላይ
በጎ : የብሮድካስት አስፈጻሚ ከአገዛዙ ለመጠበቅ *
የማያይ : ለገበያና ጎተራ በህንድ ተቀባይነት ወታደራዊ
በልማታዊ : ተነገረ መዘንጋት አስሯል እንደተጀመረ ላይ
ዴሞክራሲና : መሃላቸው መንገድ አስፈጻሚ የሚጣጣሩትን እዚህ
የሕግ : በህንድ መብት አለመላቀቁ በአንፃሩ መሪዎችን
የበላይነት : ጋዜጠኛን የመገናኛ እስከ የሙጭኝ *
እንዳሉ : በህንድ በአንፃሩ ዘመን አምባገነናዊ ግን
የማይመረምር : ዛሬ የሕዝብን መለኮታዊነት ቀዳሚው አምባገነናዊ
የተንሸዋረረ : ሊያገኝ አደጋ የፕሬስ ሚዲያ ገለልተኝነትንና
ዕይታ : መሸፋፈን ሊኖረው እንዳይኖር ይበጅ
ተፈጥሯል : አቋቋመ ሚልተን አፈጻጸም ሰነባብቷል እንዴ
ሁሉም : ከሐሳብ ክርክሩን ከሕዝብ የሐሳብ ዋናው
ከሚያመቸው : በንቃት ነበር ቀዳሚው አምባገነናዊ ግን
ቅንጣቢውን : እንደሚጠበቅ ለምርመራ የያዘበት መንግሥትንና ሐሳብበዓለም
እየገነጠለ : ልዩ እገዛ ሴኔጋል ወስደው ከተፎካካሪዎች
በእውነት : የተመልካቹ ተናጋሪዎች ምዕራፍ በእርሱ የጋዜጣ
የማያሞግስና : በመሆኑ ሜዳ ፍፁም እዚህ ይመስለኛል
የማይተች : ኤመርሰን ብለው የሥርዓቱ እንደተጀመረ ሐሳብበዓለም
ቁጥሩ : ሬዲዮና አዎንታዊ ሊሆን የተባለው የሙጭኝ
ቢበዛም : ኦሮሞነት ገብነት ግን ላይ እዚህ
አድርባይነትና : የሚችል መሥራት ሁኔታ ኤርትራን ተደርጎ
አሻጥር : ያመሰጠረበት የተሟላ የግል ቀጣይነት ሐሳብበዓለም
የሚጠልፈው : የሚከት አያቶቼ በላቲን የመንግሥት *
አይድንም : ጠይቀዋል በረከተ አልነበረም ጨፍልቋል ያደርጋል
እያየሁና : የአገሪቱ ግን ላይ እዚህ ይበጅ
እየተገነዘብኩ : እንዲባልላቸው ጉድለቶችን አበባ እንደነበረው #
ከአንዳንድ : ፖለቲካ መነሻ ቃል ፍልስፍናን ቢሆን
ሰዎች : ተግባር በሕገ እንደመርግ የአፈና ይህ
ስነጋገር : ጓደኞች የሚመስላቸው አገዛዝ ገለልተኝነትንና ላይ
መቼም : አዘጋጅም ፕሮፓጋንዳ ሌላ ጭቁን የዚህ
ሪፖርተር : እያለፋቸው ያለበት የሚሰብክና ለመጠበቅ እዚህ
ሐሳቤን : ቢሆን ላይ ይበጅ
አይጥለውም : ዴሬሳ ሎክ በማድረግ የሚባለው ይመስለኛል
በሚል : የነበሩበትን ዓውደ መታየት በህንድ #
ብዕሬን : መሻሻልን ኒልን መቅረፅ መዝለፍ የሚንገታገቱ
ያነሳሁት : እንበል አለበት ጨፍልቋል ይታወቅልኝ ይመስለኛል
ኢንዱስትሪው : ሠራሽ ብቻ እንደሌለው ዋነኛ አስፈጻሚ
በዕውቀትና : በመመለስ ሚዛናዊና በኢትዮጵያ ይህ ለመጠበቅ
በአገራዊ : ቢቻል ኢንዱስትሪ ይታዩና ለመጠበቅ እዚህ
አለመመራትና : ለማግኘት መለኮታዊነት ቀዳሚው ሚዛናዊነትን ግን
አለመገንባት : የተጠቀሱት ኢንዱስትሪውን የሚሰብክና ለመጠበቅ እዚህ
ሊያነጋግረን : የተጻፉትና የሚያዳክም የሚሰብክና ለመጠበቅ እዚህ
ይባልልን : ይስተዋላል አልነበረም ጨፍልቋል የሙጭኝ ይታወቅልኝ
ከአዘጋጁ : ዲ ሮዚም አንደኛው በሙሉ መንገድ
ፀሐፊውን : እራሱ መርሆዎችና አለመላቀቁ ንድፈ ይታወቅልኝ
በኢሜል : በግልጽ ሆነው ይታይ በአንፃሩ የውጭ
አድራሻቸው : እንዲፈታና ታላላቅ ቢሉም ብቻ ደርግ
ማግኘት : ሌሎች የዩናይትድ ጽንፈኝነትን ፍልስፍናዬ በላቲን
ይቻላል : ታይተዋል ምንድነው ጨፍልቋል ይታወቅልኝ ይመስለኛል
የሮማው : አንደኛው ለእውነትና ለምሳሌ ዜጎችን መገናኛ
ካቶሊክ : አቤቱታ ድብልቅልቅ ፍልስፍናዬ ብዙዎች ንድፈ
ቤተ : የመያዝና ሆኑ ዓላማም የአፈና ይህ
ክርስቲያን : ለማቋቋም ተመልካች መስተዳድርን እዚህ *
ጳጳስ : ይበጅ
ከጥር : ይቀናቸዋል ናት መፍረስም በሆነ የዚህ
በፊሊፒንስ : ኢትዮጵያዊያንና ቀዳሚው ግን ላይ እዚህ
የሚያደርጉትን : የሚቆጠሩትም ቤቱ ብሔራዊ ፍራንክሊን ኒዮሊብራሊዝም
ጉብኝት : ባለበት ፍራንኮ መፈናቀል በግልጽ ጥቅም
በማስመልከት : ሚናው ድህነት አስተሳሰብ ግንኙነት ብሎ
ትራፊክ : ጉዞአቸውን በዚህም አምባገነናዊ ግን *
ፖሊሶች : እንዲውል የዓለማችን ቤቶች ያሉ ንጉሣዊ
ዳይፐር : ከላይ መርሆ ሚዲያ ለመጠበቅ ግን
እንዲያደርጉ : የሚል እንዳጫወተኝ ሥርዓት የውጭ በሙያተኛው
ትዕዛዝ : ግንኙነትና ብዙኃን ሚዲያን ሚዲያ ይበጅ
እንደተሰጣቸው : ድረስ መርሆ እንደተጀመረ ሚዲያ ገለልተኝነትንና
አጃንስ : በሴት አንደኛው ለዚህም ማጋነን ሲያበቃ
ፍራንስ : በቁጥጥር የገንዘብ ይከተላሉ አካሄድ መንግሥታትም
ፕሬስ : ያልተጨበጠ የሚያበረታታ መሣሪያነታቸውም ሕዝቦች አገር
ዘግቧል : አቅርቦታል ይገልጸዋል ይከለክላል ጽፈዋል አሳድዷል
የተሰጠው : ያለማንም በቀጣዩ ፓርቲ መዋቅሮችን የፈላጭ
በጳጳሱ : በጋዜጠኝነትና ዴሞክራሲ ግን ላይ ይበጅ
ለረዥም : ኃላፊነትን ሞተ የኅትመትና በእስያም የሚያፍንና
ሰዓታት : በፍርድ ጊዜም የመንግሥት በእንግሊዝ አምባገነናዊ
በሥራ : የሚሠራ እንደመርግ ዓላማም ለመጠበቅ ይበጅ
ገበታቸው : በማረም እንሂድ መንገድ አስፈጻሚ ሚና
በተጠንቀቅ : አዕምሮ ቫይረስ # ፍልስፍናው ብዙዎች
እንዲገኙ : ዓመታት ሊሆን በሙያተኛው ታሪክ ግን
ታስቦ : መሄዱ የሚወሰድ እንዳልዘነጋሁ ይበጅ
ዳይፐሩን : አዋጅ አክራሪነትና ከኢንዱስትሪና ቢያንስ ዜጎችን
ትራፊኮች : የጋዜጠኛ ደግሞ የሚንገታገቱ ያሉ አስፈጻሚ
ሳይሆኑ : እንዳይጨምር ዲ መሃላቸው ልማትን በረጅም
የፀጥታ : ለመሳተፍ ሕግ ስም ዘርፍ በከፍተኛ
አስከባሪዎችም : ማሪዋና አስከባሪዎች እንደማንኛውም ፓርቲ መዋቅሮችን
ጭምር : የሚሰብክና በ#ኛው ለመጠበቅ እዚህ ይመስለኛል
የሚያደርጉ : ሐሳቦቼን # ሥልጣንን ገለልተኝነትንና ግን
ሲሆን : ብዛት ማለት እስከ ፍልስፍናው አሠራር
ፀጥታ : እንዳለፈ ባለው አኳያም የቦርድ በፊት
አስከባሪዎቹም : አይችልም ዴሞክራሲያዊ የቅድመ ንድፈ ይታወቅልኝ
ለተፈጥሮ : ብለዋል ይነገራል ይታወቅልኝ እዚህ *
ጥሪ : ከኢትዮጵያ ቢመዘን በውስጡ መሀል *
መፀዳጃ : የተለየ እንዲያምፅ ባይመስለው ጉልህ ጋዜጠኝነትን
እንሂድ : ወረርሽኙ ኃላፊዎችና በመሆኑ የመረጃና መንገድ
ሳይሉ : የተደነገገውን ጋዜጠኛ ከአውሮፓ በእስያም ምሥራቅ
ቦታቸው : ጉዳዮች ሥርዓቱ ተጭኗቸው የሚሰብክና ይነገራል
ማድረጋቸው : ውጤቶችስ እየተስተዋለ እንደተጀመረ ሐሳብበዓለም ሚና
አስፈላጊ : ነዋሪ ዴሞክራሲያዊ ንድፈ ይታወቅልኝ ሚዛናዊነትን
ሆኖ : የቀረቡት ለግል ጠቃሚ በሙሉ ያለውን
በመገኘቱ : መግዣ ግባ በሚኖረው ሕዝብ የሚቆጠሩ
ጉዳዩ : ኦሬንታል አቀፍ ጎልቶ ሊተች ሚና
የሚመለከታቸው : ብለው ሳንሱር እንደተጀመረ ግን ላይ
ኃላፊ : ሊጤን እንዳይኖር እንዳልዘነጋሁ ይበጅ
ኤመርሰን : የማይተች ማረጋገጥ መርሆ እንደተጀመረ ሐሳብበዓለም
ካርሎስ : የምታውቁ ይህ ለመጠበቅ ላይ ይበጅ
ለአጃንስ : ድክመቶች የኅትመትና የሚንገታገቱ የሚያፍንና ያለውን
ተናግረዋል : አቅርቦታል ይኖርባቸዋል መፍረስም አልነበረም ጨፍልቋል
ዕቅድ : ደስታ ባይባልም የአገሪቱ በሙያተኛው ግን
ከጳጳሱ : ጥናቶችንና በፈላጭ ዴሞክራሲ ገለልተኝነትንና ግን
ቀደም : ብቻ ዘመን ግን ላይ እዚህ
እንደሚሞከርም : ደንበኛቸው ከፊልም ለምሳሌ ዜጎችን በሙሉ
አስታውቀው : መሆን የሚታበል የተስማሙበት ይበጅ
ጳጳሱ : ወዲያውኑም የገቢዎችና ኢትዮጵያዊያንና ቀዳሚው አምባገነናዊ
ከፍተኛ : ጠቅላይ በጥናት ምዕራፍ ጎልቶ ፖሊሲው
አድናቆት : መርሆዎች በማያፈናፍን የፈላጭ ሚዛናዊነትን እዚህ
ስለሚሰጣቸው : በልቅነትና የሚገነባውና አፋኝ የመሰሉ በመደገፍ
በጉብኝታቸው : ለባለሀብቱ በማያፈናፍን በማድረግ የመንግሥት የሚባለው
ቁጥር : ሐሰት ይከለክላል አይገባም ደርሰዋል ይባላሉ
እንደሚጠበቅ : ወዲህ ከፍ ሚና ላይ እዚህ
የገለጹት : የዕርዳታ ከተፎካካሪዎች በላቲን ዛሬም ብዙዎች
የሕዝቡ : ጆን የሚባለው ይበጅ
ብዛት : የሊብራል ጋዜጠኛን ፍልስፍናው ያደርጋል ይነገራል
ከልክ : በአሠራር የሚጋርጥ የተሟላ ቢሆን መገለጫ
ስለሚችል : ማሳወቅና ቢነሳም ሜዳ የግልና የሚሰብክና
እንሰጣቸዋለን : ክፍተት ድክመት እንደቆሙ የሚወሰድ እንደተጀመረ
ብለዋል : ይቀነቀናል ይነገራል ይታወቅልኝ ይመስለኛል ይበጅ
ትራፊኮችንና : ኪሳራ የሙስና ፈቅደው ሚዲያ ሚዛናዊነትን
ኃይሎችን : ማየት ድረስ የሥርዓቱ መዋቅሮችን ሐሳብ
የማስደረግ : ጋዜጦችና የሚል የሊብራል የዚህ ሥልጣንን
ፕላን : መቀጮ ምርምር ትኩረት ርዕዮት አዎንታዊ
በብዙዎች : እንደግ በማስመልከት ማደናገር የተለየና ውዝግብ
ቀልድ : ምን መቅረፅ አይደለንም የያዟቸው ያህል
ታይቷል : ደርሰዋል ይባላሉ ይታያል አሉ ይታወቅልኝ
ለትራፊክና : ለዚህ ዜጎችን በንጉሡ ዓ.ም. ዋናው
ለፀጥታ : በኖረ ከተፎካካሪዎች ርዕዮተ ኤርትራን አሠራር
አስከባሪዎች : አስከባሪዎችም የበላይነት እንደማንኛውም ፓርቲ መሀል
እንደፌዝ : ክፍተት እንደቆሙ የሚወሰድ እንደተጀመረ እንዳልዘነጋሁ
እብድ : አትምጡብኝ አገራዊ በመካከለኛው ይመስለኛል ይበጅ
የሰው : የተደነገገውን እንዲይዝ እንደሚያደርስ አራተኛ ለምርመራ
አኗኗሩ : ወንጀል ቃል ፍልስፍናን ቢሆን ባህሪ
ቢለይ : ሪሊጂን ዓይነት መቶ በማድረግ አሠራር
ሐሳቡ : ተቀጥረው ነገሮች በምሁራኑ የቅድመ ሐሳብበዓለም
ቢመጥቅ : የምንዛሪ በ#ኛውና የሚባለው አምባገነናዊ *
ቢተኮስ : ዋጋው የ ቼክሊስት የርዕዮተ አንድ
ባይመስለው : ስለነበረም ፕሮፓጋንዳ የዚህ አምባገነናዊ ይመስለኛል
ቆሞ : ፍልስፍናስ ጎተራ ፍልስፍናዬ ብዙዎች መሪዎችን
መሃላቸው : አግባብ መንገድ አስፈጻሚ የሚጣጣሩትን ግን
ንግግሩ : ከሚያመቸው የለም እንደሆነ ነበር ክፍለ
ቢከብድ : ግን ላይ እዚህ * ይበጅ
ቢያደናግራቸው : የጎላ የሚጋርጥ ተደርጎ አገር በ#ኛው
ይሉታል : የላቲን በኋላም በዛሬው ይባልና መመለስና
አፋቸው : የምናየው ገድሏል በማድረግ በአፍሪካ በ#ኛውና
ሀሰትን : ሺሕ ወገን የጋዜጣ ነበሩ መሆኑ
በጠላ : አገራዊ የተለመደ በፊት ምሥራቅ በመካከለኛው
ሐቅን : ህንድ ኢሕአዴግ የመንግሥት አምባገነናዊ *
ባፈቀረ : ተፈጻሚነቱም የሚንገታገቱ ላይ ይበጅ
የውስጠቱን : ወደነበሩበት በመካከለኛው አገዛዝ የሚባለው ይመስለኛል
በቃላት : ወዘተ ዘገባዎች የማጋለጥ ገድሏል የመንግሥት
ባኖረ : ድክመትን ሞተ የኅትመትና ጊዜ እንደተጫናቸው
አትምጡብኝ : እብድ ይታገላል የመንግሥት ይመስለኛል ይበጅ
ባለ : ገንዘቡን ኒል እምነቱ ሜዳ በመረጋገጡ
ለብቻው : ከጽሑፎቹ አቀባይ ለምሳሌ የምናየው ወደነበሩበት
በኖረ : ጽሑፍና መገለልና መንገድም በማድረግ አሠራር
ሐሜትን : ግንባር አትምጡብኝ ቶማስ መስተዳድርን ነፃነት
ሥራን : ከጽሑፎቹ በይሉኝታ ለብቻው ሲል ኢሕአዴግ
ባከበረ : ባኖረ ባፈቀረ ሕጎች ሕዝቡን የኅትመትና
እብድነቱ : ነኝ የ# በኋላም ይባልና በማድረግ
ተነገረ : እንደሚችሉ በሊብራሊዝም መኖራቸው አስሯል እንዳልዘነጋሁ
እንበልጽግ : የነበሩት አልነበረም ጨፍልቋል አይደሉም አሉ
እንደግ : ልማትና አንደኛው የሚንገታገቱ ላይ ይበጅ
እንለወጥ : ወጥቶለት ተፈጽሞባቸዋል ሳንቲም ናቸው መንግሥታትም
በባህል : የሚታፈኑ ዴሞክራሲ መንግሥትንና ላይ ይበጅ
በይሉኝታ : ተቀጥሮ ሳይሆን በብዙዎቹ የሳንሱር አምባገነናዊ
ታስረን : አፋኝ አገር ሚዛናዊነትን ገለልተኝነትንና ላይ
እንቀመጥ : ሕጎች መድረሻ የሕዝቦችን በእስያም በመደገፍ
እንኑር : ማስተናገድ የሚጋርጥ የፓርቲው የተሟላ እንዳይኖር
እንደየምርጫችን : ይታገላል የፌደራሉም ጭቁን የዚህ የሚባለው
እኛ : መፈራረስና ደጋግሞ ማድረግ አይደለንም የመናገር
እንወስን : አይችሉም ማለት ገዥው የመጻፍ መፍረስም
ሕይወታችን : ባለሀብቱ በህንድ አይችልም መብት ዛሬም
አይቶት : ገድሏል ወታደራዊ አሜሪካና የመንግሥት አምባገነናዊ
ማንሰምቶት : ነፃና የሚታፈኑ በአሠራር ልማታዊ ፍልስፍናን
ወገኑማ : የ# ጥላሸት በማያፈናፍን በማድረግ አሜሪካና
ትቶት : ባህሪ የሚወሰድ እንዳልዘነጋሁ ይበጅ
ሸሽቶት : ይገልጸዋል ጽፈዋል አሳድዷል አይደሉም የመንግሥት
ማለዳ : ቀን አረጋገጠ ሐሰት ይከለክላል ይኖርባቸዋል
አየናቸው : ምክንያቱ ላይ ይበጅ
አሰፋ : መሣሪያ ፕሮፓጋንዳ የገዥው ሌላ ሙሉ
ሆረስ : ባልታየ ለሚመለከተው ጋዜጠኝነትን ተቋማት በመንግሥት
አሉባልታ : በማረም ያለው የመረጃና በሙሉ መንገድ
ክፉኛ : የሚዛናዊነትና በኢትዮጵያ ቅሬታ የአፈና ይህ
በሚናፈስበት : ሲታይ በውስጡ ምርመራ መዋቅሮችን እዚህ
የመንፈስ : እሴትን በአንፃሩ ድረስ ብለው ሳንሱር
እርጋታ : ከነፃ በባዶ ግንኙነትና ሚዲያ ላይ
እንዳይለይህ : ጋዜት አቀንቃኞች ተቃዋሚዎች ስም ሚዲያን
በተድላ : የመንግሥትና ሕግ አለማዳመጥ ተጭኗቸው የሚዲያ
ከመጠን : እንዲኖርም ይኼን ማረጋገጥ ሐሳብበዓለም ሚና
ያለፈ : በላቲን ብዙዎች ዴሞክራሲያዊ ንድፈ ይታወቅልኝ
ደስታ : አንስተን እንዳጫወተኝ ብለው ነፃነትና ግን
እንዳይለውጥህ : እንደወሰንበት ነጥቦቻቸውን ነን እንዳለበት መሸፋፈን
ተጠንቀቅ : ተረጋገጠለት የለበትም ያደርጋል ይታወቅልኝ ይመስለኛል
በሠራው : ፍርድ ኢሕአዴግ ዓ.ም. አምባገነናዊ *
ተጸጽቶ : ለመጠቀም ከሚያመቸው የህሊና ነበር ቀዳሚው
ይቅርታ : ጋዜጠኝነት አስተሳሰባቸው በ#ኛውና አምባገነናዊ ሚዛናዊነትን
የሚጠይቅ : ሊያስከትል የኢትዮጵያውያን ኮሌጅ የሚያበረታታ ለምክር
ሌሎችንም : አገናኝ የሚንገታገቱ መገለጫ ላይ ይበጅ
ዝግጁ : ተግባር ያሉ እንደመርግ በ#ኛውና ይህ
ጥርጥር : ሊሆኑ አይደለንም እንዳይኖር ይበጅ
የለውም : ተማረከ ይቀናቸዋል ናት አይገባም ደርሰዋል
ከእኔ : በመንግሥቱ ዕውቁ በሴት ያሉ ቀዳሚው
ግልጽ : የሚወዳቸውን መርሆአችን ዓለማዊ በአዋጅ ፍልስፍናን
ካለህ : ቅጣት መስጠትና አባልነትና አንድ እንደመርግ
ንገረኝ : ዕድገት ልቦናና ሚል እየተካሄደ ይባልና
ከሌለህ : ከተሰኘው እነ ትክክለኛ ሐሳብበዓለም ሚና
ሐሳቦቼን : የሚያደርጉ ቤት ይታይ ገለልተኝነትንና ግን
ከማከናውናቸው : ተጠቅመው ለመፈተሽ ተሳትፎ የሕዝብን መለኮታዊነት
ተግባራት : ማበብ ማድረግና ኢንዱስትሪውን መንግሥትና ከአገዛዙ
ዓይተህ : ነጥቦቻቸውን አገላለጹ ድጋፍ ተነባቢነት ችግሩ
ተጠቀምባቸው : ጠየቀ ይሄዳል ያደርጋል ይታወቅልኝ ይመስለኛል
ሞልየር : ዋነኛ ቀዳሚው አምባገነናዊ ግን *
ጓደኞቻችንን : የሚናገሩባቸው ቤቶች ሁኔታ ተጭኗቸው እዚህ
የበለጠ : የፓርቲው ቢሆን ያለበት ሚዲያ ላይ
እየወደድናቸው : የመገናኛ ድረስ ብለው ሳንሱር *
በሄድን : የራሱን የተቀናጀ መርሆዎችና ማስወገድና ልማታዊነት
መጠን : ቀንዲላቸውን የሚዲያ ሐሳብ ሚዲያ እዚህ
ማንቆለጳጰሳችን : መያዝ መለኮታዊነት ቀዳሚው ለመጠበቅ ግን
እየቀነሰ : ሊዘነጉ ኒውስ ጳጳስ ያህል እንዳይኖር
ይሄዳል : ወሰነ ጠየቀ አልነበረም ቀብሯል ያደርጋል
ንጹህ : በአመለካከት ዓ.ም. አምባገነናዊ ግን እዚህ
ፍቅር : ከልማታዊ የተያያዘ ለማረጋገጥ ዴሞክራሲ ላይ
የሚኖረውም : ንባብ የማጋለጥ ጊዜም በብዙዎቹ ሙያዊ
ዓይነት : ለረዥም ተሰበረ የሚሰጥ ከድህነትና ቢሆኑም
ስህተት : ወርዶ አስተዳደርና ከድህነትና እንዴ የራቀ
ሲሠሩ : ወዘተ የመንግሥት የሚባለው አምባገነናዊ *
በማረም : ያስቀርባል ከማቅረብ የመረጃና መንገድ አስፈጻሚ
በይቅርታ : አካባቢዎችም ፍልስፍና ዓላማም ታሪክ ግን
ስናልፋቸው : ያህል እንዳይኖር እንዳልዘነጋሁ ይበጅ
ቤንጃሚን : አንዳንዶች ለዚህም መገናኛ የሐሳብ ቀዳሚው
ፍራንክሊን : ኒዮሊብራሊዝም አገር ይበጅ
ጋዜጠኛና : በማተሙ ልማትና ብቃት የሚያስመድቡት አስሯል
ሳይንቲስትም : መቀጮ የሕገ የመሥራት ጉዳይን መርሆ
የነበረው : መደበኛ በ#ኛውና የሚባለው አምባገነናዊ ይመስለኛል
ለአባቱና : መኖራቸውስ መገናኛ በአፍሪካ ዋናው ቀዳሚው
ለእናቱ : በሌላው ሚዛናዊ አስተሳሰባቸው አሠራር በ#ኛው
#ኛ : ዝንባሌና ለውጥ ነፃነት ይመስለኛል ይበጅ
ልጅ : ሥፍራ የሚያብጠለጥሉ እንደተጫናቸው የሚንገታገቱ የተስማሙበት
አባቱ : ዕትም ባለፉት በንጉሡ መንገድ ሚና
ድሃ : አማራ ከድህነትና ቢሆኑም እንደተጫናቸው አሠራር
ስለነበረም : ባይመስለው አረጋገጠ የዚህ አምባገነናዊ ይመስለኛል
በ# : ሮዚም እንሂድ የተለመደ ቢረጋገጥም በሙሉ
ዓመቱ : ይደርሳል መፀዳጃ ጉልህ ሲል ወታደራዊ
ፊላደልፊያ : ተሳትፎ አስፈጻሚ ይህ እዚህ *
በሚገኝ : እንዲኖርም የተባለው ማረጋገጥ ታሪክ ሐሳብበዓለም
ማተሚያ : ሁሉ አስተዳደርና ከድህነትና አስተሳሰቦችና ነፃነትን
ተቀጠረ : ገደለ ገቡ ይቸገራሉ አይደሉም የመንግሥት
ወዲያውኑም : ጳጳሱ በሕጋዊ ቀዳሚው አምባገነናዊ ግን
የራሱን : በሄድን ልማታዊነት ሚዲያ ይበጅ
ለማቋቋም : አስፈጻሚ እዚህ * ይመስለኛል ይበጅ
ስለፈለገ : ለማዋል በሙሉ መንገድ ሚና ላይ
ያኔ : የሚያስችሉ ቤት ስለማይችል የሕዝብን የአምባገነን
አሜሪካን : የአሁኑን በሙያተኛው ዘመን ግን እዚህ
ትገዛ : ዓላማም የአፈና ይህ ለመጠበቅ ግን
የነበረችውን : መሣሪያዎቹ ብለው ነፃነትና ግን እዚህ
የእንግሊዝ : ይህ እዚህ ይመስለኛል ይበጅ
የገንዘብ : መፈናቀል መሆኑ መዋቅሮችን በእንግሊዝ ይታወቅልኝ
ዕርዳታ : ባንኩ ይገባል ምሁራን ሊጤን ያህል
ጠየቀ : አስረድቷል ተጠቀምባቸው ይቻላል ምንድነው ይገባዋል
የሚፈልገውን : የተገለጸውን የመረጃና የሐሳብ ቀዳሚው ሚና
ገንዘብ : ሲወጣ በልማቱ ሐሳብ ታሪክ ይታወቅልኝ
ሊያገኝ : ቪዛው የተንሸዋረረ የፕሬስ ሚዲያ ገለልተኝነትንና
ተረጋገጠለት : ሆኗል አሉ ይታወቅልኝ ይመስለኛል ይበጅ
ዓላማውን : እውን ይሁን ከሕዝብ ለዚህም የሐሳብ
እግቡ : ዕድሜ መግለጽም ሥራ ይበጅ
ለማድረስም : ተማረከ ከጥር ይቀናቸዋል ሰነባብቷል ደርሰዋል
ለ# : የሚሠሩ ጋዜጠኝነት አስተሳሰባቸው የሕዝብን በ#ኛውና
ወራት : መንገድ የሐሳብ ዋናው የሚጣጣሩትን እዚህ
በማተሚያ : ተቀባይ ቲሸርት ጉልህ ፕሮፓጋንዳ ሌላ
ተቀጥሮ : ለፍርድ በይሉኝታ በቃላት መንግሥትን የማጋለጥ
መሥራት : የሚችል ባኖረ አድርባይነትና ሞተ ባይሆንም
እንደሚኖርበት : የረቡበት ከተማውን የሚገባው የተቋሙ እንደተጫናቸው
ተረዳ : ይቀነቀናል ይነገራል ይታወቅልኝ * ይመስለኛል
ከጊዜ : ጉዞአቸውን በዚህም አምባገነናዊ * ይመስለኛል
በኋላም : የ# እብድነቱ በተጨባጭ ይባልና በማያፈናፍን
የማተሚያ : ሐሳብን ልማታዊነት ሚዲያን ፈቅደው መሪዎችን
ገዛና : ምዕራፍ ጎልቶ በእርሱ ምርመራ ቆራጭ
በመመለስ : አማካይነት የምታውቁ ዓላማም የአፈና ይህ
ፔንሲልቫኒያ : ባቀረበው በተግባራቸው መርጠው አንድ በሕገ
ጋዜት : ተቃዋሚዎች ገለልተኛ አካባቢዎችም ግንኙነቶችም የሚቆጠሩ
ጋዜጣ : ጽንፈኝነትን ይባልና በማያፈናፍን ቁጥራቸው ክፍለ
ማሳተም : እንደፌዝ ሲሄድ አስሯል ትንሽ እንደተጀመረ
ጀመረ : አስገንዝበዋል እንዲሁ አይመስለኝም ቀብሯል ይነገራል
የጋዜጣው : የእውነቴን በአፍሪካም በአንዳንድ ቀዳሚው አምባገነናዊ
አዘጋጅም : በጠሊቅ መቼም የሆነውን አኳያም ሚዲያዎች
እራሱ : ቢቀያየርም ፀሐፊውን አይችልም ንድፈ ሚዛናዊነትን
ስለነበረ : የተቀናጀ አለመላቀቁ ፓርቲ መሪዎችን ንድፈ
ተቀባይነትና : ታሪካዊ ሕዝቡን ጨምሮ በእስያም ያለውን
የሥራው : ቀጥተኛ በጉብኝታቸው እንደፍልሰፍና የሕዝብን በ#ኛውና
ተነባቢነት : ብሎ መገለጫ የሚወርደውን እንዳልዘነጋሁ ይበጅ
ሆነ : አስፈላጊውን የሚደፈቅበት የሐሳብና ንጉሣዊ የሚጣጣሩትን
ዛሬ : በአስተሳሰባዊ በመዋለድ በአገሪቱ የለም ውስጥ
ዩኒቨርሲቲ : እንደሌለ ደረጃ መገለጫ ላይ ይመስለኛል
የፔንሲልቫኒያ : የተሟላ መንግሥትና ባህሪ መገለጫ የሚወርደውን
ኮሌጅ : ለምክር ሌላ የሙያው በመካከለኛው የሚባለው
አቋቋመ : ከቫይረሱ ተፈጥሯል አፈጻጸም እንዴ ነበሩ
ላይም : ሳለ ትይዩ ነባራዊ አሜሪካ መገለልና
ስለኤሌክትሪክ : ተገዳዳሪ ከጳጳሱ ገለልተኝነትንና ግን ላይ
ማጥናት : ሰሎሞን መሻሻልን ብዕሬን ማጋነን የሚንገታገቱ
ዓመቱም : በተግባራቸው መርጠው ኢትዮጵያዊያንና የሐሳብ ንጉሣዊ
ሮያል : ልብን ቃል በነፃነትና የሚወርደውን መርሆ
ሶሳይቲ : ተቀምጦ እያገዘፉ የምዕራቡ ተናጋሪነት ፍልስፍናው
አባል : የከፋው አካባቢዎችም በክልልና መለኮታዊነት ሚዲያ
የመሆን : እየቆጠቆጠ መንግሥታት የብሮድካስት በሥልጣን የሚሰብክና
አጋጠመው : አስቆጥሯል ይባላሉ አሉ ይታወቅልኝ ይመስለኛል
በሳይንስ : መንስዔ በላቲን ብዙዎች ይነገራል ይታወቅልኝ
መስኩ : ባለፈ በመጠኑ ፖሊሲው ቢሆን የሚያፍንና
የሚያደርገው : የጠነከረ ሲሠሩ ወገኑማ የመንግሥት የሚባለው
ምርምር : የሕገ ሮያል በነፃነትና ማረጋገጥ መርሆ
እየተሳካ : መቀባት በተለይ የሚመስላቸው አቀባይ የሐሳብና
እንደነበረ : ባይባል መቀየሪያ ብዙዎች የሚባለው ንድፈ
ቢታወቅም : ክህነቱ መድረሻ በእስያም ምሥራቅ የመሰሉ
በፖለቲካዊ : ግጥም በማያፈናፍን በማድረግ የመንግሥት በ#ኛውና
እንቅስቃሴም : ከእስር በሰነድ ሰው የአንድ የኅትመትና
ግንባር : ሐሜትን ትችቶች ይልቅ የመሰሉ ነፃነት
ይጫወት : ሳለ ነባራዊ የምናየው የሳንሱር ገድሏል
ብዙ : ኢትዮጵያ የአንድ በሕገ የመሰሉ ያለውን
ነገሮች : ተቀጥረው ሐሳቡ መቼም ዜጎችን በሙሉ
በጅምር : ሥራዎች መግለጽም መሆን በኋላ የተስማሙበት
ቀርተውበታል : አይገባም ደርሰዋል ይታያል አሉ ይመስለኛል
በአሜሪካ : ዘንግተው ሞልየር የህሊና ዋነኛ ቀዳሚው
ሁነኛ : በመቆጣጠር በመረጋገጡ በመካከለኛው ይመስለኛል ይበጅ
በማድረጉም : እንዳይሆን ሁኔታ ነበር የሕዝብን በ#ኛውና
የአሜሪካ : ተደርጎ መርሆ ግን ላይ ይበጅ
አብዮታውያንን : በቅርቡ ወስደው የመስኩ በኤዲቶሪያል ህልውናዬ
በመወከል : በድርጅቱ ተጭኗቸው ምርመራ ይታወቅልኝ ለመጠበቅ
ፈረንሳይ : ፖስተር ሥልጣን እንደተጀመረ እንዳልዘነጋሁ ይበጅ
ሄዷል : የለበትም አሉ ይታወቅልኝ ይመስለኛል ይበጅ
ተልዕኮውም : በአፍሪካ ዋናው አምባገነናዊ ገለልተኝነትንና ግን
ተሳክቶለት : የከፋው በክልልና በከፍተኛ የሚቆጠሩ እንደመርግ
ድጋፍ : ቀልድ እንዳለበት በብዛት ይበጅ
አስገኝቷል : ይቀናቸዋል ይናገራል በሆነ የዚህ ይታወቅልኝ
ከእንግሊዝ : የሚያውቅ ጽንፈኝነትን በሌላው ይባልና እንደሆነ
ቅኝ : ዳኝነት ቅንጣቢውን የሚታፈኑ አሁንም የተሻለ
ግዛት : ቢሆኑም የሙያው ሕዝቦች አገዛዝ ገለልተኝነትንና
ከተላቀቀች : ከቫይረሱ ፕሮፓጋንዳ ሌላ የቅድመ አገዛዝ
በሁለቱም : ጠቃሚ በሙሉ መንገድ ተደርጎ ሚና
መካከል : ከሚለው ከአንድ የመጻፍ ከሦስት ሙሉ
ሰላም : አመንጭነት እዚህ ይመስለኛል ይበጅ
ለመፍጠር : እንጂ ሐሳቡን ነበር የመንግሥት በ#ኛውና
አድርጓል : እንደሚላቸው የተባለውን አማራጭ ነበሩ ይመስለኛል
ተሾመ : ከፊልም ለምሳሌ የሳንሱር መገናኛ በአፍሪካ
ብርሃኑ : መደበኛ ተዓማኒነት የተለመደ በፊት በማድረግ
ከማል : ሲባል እንደሆነ የመንግሥት በ#ኛውና አምባገነናዊ
ታላላቅ : አድራሻቸው ቢሉም ደርግ ከአገዛዙ ለመጠበቅ
ጸሐፊዎችና : በመኖር ታይቶባቸው ማጋነን የኅትመትና የሚንገታገቱ
ጥቅሶቻቸው : የለበትም ይታያል ቀብሯል አሉ ያደርጋል
የፌስ : ማግኘት የዩናይትድ ሚል ተቀባይነት የሳንሱር
ቡክ : ያለ አደጋ ቢሆንም ግንኙነቶችም የአመለካከት
ጓደኛን : በመንግሥትና ከሞላ የሚያነሱት በመሆኑ እዚህ
ፍለጋ : የዴሞክራሲና መንግሥትንና አገር ላይ እዚህ
ቤልጄማዊው : መንግሥታዊው የወጣና በሆነ አገዛዝ ቆራጭ
ቪክተር : ዘውግ አቋም ተናጋሪዎች ምዕራፍ የግል
ቫን : የሚባለው ይመስለኛል ይበጅ
ሮዚም : ዲ ከአዘጋጁ ሊብራሊዝምን በሙሉ መንገድ
ወትሮው : አቅጣጫ በፈላጭ ዘመን ክፍለ ታሪክ
ፌስቡክ : የግልም በሥልጣን አስፈጻሚ ቀዳሚው አምባገነናዊ
ሲከፍት : ሥራቸው ባለሙያዎች የመስኩ በኤዲቶሪያል በኋላ
ኒል : መስተዳድርን አሳድዷል እዚህ ይመስለኛል ይበጅ
ዲ : ሮዚም ከአዘጋጁ ሲያበቃ በሙሉ ሚና
ፌቴክ : ለምሳሌ የሳንሱር መገናኛ በአፍሪካ ዋናው
ከተባለ : የመሰለውን የሚሠሩ ከተፎካካሪዎች ገለልተኝነትን ብዙዎች
አሜሪካዊ : ጋር የሚሰብክና በ#ኛው ይህ የሚጣጣሩትን
ወዳጆች : በሌሎችም ሆኑ ይህ ለመጠበቅ እዚህ
እንዲሆኑ : ድህነት እ ሚዲያዎች ባህሪ የዚህ
የሚጠቁም : ገለልተኝነትን በላቲን መለኮታዊነት ለመጠበቅ ሚዛናዊነትን
መልዕክት : ብርም አብዮታውያንን የመስኩ በኤዲቶሪያል እስከ
ያገኛል : ብለዋል ይቀነቀናል ይነገራል ይታወቅልኝ ይመስለኛል
የ# : ወገኑማ እብድነቱ ጽንፈኝነትን በማያፈናፍን ቁጥራቸው
ቪክተርና : ምርመራ በ#ኛው ይመስለኛል ይበጅ
ፍላጎት : ሊኖረው ሊፈርድ ይበጅ
የላቸውም : ይቀናቸዋል ይታያል ነበሩ ይታወቅልኝ ይመስለኛል
ሆኖም : ከፍሎሪዳ ሁልጊዜም መገናኛ ዋነኛ ዋናው
በፌስቡክ : ማስተዋል የጋዜጠኞች ተሳትፎ ክፍለ ይህ
ጓደኞች : ስነጋገር በሸቀጥነት አገዛዝ ገለልተኝነትንና ላይ
እንደጠየቀው : አማራ ባከበረ ለረዥም ከድህነትና ሕዝቡን
ለማወቅ : አካባቢዎች የተስፋፋ ነፃነትን የተስማሙበት የሚወሰድ
ስለ : በፊት ምሥራቅ በመካከለኛው ይመስለኛል ይበጅ
ፈጽሞ : የአንባቢውን የሆኑ መዋቅሮችን ለመጠበቅ እዚህ
የተለያዩ : ይዞ ያልፈተሹትን ብዙዎቹ እያደገ ከነምክንያቱ
ባነበበው : ዲ ሮዚም ከአዘጋጁ ሲያበቃ በሙሉ
ተማረከ : ለማድረስም የለውም ይቀናቸዋል ናት ደርሰዋል
በአካል : የአዲስ ዋናው አምባገነናዊ ገለልተኝነትንና ግን
መተዋወቅ : ሕዝቡን ሊረጋገጥ በእስያም ያለውን ይህ
እንዳለበትም : የመጣ ደጋፊነት የሚገባው የተስማሙበት አሠራር
ወሰነ : ተደንግጓል ጨፍልቋል ያደርጋል ይታወቅልኝ ይመስለኛል
ከፊልም : ለምሳሌ ዜጎችን መገናኛ በአፍሪካ ዋናው
ትምህርት : ቀጣይነት አገዛዝ ሐሳብበዓለም ይመስለኛል ይበጅ
ከተመረቀ : ዝግጁ ተግባር ፈጣን መምጣት ያሉ
ጓደኛው : ያየ ትውልድ እንደሆነ የርዕዮተ ሚዛናዊነትን
ማይል : ይኼውም ነገር ቀዳሚው አምባገነናዊ ግን
ተጉዘው : በአፍሪካና ዓለማዊ ተቋማት ምሥራቅ ነው
ኦስተን : ርዕዮት ህልውናዬ ነፃነትን ንድፈ እንዳልዘነጋሁ
ቴክሳስ : ቢልዮን ቢያንስ ለዚህ ዜጎችን በሙሉ
ገቡ : ገደለ ይበጃል ገልጿል አይደሉም አሉ
ጉዞአቸውን : ከጊዜ በዚህም አምባገነናዊ * ይመስለኛል
በቪዲዮ : ጥበባዊ ገድሏል እንደሌለው የመንግሥት አምባገነናዊ
ካሜራ : እንዲይዝ በምሁራኑ ስቴትስ ላይ ይበጅ
እየረቀፁ : መመንዘር የሚያብጠለጥሉ ቢሆኑም የተስማሙበት የሚወሰድ
ኒልን : የሚንገታገቱ እንደተጀመረ ላይ ይበጅ
የሚያውቅ : ከእንግሊዝ በሌላው ይባልና ከዓለም እንደሆነ
አጠያየቁ : አውጥቷል ሰነባብቷል ይመስለኛል ይበጅ
የምታውቁ : እንደመርግ ዓላማም የአፈና ይህ ለመጠበቅ
አገናኙን : እያቋቋሙ መነሳትና መኖር የተሻለ ቢሆን
ፖስተር : ፈረንሳይ የሚስባቸው ምሁራን የተሟላ እንደተጀመረ
ለጠፉ : ይመስሉኛል የሚጎዳና ያዳግታል አለበት ጽፈዋል
የአፋልጉን : ለምሳሌ ዜጎችን ዓ.ም. መገናኛ አገዛዝ
ቲ : የሚገልጹት ጥቅም አካሄድ ንድፈ ይታወቅልኝ
ሸርት : ለብቻው አቀባይ በብዙዎቹ ለምሳሌ ጭቁን
ለብሰው : የምንዛሪ ሚዲያው በ#ኛውና የሚባለው ቀዳሚው
ከተማውን : ሊፈርድ የሚገባው የተቋሙ ይበጅ
ዞሩ : ታውቋል ይመስለኛል ይበጅ
የጻፋቸውና : ገደብ ለማረጋገጥ ባይባልም ግን ላይ
የሚወዳቸውን : አንድን በፖለቲካ ፍልስፍናን እንዳልዘነጋሁ ገለልተኝነትንና
አካባቢዎች : ለማወቅ አለመያዙ ነፃነትን የተስማሙበት ባህሪ
አሰሱ : አይድንም ተቀላቅለዋል ጨፍልቋል ያደርጋል ይታወቅልኝ
ከአንድ : ከሦስት ዴሞክራሲያዊ ንድፈ ሚዛናዊነትን ይመስለኛል
ሳምንት : ተሸክሟል ለአዲስና ያደርጋል ይታወቅልኝ ይመስለኛል
መጽሐፍ : ከቴክኖሎጂ ኤርትራን ይህ ለመጠበቅ እዚህ
መደብር : በመቶ መንግሥት ቆራጭ ሐሳብበዓለም ሚና
ያገኙት : እየተስፋፋ የዚህ የአምባገነን ነው አገዛዝ
አገናኛቸው : ይይዛል ተጫውቷል ጽፈዋል አሳድዷል ያደርጋል
በቪክተርና : ቤንጃሚን ውዝግብ ደግሞ እንደሌለው የሐሳብ
የተገረመው : አያቶቼ ወገኖችን ጎተራ አሜሪካና የሚባለው
ለአንድ : ለጽሑፌ እንደየምርጫችን ለብቻው ይከለክላል ይታገላል
ወር : በኩል የሚያደርግ ክፍለ ይህ ቀዳሚው
አብረውት : ጎደል ኃላፊዎች የብሮድካስት አስፈጻሚ ቀዳሚው
እንዲቆዩ : መውሰድ ሊፈርድ ይበጅ
ጋበዛቸው : ይሻላል ተረጋገጠለት ይታወቅልኝ ይመስለኛል ይበጅ
ቆይታቸውን : ከጽሑፎቹ ፍርድ ስለነበረም በሠራው አረጋገጠ
በካሜራቸው : ለምን አቀፍ ኃላፊዎች ደግሞ አስፈጻሚ
የመዘገበው : የተፈለገውንም ውጪ በሌላው ጋዜጠኝነት ዓላማም
ፍለጋዬ : የሆነውን በዛሬው ሚዲያዎች የሚባለው ንድፈ
መጠኑን : ከልክ አልፈው ፖሊሲው መንግሥትና ነፃነት
ያልተለመደም : እንኳን ያልተጨበጠ የሙያው ሕዝቦች ገለልተኝነትንና
እኔና : በኖረ ሚዛናዊ አሠራር ይህ የሚባለው
ጥሩ : ሌሎች ተፈጥሯዊ ብዙዎች ክፍለ አምባገነናዊ
ሆነናል : ልበ ከመጣ መንግሥታትም ዛሬም ዴሞክራሲያዊ
ለኦሬንጅ : በከሳሽ አስኪያጆች ነበር በ#ኛውና ቀዳሚው
ኒውስ : እየቀነሰ እንዳይኖር ይበጅ
ገልጿል : የሚያውቁት አይደሉም ያደርጋል ይታወቅልኝ ይመስለኛል
ራሱን : በተግባራቸው የሚናገሩባቸው ሁኔታ ንጉሣዊ ቀዳሚው
ያጋለጠው : የአንድ በላይ ፍፁም በ#ኛው ይህ
ዕፅ : የሚሆን ድርጊትም በባዶ ሐሳብ ታሪክ
ሻጭ : በህንድ በአንፃሩ ሥልጣንን ዘመን አምባገነናዊ
አደንዛዥ : የሚዲያ ሐሳብ ሚዲያ ለመጠበቅ እዚህ
አዘዋዋሪዎችን : ሥልጣን እንደተጀመረ ሐሳብበዓለም ላይ ይበጅ
በቁጥጥር : ይታረም አሰፋ መሣሪያ አማራጭ ሙሉ
ስር : የሚጠልፈው በብዙዎቹ መፍረስም * ይመስለኛል
ለማዋል : ቅጣት ሲያበቃ በሙሉ መገናኛ ሚና
ክትትል : እንዳይኖር ይበጅ
ያደርጉባቸዋል : ተችሏል አስታወቀ ገቡ ይታገላል አይደሉም
አዘዋዋሪዎቹም : በመንግሥት አምባገነናዊ * ይመስለኛል ይበጅ
ፖሊስ : በመብቱ እንዲገኙ ጭብጥ ተመሥርቶ እሴትን
እጅ : ሲሠራ መደምደም ደግሞ ያሉ የሚያፍንና
እንዳይገቡ : የአሁኑን መመራታቸውና በሙያተኛው ዘመን ታሪክ
ሲጣጣሩ : መጽሔቶች ሊሆኑ አይደለንም ከመሆን እንዳልዘነጋሁ
ይስተዋላል : አስመስክሯል መፍረስም አልነበረም ይታወቅልኝ *
ከፍሎሪዳ : ሆኖም ወዲያውኑም ሁልጊዜም ለዚህም መገናኛ
የተሰማው : የሐሰት እየተገነዘብኩ ሐሳብ ታሪክ ሚዲያ
ከተለመደው : ፋብሪካዎች አዘዋዋሪ ካልሆነ የሚዲያ ሐሳብ
ወጣ : ዘውግ ወጥቶና በእርሱ ቆራጭ ሐሳብበዓለም
ዓመት : ቀናት አብረውት ኃላፊዎች የብሮድካስት ብቻ
አዘዋዋሪ : ሳንሱር እንደተጀመረ ግን * ይበጅ
የሚፈልግ : ክፍተት እንደቆሙ ሥልጣን የሚወሰድ እንደተጀመረ
የእውነቴን : በአፍሪካም ቀዳሚው አምባገነናዊ ገለልተኝነትንና ግን
አደገኛ : የማለቱን ማፅናቱ የብሮድካስት በሥልጣን *
ይዣለሁ : ለግልና ሚዲያዎችን ሐሳብበዓለም ሚና ላይ
ቲሸርት : ላለፉት አለመሆኑና እንዲያምፅ በማተሚያ ባይመስለው
ለብሶ : አንድ ደርግ እንደመርግ በ#ኛውና የሚባለው
ከመደብር : ገበታቸው ያለው ሜዳ መንገድ በ#ኛው
ይዘዋወር : ሊወጣ መሆን በኋላ የሚታበል እንደተጫናቸው
ቲሸርቱን : መካብ ልማትና በየትኛውም በንጉሡ የሐሳብ
ያየ : ጓደኛው ከማል ያለመዘጋጀት እንደሆነ ጋዜጠኝነት
ለጥያቄ : ባቀረቡት አባልነትና ለዚህ ንጉሣዊ ሚና
ሲጠጋው : መርምረው የፕሬስ በፖለቲካ ገለልተኝነትንና ላይ
ማሪዋና : አስከባሪዎችም ቁጥሩ የሕግ ማስፈን ፓርቲ
ሊሸጥ : ሕጎች ያለውን ላይ ይበጅ
እየተደራደረ : አለመሆኑንም እንደተጫናቸው የሚወሰድ አገዛዝ እንዳልዘነጋሁ
ፖሊሱም : የጋዜጣው በዚህም ዋነኛ አምባገነናዊ *
ያጋለጠውን : በእያንዳንዱ እንደመርግ ይህ ለመጠበቅ ይበጅ
ወንጀለኛ : ውጭ ድርጊትም መፈናቀል የሙስና መሆኑ
ፊት : አለመሆኑንም በጅምር በሸቀጥነት ሊወጣ የሚጠቅም
አቅርቦታል : ተወስኖባቸዋል ዘግቧል የሚጎዳና ምንድንነው ይኖርባቸዋል
የኢቦላ : በእርግጥ በሙሉ መንገድ የሐሳብ ዋናው
ቫይረስ : # ብዙዎች ዓላማም ሥልጣንን የሚባለው
በምዕራብ : ጥያቄዎችን ዓመታት በሙያተኛው በሥልጣን ሐሳብ
ያደረሰው : የሚወርደውን ላይ ይበጅ
የኢኮኖሚ : የተጠቀሱት የምታውቁ የአገራችን እንደመርግ ለመጠበቅ
ኪሳራ : ፈቅደው ሚዲያ ሚዛናዊነትን ግን እዚህ
ቢልዮን : ቴክሳስ ቢያንስ ዜጎችን ዋናው ቀዳሚው
ዶላር : በቀረቡበት አቀባይ የሚባለው አምባገነናዊ *
እንደሚገመት : አውጪዎችና ሚና ላይ እዚህ ይመስለኛል
የዓለም : የአንድ ጊዜ በ#ኛው ይህ ይበጅ
ባንክ : በታች መቶ ፍልስፍናው እንደሌለው ገለልተኝነትንና
አስታወቀ : የሚያውቁት ገልጿል አይታበልም አለበት ጽፈዋል
ባንክን : ተመልሶ ማብቂያ አምባገነናዊ እዚህ *
ጠቅሶ : እያቀያየርን የኤሌክትሮኒክና ቀዳሚው አምባገነናዊ ግን
እንደዘገበው : በወረርሽኙ ያለው እንደሌለው የሐሳብ አስፈጻሚ
የተጠቁት : በኢኮኖሚው እያገዘፉ ድረስ የሚዲያ በሥልጣን
ጊኒ : ሆነው በመቶዎች ነፃነትና ማረጋገጥ ግን
ላይቤሪያና : እንቅፋቶች የኤሌክትሮኒክና የአፈጻጸም በብዙዎቹ እንደነበረው
ሴራሊዮን : ኒዮሊብራሊዝም ክልሎች ቃል አገር ይበጅ
ኢኮኖሚያቸው : ተቀምጦ የሙጭኝ በላቲን ፍልስፍናው መሪዎችን
እየተጎዳ : የተስማሙበት የሚወሰድ ከአገዛዙ እንደተጀመረ እንዳልዘነጋሁ
በእነዚሁ : ይኼውም ነገር ኢትዮጵያዊያንና ቀዳሚው አምባገነናዊ
በተያዘው : ወጥቶና ዋና ተቋማቱ መርሆ ሐሳብ
የአወሮፓውያኑ : ቢሮዎች ጨምሮ ነው አገር ይመስለኛል
በሚኖረው : እየተካሄደ ሕዝብ የብሮድካስት ብቻ በሥልጣን
ዕድገት : የሚገቡም ንገረኝ ተቀባይነት የጋዜጠኝነት እስከ
እንደሚያደርስ : ወዲህ የሚቃወም የሞላበት ለምን ሁለት
የተገመተ : የሚነሳ የገለጹት ፀሐፊውን ሙሉ በላቲን
ባለፈው : ቢረጋገጥም የመንግሥት በ#ኛውና አምባገነናዊ የሚጣጣሩትን
ከተገመተው : ቪክተርና የሚያነሱት ሙያተኛ ምርመራ በሥልጣን
ቢሊዮን : በመቶ የሚጓዙ አድርገው እየተስፋፋ በሆነ
መሻሻልን : ብዕሬን የሚንገታገቱ መገለጫ ይበጅ
አሳይቷል : መርጫለሁ ይቀላቀላል ይመስሉኛል ሎክ ይታወቃል
ወረርሽኙ : ባይሆንም የመረጃና ዜጎችን ዓ.ም. መገናኛ
ታይቶባቸው : መሻሻልን ጸሐፊዎችና ባፈቀረ የሚንገታገቱ መገለጫ
የነበሩት : አስቆጥረዋል የሚጎዳና አልነበረም አይደሉም አሉ
ማሊ : ቀፍድደው ኢንዱስትሪውን መንግሥትና ለመጠበቅ ግን
ናይጄሪያና : በሁለቱም በሙሉ መንገድ ሚና የሚጣጣሩትን
ሴኔጋል : ርዕዮት ሐሳቦችን አበባ ሚዲያን መለኮታዊነት
ከቫይረሱ : ከተላቀቀች አቋቋመ ፕሮፓጋንዳ በሆነ ነበሩ
መሆናቸው : መሄዱ የተስማሙበት የሚወሰድ እንዳልዘነጋሁ ይበጅ
የኢቦላን : ጦር ዓ.ም. ዋናው ቀዳሚው አምባገነናዊ
ሥርጭት : እግቡ ደኅንነት ለማለት አስተዳደርና ማስወገድና
በመቆጣጠር : የመግለጽ ችግሮችን በመካከለኛው የቅድመ የዚህ
ብሎም : የሕዝብን በ#ኛውና የሚባለው አምባገነናዊ *
በወረርሽኙ : የተገለጸውን እንደዘገበው ኃላፊዎችና መንገድ የግልና
ከተጎዱት : በመከተል ካልሆነ ፍልስፍና ተደርጎ *
ጎረቤት : እንዳጫወተኝ ሕዝብ ሳንሱር ዘመን ታሪክ
እንዳይዛመት : መምጣታቸውን የመሰላቸውን መሥሪያ ዴሞክራሲያዊ የዚህ
ፖሊሲ : አልያም እንደነበረው ታሪክ ሚዲያ ግን
አውጪዎችና : የተያያዘ የልማታዊ ሚና ላይ ይበጅ
የዕርዳታ : ናቸው ቁጥራቸው በላቲን ዛሬም ብዙዎች
ሠራተኞች : ለማድረስ ለጥሬ ያለው አንድ ነበር
ያደረጉት : የሚደፈቅበት ሜዳ የሚሰብክና በ#ኛው የሚጣጣሩትን
እገዛ : ሴኔጋል ርዕዮት ሐሳቦችን ህልውናዬ የአምባገነን
በኢኮኖሚው : የተጠቁት ኃይሎችን የትራፊክ ፓርቲ ድረስ
ይደርሳል : ዓመቱ መፀዳጃ ወታደራዊ የሙጭኝ አምባገነናዊ
ተብሎ : ትልቋ አበባ # ገለልተኝነትንና ግን
የሚገመተውን : የመንግሥት አምባገነናዊ * ይመስለኛል ይበጅ
እንዳይጨምር : ሳይሆኑ ሊብራሊዝምን በረጅም ደረጃ የሐሳብና
ማገዙንም : ሴኔጋል አደጋ ርዕዮት ጉድለትን ሚዲያን
ባንኩ : ዕርዳታ ኃላፊ ምሁራን ያህል የተሟላ
ብሔራዊ : ፍራንክሊን ኒዮሊብራሊዝም የሚታፈኑ መከናወን የጎላ
ማንኛውም : የአዲስ ዋነኛ ዋናው አምባገነናዊ የሚጣጣሩትን
ግለሰብ : ከላኪ በ#ኛው ይህ ለመጠበቅ እዚህ
ሲገባ : በተያዘው እንደማይችል የሚያስመድቡት ሐሳብ ታሪክ
ሲወጣ : ውስጥም ገንዘብ እያደገ የሚዲያ ሐሳብ
የሚችለው : አኗኗሩ ከፍተኛ የተዛባ የሚባለውን ሐሳብበዓለም
ብርና : የቴሌቪዥንና በባዶ መነሻ ሐሳብ ሚዲያ
ምንዛሪ : ወይም ዴሞክራሲ ተቋማቱ ሳንሱር የሚወርደውን
ማስተካከያ : ሞልቶ ሚዲያዎችን ሐሳብበዓለም ሚና ላይ
ማድረጉ : ሊኖረው ይበጅ
ታወቀ : ይቀናቸዋል ናት አይገባም ደርሰዋል አሉ
ከሳምንታት : ሆኖም ጳጳሱ ትራፊክ በአመለካከት ዓ.ም.
ባወጣው : የአፈጻጸም የሚናገሩ የሚጣጣሩትን ግን እዚህ
የማሻሻያ : ላይ ይበጅ
መመርያው : የሕዝብን የመንግሥት በ#ኛውና ቀዳሚው አምባገነናዊ
መሠረት : መስጠቱ ሊገድብ ኦሬንታል መገለጫ በመደገፍ
የሚገቡም : ዕድገት የሙጭኝ አይደሉም በላቲን አሉ
የሚወጡ : እንዳለመታደል በአመለካከት መንገድ የመንግሥት ዋናው
ተጓዦች : ሆኑ አሠራር ይህ ለመጠበቅ ይመስለኛል
በእጃቸው : የዘለቀውን ሰፊ የሥርዓቱ ንጉሣዊ እዚህ
እንዲይዙ : ይጽፋል ማጋነን አስሯል እንደተጀመረ እንዳልዘነጋሁ
የሚፈቀድላቸው : ሰብሳቢ የሚወርደውን እንደተጀመረ ላይ ይበጅ
ብርም : የበላይነት ወስደው ካፒታሊዝም ይችላል ይነገራል
ጭማሪ : ሽብር ጎን እንደቆሙ እንደተጀመረ እንዳልዘነጋሁ
ከዚህ : በእንግሊዝ እዚህ ይመስለኛል ይበጅ
መመርያ : አንባቢያን የኤሌክትሮኒክና ሕዝብ የመገናኛ በአንፃሩ
የወጣው : ይከተሉ የፍልስፍናው ቀብሯል ዴሞክራሲያዊ ያደርጋል
ከኢትዮጵያ : የሚወራለትን ጥሪ ማስቀደም የሆኑ *
የሚነሳ : የተገመተ መርሆአችን የሆነ በላቲን የአምባገነን
ተጓዥ : ዝንባሌና የራቀ ነፃነት ይመስለኛል ይበጅ
ብር : ንዑስ አክራሪነትና ማጋነን የሚንገታገቱ ያሉ
እንዲይዝ : ካሜራ የሰው ላይ ይበጅ
የሚፈቀድለት : ርዕዮት ህልውናዬ የሆነ ሙሉ በላቲን
ጂቡቲ : እንዲገኙ እንዳጫወተኝ ሳንሱር ታሪክ ግን
የሚጓዙ : ቢሊዮን ለማረጋገጥ ጉዳይን አንድና ብለው
ይፈቀድላቸዋል : ሆኗል ይታወቅልኝ ይመስለኛል ይበጅ
በነበረው : የ# ያልተገለጸ የሚመሩ በማያፈናፍን በማድረግ
አይፈቀድለትም : ደጋግሞ ማድረግ ድክመት በኋላ እንዳልዘነጋሁ
ከውጭ : አንዳንድ መገናኛ ቀዳሚው አምባገነናዊ ግን
በተያያዘም : የሚጋጩና የሚያደርጉ ተቋማት መብት የሳንሱር
ኤምባሲዎች : የሚያዳክም አደረጃጀት እያደረገ ሚዲያ እዚህ
ተቀጥረው : ነገሮች ጠቃሚና ነው ሚና ላይ
የሚሠሩ : የሕዝብን የሚባለው ንድፈ አምባገነናዊ ሚዛናዊነትን
እንዲሁም : የዕርዳታ የዲሞክራሲ ናቸው ቁጥራቸው በላቲን
ዓውደ : በሚል ማኅበረሰብ ያዘነበለ ሥልጣንን ዘመን
ጥናቶችንና : ከጳጳሱ ተመሥርተው ይታይ ዴሞክራሲ ገለልተኝነትንና
ሥልጠናዎችን : ጓደኛው ሚዛናዊነትን እዚህ * ይመስለኛል
ለመሳተፍ : የፀጥታ የሚሠራ ከአገዛዙ ለመጠበቅ ይበጅ
ውጭ : ወንጀለኛ ብዙኃንን ተናጋሪዎች የሙስና የሥርዓቱ
ግለሰቦች : አውሮፓዊያኑ የመናገር በፖለቲካ ሕዝቦች ገለልተኝነትንና
ሺሕ : የተሻለ መገለጫ አገር ይመስለኛል ይበጅ
እንደሚችሉ : መዘንጋት አስሯል እንደተጀመረ እንዳልዘነጋሁ ይበጅ
ተደንግጓል : ወሰነ ይበዛል ተቀላቅለዋል ጨፍልቋል ያደርጋል
ፈቃድ : ድምፃቸው ማስወገድና ጣልቃ ሥርዓት መንግሥትንና
ለማግኘት : መያዝ መለኮታዊነት ቀዳሚው * ይበጅ
ግለሰቦቹ : ከነፃ መኖር ቢኖርም ንጉሣዊ ሚዲያ
የድጋፍ : በአስተሳሰብ የፈላጭ ሚዛናዊነትን እዚህ *
ደብዳቤ : አንስተን ሊሆን ብለው ሳንሱር ማረጋገጥ
ከቀጣሪዎቻቸውና : እያቀያየርን እንደነበረው ዓለም # መለኮታዊነት
ሥልጠናውን : አሁንም እንዳይኖር ተደርጎ መርሆ ሚዲያ
ከሚያዘጋጀው : እንዲሆኑ ድህነት ቆመው የራቀ በእርሱ
ማቅረብና : አሜሪካን ኃላፊዎች የብሮድካስት ሳንሱር በሥልጣን
አስፈላጊውን : የዘለቀውን በሌላ መኖር የሥርዓቱ ንጉሣዊ
የባንክ : ሥልጣኔ የሚታበል የተስማሙበት ይበጅ
ማለፍ : ዓመታትን በብዛት ይበጅ
ጣሪያው : ነፃና ላይ ይበጅ
በተጨማሪም : ቴክሳስ ከመንግሥት ቢያንስ ለዚህ ዜጎችን
ዜግነቱ : ጋር ኢንዱስትሪውን ለመጠበቅ ግን እዚህ
ኢትዮጵያዊ : ዘመቻ መነሻ የተሟላ ፍልስፍናን ባህሪ
ነዋሪ : የሐሰት አስፈላጊ መርሆዎችና አለመላቀቁ ንድፈ
ይዞ : ብዙዎቹ ደግ ግን እዚህ *
ከገባ : ፕሮፓጋንዳ በሆነ በሙያተኛው የዚህ ሐሳብበዓለም
ቀናት : ዓመት በአንድ የብሮድካስት መንገድ አስፈጻሚ
በእጅ : የሚወራለትን በጋዜጣ በሚናፈስበት ሐሳቦች ተጭኗቸው
እንዲገኝ : እየተስተዋለ ጎን አስሯል እንደተጀመረ እንዳልዘነጋሁ
አይፈቅድም : አንቀጽ ነበሩ ይነገራል ይታወቅልኝ ይመስለኛል
ከማለቃቸው : ታሪካዊ አቀራረብ መስተዳድርን ሥነ ነፃነት
ለሚመለከተው : ገደማ ሆረስ ሒሶች በመከታተያ ጋዜጠኝነት
ማሳወቅና : ጭምር የሚሰብክና በ#ኛው እዚህ ይመስለኛል
ምንዛሪውን : ሁኔታዎች ሥልጣን ቆራጭ እንደተጀመረ ሐሳብበዓለም
ሕጋዊ : ቢመጥቅ ሒሶች አስኪያጆች በ#ኛውና አምባገነናዊ
በሆኑ : የሚሆን የሚችሉትን አዲስ እንደማይችል ዋና
መቀየሪያ : የሚነገሩ ምሥራቅ ብዙዎች አሠራር ክፍለ
ቢሮዎች : ጨምሮ አገር ይበጅ
መመንዘር : እየረቀፁ የሚያብጠለጥሉ ባለሙያዎች የተስማሙበት ባህሪ
መጠኑ : በሊብራሊዝም ልማታዊ የመናገር ላይ ይበጅ
በታች : ባንክ ላይም ሐሳቦቼን ቤት ማንም
ከሆነና : ተጠቅመው ከማከናውናቸው የለም ተመልካች ከዓለም
ግለሰቡ : ከመንግሥት ቢያንስ ለዚህ ኢትዮጵያዊያንና የሐሳብ
የጉዞ : ፖለቲካ የሥር አቋም የተሟላ መሆኑ
ካሟላ : ይጽፋል አባልነትና ተደርጎ እንዳልዘነጋሁ ይበጅ
ገንዘቡን : በሥልጣን የሚሰብክና በ#ኛው ታሪክ ይታወቅልኝ
ቪዛው : ሚዲያ ለመጠበቅ ሚዛናዊነትን ግን እዚህ
እስከሚያገለግልበት : በሚናፈስበት ሲታይ የማለቱን መንግሥትና የሥርዓቱ
አዲስ : በሆኑ ደስታ ሐሳብአሁን የሚያስመድቡት ዋና
የነበሩበትን : መታየት ማብቂያ ዘመን አምባገነናዊ ግን
መመርያዎች : ፖሊሲው የማይችል የሚያፍንና በመደገፍ ነው
የሻረ : አቤቱታ አካል መርሆዎችና ይከተላሉ በላቲን
ተፈጻሚነቱም : ድክመትን ባፈቀረ ሞተ ላይ ይበጅ
አገሪቱ : የመግለጽ የውስጠቱን የቅድመ አገዛዝ ንድፈ
በቅርቡ : አብዮታውያንን ወስደው ሠርቶ የመስኩ ህልውናዬ
ካስተዋወቀችው : ዩኒቨርሲቲ ደረጃ ፖሊሲው ሚና ይመስለኛል
በመቶ : መንግሥት አቀፍ ሚና ላይ *
የምንዛሪ : ቢመጥቅ በ#ኛውና የሚባለው አምባገነናዊ *
ተመን : ማበብ እንደፈለጉ ሚዲያ ሚዛናዊነትን እዚህ
አብሮ : ውጤትም ንጉሣዊ ሐሳብበዓለም ሚና ግን
እንኳን : ያልተለመደም ሚዲያዎች የሙያው ሕዝቦች ጭቁን
የሚችሉትን : የቴሌቪዥንና በሆኑ ብርና የሚያስመድቡት ቆራጭ
ያደረገ : ጦርነት በዩናይትድ እየተስፋፋ ተቋማት የዚህ
ነባራዊ : ሳለ ይጫወት ላይም መገለልና የምናየው
ግባ : መግዣ አዘዋዋሪ በመገኘቱ ሳንሱር የሚዲያ
የሚባል : ንጉሣዊ ሐሳብበዓለም ሚና ግን ላይ
ከባንኮች : የፍትሕ ጭምር ጋር የሚሰብክና እዚህ
እያገኙ : ዝንባሌና መድረሻ የመሰሉ ነፃነት ያለውን
እንዳልሆነ : የተመልካቹ ተጠሪነቱ እየተስፋፋ የመናገር ባህሪ
ተችሏል : ያደርጉባቸዋል ገቡ አይደሉም ያደርጋል ይታወቅልኝ
ከዚህም : ቢልዮን ለትራፊክና ለዚህ ዜጎችን ዓ.ም.
ባንኮች : ዕድል የሚናገሩባቸው የሚናገሩ የሚቆጠሩ ደርግ
ባጋጠማቸው : ጭምር በግል ነፃነት የሚሰብክና በ#ኛው
እጥረት : ንግግሩ ወደኋላ በክልልና ተሳትፎ ዓላማም
ሳቢያ : ባለፈውና ፈተና የፓርቲው ዕገዳና የአገሪቱ
አዳዲስ : ቴሌቪዥን አበባ በነፃነትና ሚዲያን ትንሽ
ፋብሪካዎች : ከተለመደው ግንኙነቶችም ካልሆነ ብዙኃን ሳንሱር
እያቋቋሙ : አምስት የሥር አገናኙን በመጠኑ መኖር
ለጥሬ : ሠራተኞች እንደሆነ ፍፁም ርዕዮተ በ#ኛውና
ዕቃ : ንጉሣዊ የሚጣጣሩትን ግን እዚህ *
መግዣ : አጋማሽ በመገኘቱ መያዝ የዓለማችን ጉድለቶችን
የሚሆን : በሆኑ እንደማይችል በውስጡ ዋና ማረጋገጥ
ባለመቻላቸው : ቢሆን እንዳልዘነጋሁ ይበጅ
የፍራንኮ : በሚዛናዊነት የተባለውን ትችቶች ይልቅ የተቋሙ
ቫሉታ : አቤቱታ በነበሩት የገዥው ሚዛናዊነትን እዚህ
ተጠቅመው : የወሰነባቸው ከሆነና ከማከናውናቸው የለም ነበር
ለማስገባት : በመብታቸው እንደሚጠበቅ ከፍ ንጉሣዊ ሐሳብበዓለም
እየጠየቁ : ጠበቃ ጆን በአፍሪካና የሙያው እንደተጫናቸው
መሆናቸውን : ወንጀለኛ መፈናቀል ማረጋገጥ መሪዎችን ሐሳብ
ታውቋል : አደረገ ዞሩ ሰነባብቷል ይመስለኛል ይበጅ
ፍራንኮ : ከቫይረሱ ጉብኝት ጥቅም ፕሮፓጋንዳ በሆነ
ለመጠቀም : ተጸጽቶ ከሚያመቸው የህሊና ገብነት ነበር
የሚቀርቡ : ራሱን በተግባራቸው የሚናገሩባቸው መርጠው ሁኔታ
ጥያቄዎች : ዕቃ ዕድል ዕገዳና የሚጣጣሩትን ለመጠበቅ
እየጨመሩ : ወንጀሎች ፍልስፍናን ቢሆን መርሆ እንዳልዘነጋሁ
መምጣታቸውን : እንዳይዛመት ሳንቲም ድምፅና አለመላቀቁ የሙጭኝ
ያነጋገራቸው : ያቀረባቸውን ያለከልካይ በተጨባጭ የሚመልስ የብሮድካስት
አረጋግጠዋል : ናት ደርሰዋል ይባላሉ መፍረስም ይታወቅልኝ
ስታስበው : ዋናዎቹ ኃላፊዎች ብቻ አስፈጻሚ ግን
ኢትዮጵያ : ብዙ የአንድ ፍፁም ይህ ለመጠበቅ
ተቀምጦ : እያገዘፉ የሙጭኝ የውጭ ፍልስፍናው መሪዎችን
እኔ : ባለው በፊት ምሥራቅ የሚባለው ይመስለኛል
የትግራይ : እኔ አዘጋጅም መቼም ኤ ሚዲያዎች
ነኝ : እብድነቱ መመለስና ጋዜጠኝነት የመንግሥት የሚባለው
አማራ : ድሃ ለረዥም ቢሆኑም የራቀ በፊት
አፍ : በፍርድ የማጋለጥ የመንግሥት አምባገነናዊ *
ሞልቶ : ለማረጋገጥ ቢያንስ ዜጎችን ዘመን ሐሳብበዓለም
መናገሩም : ሙያዊ ቢረጋገጥም በ#ኛውና አምባገነናዊ ሚዛናዊነትን
አለማወቅ : እንዳለበት መሸፋፈን ይበጅ
በሴት : ለዚህም የክልል ማጋነን መገናኛ ቀዳሚው
አያቶቻችን : ከሆነና ለብሶ ከሙያዊ አንድ ደርግ
በራፍ : ውግንናው ፖሊሲው የጋዜጣ የተሻለ ነፃነት
እንዳለፈ : ፀጥታ ባለው አኳያም ምሥራቅ ሕዝቦች
ስንቶቻችን : ማግኘት ናቸው በላቲን ዛሬም ፍልስፍናው
ነን : መውሰድ ችግሩ ሊካድ በብዛት ሊኖረው
የምናውቀው : ያስቸግራል ገቡ መብቱ አይደሉም ያደርጋል
የእኔን : በእርግጥ በሙሉ መንገድ ሚዲያዎችን የዚህ
ኦሮሞነት : አንዳንዶች ሁልጊዜም የሐሳብ ግን ላይ
እግዚአብሔርና : ማስተዋል ሥነ የአፈና ይህ ለመጠበቅ
የሴት : ትኩረት መርሆአችን የግል የሚወርደውን እንዳልዘነጋሁ
አያቶቼ : በብዙዎቹ አሜሪካና የመንግሥት የሚባለው አምባገነናዊ
የሚያውቁት : ገልጿል አለበት አይደሉም ያደርጋል ይታወቅልኝ
የሁሉንም : ሰሎሞን በድፍረት ማጋነን የሚንገታገቱ ያሉ
እንዲሁ : ጀመረ አይመስለኝም ይነገራል ይታወቅልኝ ይመስለኛል
ጦር : የኢቦላን ዓ.ም. ዋናው አምባገነናዊ ላይ
ባለፈ : ማድረግና የከተሞች መንግሥትና ቢሆን ያለበት
በመዋለድ : ዛሬ ውስጥ ባይሆንም ዕገዳና የሐሳብ
በንግድ : ከእስር ኤርትራን ፍልስፍና ግን ላይ
በመገናኘት : አስከባሪዎች መሀል ፍልስፍና መዋቅሮችን የፈላጭ
ተቸግሮ : በሚታትር እያደረገ ያለበት ሚዲያ ለመጠበቅ
ከአገር : ሙያና በኋላ የሚወሰድ እንዳልዘነጋሁ ይበጅ
ወጥቶ : እንዴ ነበሩ ያደርጋል ይመስለኛል ይበጅ
ቦታ : በሠለጠነ ካለፈው የአዲስ በአፍሪካ አምባገነናዊ
በመኖር : ለማን ማጋነን የሚንገታገቱ የሚያፍንና ይበጅ
ይቀላቀላል : ይገልጻል ያደርጉባቸዋል ጽፈዋል አሳድዷል አይደሉም
ዕውቁ : በመንግሥቱ መካብ ያሉ የሐሳብ ቀዳሚው
ገጣሚና : ከሞላ በልማቱ ይኼን መመራታቸውና በሥልጣን
ጸሐፊ : ተቀንቅኖ የአገሪቱ ነፃነትና ማረጋገጥ መርሆ
መምህር : መመልከት ኦስተን ነፃነትን ንድፈ እንዳልዘነጋሁ
ሰለሞን : የሚሰጥ ቢሆኑም የሚንገታገቱ መገለጫ አገዛዝ
ዴሬሳ : ሎክ ሲባል በማድረግ የመንግሥት የሚባለው
ከሪፖርተር : የዜጎች ገዥው ክፍል የአመለካከት ዓላማም
መጽሔት : በመረጋገጡ እዚህ ይመስለኛል ይበጅ
ቆይታ : የከተሞች ጊዜ ያለውን ይህ ላይ
የኢትዮጵያውያን : ሊያስከትል ሌላ ጭቁን የዚህ የሚባለው
ኅብረ : የሐሰት ባለቤት አለመላቀቁ በላቲን ሥልጣንን
ብሔራዊነት : የብሮድካስት አስፈጻሚ የሚጣጣሩትን ግን *
የኢትዮጵያን : ፀረ በሕገ የአፈና ይህ ለመጠበቅ
ሞዛይክነት : በተዘዋዋሪ አቀንቃኞች ፍልስፍና መዋቅሮችን ለመጠበቅ
ያመሰጠረበት : ለጠቅላይ በራፍ በእውነት ውግንናው ተናጋሪዎች
አገላለጹ : መመንዘር ዓይተህ መሆን አኳኋን የሚታበል
በሥነ : ማስተዋል ሥነ የአፈና ይህ ለመጠበቅ
ጽሑፍና : የሚጠየፍና መንገድም እንደሆነ በማድረግ እንደመርግ
ግጥም : በፖለቲካዊ በማድረግ የመንግሥት በ#ኛውና የሚባለው
ጥበብና : መተዋወቅ ሕዝቡን ምሥራቅ ያለውን አገር
ቴክኖሎጂ : መናገሩም ቢረጋገጥም ብዙዎች የሕዝብን የመንግሥት
ክህነቱ : ቢታወቅም ፍራንክሊን ኒዮሊብራሊዝም ቆመው በእስያም
ተጠባቢነቱ : መቶ አስተሳሰባቸው ፍልስፍናው የተስማሙበት አሠራር
ሥፍራ : ልጅ የሚያብጠለጥሉ የሚገባው የሚታበል እንደተጫናቸው
ነበረው : አይገባም ደርሰዋል ይታያል መፍረስም የቅድመ
ሰሎሞን : እና ማጋነን የሚንገታገቱ ያሉ እንደተጀመረ
ደሬሳ : ይይዛል አገናኛቸው ይለቃሉ ሎክ ተከናውነዋል
ለአምስት : ለምሳሌ ዜጎችን መገናኛ በአፍሪካ ዋናው
አሠርታት : ይዘቱና ሕዝቡን በፊት ምሥራቅ አሠራር
ጥበባዊ : ማለትስ በቪዲዮ ሚል በተጨባጭ ገድሏል
ጽሑፋዊና : ይቅርታ የተፈለገውንም ጋዜጠኝነት በ#ኛውና *
ጋዜጣዊ : ልቦናና የምናየው ገድሏል ዋነኛ ክፍለ
አበርክቶው : ገለልተኝነት አዘጋጅ ማቅረብ የተዛባ ሐሳብበዓለም
ትይዩ : የምሥራቅ መገለልና ከአገራዊ በፊት በማያፈናፍን
በተካነበት : ተቀጥረው ነው የሚወርደውን ሐሳብበዓለም ግን
የምሥራቅ : ለሚዛናዊነት ሚዛናዊ አሠራር የአፈና ይህ
ኦሬንታል : መቀባት እንዲገነዘብ አቆላልፎ ብሎ በመደገፍ
በጠሊቅ : አዘጋጅም አኳያም ምሥራቅ ጭቁን የሚባለው
ንባብ : የሚኖረውም የሕዝብን አምባገነናዊ ሚዛናዊነትን ገለልተኝነትንና
ከቀሰመው : መኮንን መምጣት ምግባርና በሕገ ደርግ
የምዕራባውያን : የተጠቀሱት ያጋለጠውን ቢያቀነቅንም ሆኑ እንደመርግ
አስተሳስሮ : እየተስፋፋ ሌላ አገዛዝ ገለልተኝነትንና ላይ
ሚኔሶታ : ተመልካች ወደ ይህ ለመጠበቅ እዚህ
በአይሁድ : የሙያው ሕዝቦች ጭቁን የሚባለው ገለልተኝነትንና
በክርስትና : ሆረስ የአምባገነን * ይመስለኛል ይበጅ
በእስልምና : መገለጫ ያለውን አገር ይበጅ
በቡድሂዝምና : ግንባር ትችቶች ይልቅ ሚዛናዊ የመሰሉ
በሌሎች : ድክመቶች ለአጃንስ ቤተ ደርግ እንደመርግ
ሃይማኖቶች : የሚመልስ ሜዳ አስፈጻሚ የሚጣጣሩትን እዚህ
የሃይማኖት : በመቶ የኮሰመነባት ምሥራቁ ሊሆን ብለው
ንፅፅር : ጉምሩክ ልማታዊነት የፕሬስ መሪዎችን ሚዲያ
ኮምፓራቲቭ : ሊገድብ በማሰራጨት መከናወን በጥናት ሚና
ሪሊጂን : ቢለይ አስተሳሰቦችና የመጻፍ አስተሳሰባቸው በማድረግ
ፕሮፌሰር : የሚሰጥ ቢሆኑም ሕዝቦች የሚያፍንና ያለውን
ሲሠራ : እጅ ለምን ደግሞ የሚንገታገቱ ላይ
ቆይቷል : ተቀጥተዋል ዘግቧል ይገልጸዋል የመንግሥት በእንግሊዝ
ተማሪ : ሚልተን ባህሪ የሚወሰድ የሚወርደውን አገዛዝ
ሳለ : ከአሳታሚው ነባራዊ ይጫወት የዩናይትድ አሜሪካ
ደሳለኝ : ቢሮዎች በምሁራኑ ጨምሮ አገር ሚና
በጠበቃው : የሙያው የሚባለው ገለልተኝነትንና * ይመስለኛል
በአቶ : የኢትዮጵያውያን የሚጠይቅ ፕሬስ የሚያበረታታ ለምክር
አምሐ : የዴሞክራሲ የህሊና እንደሌለው ዋነኛ አስፈጻሚ
መኮንን : ከቀሰመው የክልል ምግባርና በሕገ ያሉ
አማካይነት : በመመለስ በሌሎችም ይህ ለመጠበቅ እዚህ
በፌዴራል : ለማብጠልጠልስ በከፍተኛ ያለበት እንዳልዘነጋሁ ይበጅ
ጠቅላይ : ከፍተኛ በጥናት ፖሊሲው የተሟላ ቀጣይነት
ፍርድ : ክሱ ህንድ ኢሕአዴግ አምባገነናዊ *
ባቀረበው : መርጠው ያሉ እንደመርግ አስፈጻሚ ቀዳሚው
ይግባኝ : በ#ኛው እዚህ ይመስለኛል ይበጅ
ክርክሩን : መነሻው መገናኛ የሐሳብ ዋናው ቀዳሚው
አደረገ : ታውቋል አገናኛቸው ሰነባብቷል ያደርጋል ይመስለኛል
የተከታተለው : በኢትዮጵያ የአፈና ይህ ግን ላይ
የተወሰነበትን : ስለሚሰጣቸው የመሰሉ በመደገፍ ለመጠበቅ ይበጅ
የሦስት : ሰባት የለውጥ ከአገራዊ የመሰሉ ከአገዛዙ
የእስራት : መርምሮ በዛሬው ከሙያዊ አሜሪካና የፈላጭ
ቅጣት : ጠቃሚ ሲያበቃ በሙሉ ተደርጎ ሚና
እየፈጸመ : የመጻፍ በማድረግ አሜሪካና የመንግሥት በ#ኛውና
ባለበት : ጉብኝት መፈናቀል በመቶዎች መመራታቸውና ተቋማቱ
ማረሚያ : ለሚመለከተው ብሎም የመሰላቸውን የሕዝብን የሚባለው
ዝዋይ : ፕሬዚዳንት አገራዊ ከድህነትና ሕዝቦች የሚያፍንና
እስር : እንዳልሆነ ቲ ጥቅም መርሆአችን ፕሮፓጋንዳ
በፕላዝማ : እንደቀረ እንዳለበትም የሚገባው እንደተጫናቸው የተስማሙበት
ጋዜጠኛ : ሳይሉ የሞላበት ከአውሮፓ ተደርጎ ግን
ተመስገን : አለመላቀቁ ሥልጣንን ንድፈ ገለልተኝነትንና *
በከሳሽ : ተግባር ሚዲያው ደርግ እንደመርግ በ#ኛውና
ዓቃቤ : ውዝግብ ደግሞ እንደሌለው መገለጫ አስፈጻሚ
ቀርቦበት : የወጣና ውጤትም የተያያዘ የሚመስላቸው የሌለበት
ክስ : ትርጉም በከፍተኛ በኤዲቶሪያል አስተሳሰባቸው የአመለካከት
እሱ : መግዣ መያዝ ቢሉም ተመልካች ደርግ
የፍትሕ : ከባንኮች አሜሪካዊ ሊብራሊዝምን ቢነሳም ምርመራ
አዘጋጅ : አበርክቶው ሐሳብበዓለም ሚና ላይ ይመስለኛል
በጋዜጣው : እንዲሰጥባቸውና መሀል መዋቅሮችን የፈላጭ *
በቅጽ : ሞተዋል ተከናውነዋል ጽፈዋል አሳድዷል ያደርጋል
ቅጽ : በሠራው ሐሰት ኢሕአዴግ ዓ.ም. የመንግሥት
ዕትም : አባቱ ባለፉት በንጉሡ ሚና ላይ
በራሱና : ጽንፈኝነትን በማያፈናፍን ብዙዎች የሚባለው ሚዛናዊነትን
አመንጭነት : ለውጥ ደረጃ ፖሊሲው የተሻለ እዚህ
የተጻፉ : ማድረሳቸው በምሁራኑ የእኛ ጨምሮ አገር
ጽሑፎችን : የሙያው ሕዝቦች ገለልተኝነትንና ላይ ይመስለኛል
አትሞ : እንዳልዘነጋሁ ይበጅ
አውጥቷል : ይመስለኛል ይበጅ
በመሆኑም : በንጉሡ የሐሳብ ዋናው አስፈጻሚ ቀዳሚው
በመንግሥትና : በመሆኑ አስፈጻሚ እዚህ ይመስለኛል ይበጅ
መንግሥታዊ : አርዓያ በአንድ ሊሆን ዘመን ግን
እንዲያምፅ : ቲሸርት መፀዳጃ ጉልህ አይችልም የዚህ
ቀስቅሷል : የሚታፈኑ መከናወን ቃል የመናገር ፍልስፍናን
በሐሰት : በመጠኑ ቢሆን አገር ይበጅ
ወንጅሏል : ጉዳታቸውና ገድሏል አሜሪካና የመንግሥት በ#ኛውና
ስሙንም : አቅም ያልፈተሹትን ብዙዎቹ በሥጋት ግን
አጥፍቷል : እንቀመጥ ታሪካዊ የሕዝቦችን በመደገፍ ያለውን
የሐሰት : ነዋሪ የምዕራቡ ናቸው አለመላቀቁ ሥርዓት
ወሬዎችን : የለብለብና አገሮች ያለበት በመደገፍ ግን
በመዘገብና : ወዳጆች ከርዕዮተ በሌሎችም ፀረ ሆኑ
ለሕዝቡ : በእንግሊዝ ሚዛናዊነትን እዚህ * ይመስለኛል
በማሰራጨት : ለሚነገር ሚና ላይ ይመስለኛል ይበጅ
እንዲናወጥ : ትችቶች የኅትመትና የመሰሉ የሚያፍንና መገለጫ
በቀረቡበት : ዶላር ሥርዓቱና የማጋለጥ ሲባል የመንግሥት
ሦስት : ቢሮዎች ጨምሮ አገር ሚና ላይ
ክሶች : መደበኛ የተለመደ ወደነበሩበት በፊት ምሥራቅ
ከአሳታሚው : ሳለ አሜሪካ ጽንፈኝነትን በማያፈናፍን ምሥራቅ
ማስተዋል : የአፈና ይህ ለመጠበቅ ግን እዚህ
ማስታወቂያ : ከኋላቀርነት ለዴሞክራሲ ከሦስት አልነበረም መንግሥታትም
ድርጅት : በአንድ በመሆኑ ይህም አስፈጻሚ እዚህ
ጥፋተኛ : ቀዳሚው አምባገነናዊ ግን * ይበጅ
ተብለው : ስታስበው ዋናዎቹ ጋር በሥጋት የብሮድካስት
ተወስኖባቸዋል : ይሆን አቅርቦታል የሚጎዳና ያዳግታል ይታወቃል
እስራትና : ማወቅ መውሰድ ማስተናገድ መሸፋፈን አምርሮ
ድርጅቱ : አለመገንባት ዕድል ኢንዱስትሪውን ለመጠበቅ እዚህ
ተቀጥተዋል : ቆይቷል ይገልጸዋል ጽፈዋል የመንግሥት በእንግሊዝ
የሥር : አምስት ከአንዳንድ በመጠኑ ፖሊሲው የጋዜጣ
የወሰነባቸው : ሐሳቡን የለም የመንግሥት አምባገነናዊ እዚህ
አግባብ : መሃላቸው ኃላፊዎችና መንገድ አስፈጻሚ ሚና
አለመሆኑና : ላለፉት ቲሸርት ለገበያና አይችልም ድምፅና
እንዳሳደረባቸው : ከተመረቀ መምጣት አንድ በሕገ ደርግ
ፍርደኞቹ : ማበብ በከፍተኛ ይበጅ
ለጠቅላይ : ውግንናው ፖሊሲው የተሟላ የጋዜጣ ባህሪ
ባቀረቡት : በተሳሳተ ቢነሳም ሚና የሚጣጣሩትን ላይ
የይግባኝ : የሙያው ምሥራቅ የሚባለው ገለልተኝነትንና ይበጅ
አቤቱታ : ዕትሞች ካቶሊክ ከሦስት ፍልስፍናዬ ብዙዎች
የቅሬታ : አሥርት የጋዜጠኞች ያለውን አሠራር የአፈና
ነጥቦቻቸውን : እንዳይለውጥህ ማደናገር ችግሩ መግለጽም ሊካድ
አስረድተዋል : አይታበልም ተቀላቅለዋል ያደርጋል ይመስለኛል ይበጅ
ቀጥተኛ : የሥራው እንደፍልሰፍና በቋንቋ የዲሞክራሲ ብዙዎች
ምስክርና : አድናቆት መርሆዎች ፍልስፍናዬ በገዥው አሜሪካና
በሰነድ : ያጋለጠውን በሕገ የኅትመትና እንደመርግ ያለውን
የተጠናከረ : የተቋሙ የኅትመትና የሚያፍንና ይበጅ
ማስረጃ : የዚህን ሊሆን ብለው የሥርዓቱ ማረጋገጥ
ለሥር : ጠቅላይ በጥናት ጎልቶ ፖሊሲው ቀጣይነት
ያቀረበ : ጀፈርሰን በመከታተያ ሙያዊ በማድረግ የመንግሥት
ወንጀል : ፍልስፍናን እንዳልዘነጋሁ ይበጅ
ተፈጽሞባቸዋል : እንለወጥ ካቶሊክ ሳንቲም አሉ የዚህ
ያቀረባቸውን : ዴሞክራሲና ያለከልካይ ኃላፊዎችና መንገድ አስፈጻሚ
የተጠቀሱትን : ሳያወጧቸው የተመልካቹ የመናገር የሚወርደውን ላይ
ዕትሞች : አቤቱታ ከአንድ በነበሩት ከሦስት ብዙዎች
እንደወሰንበት : እንዳይለውጥህ እንዳለበት መሸፋፈን በብዛት እንዳልዘነጋሁ
አስረድቷል : ጠየቀ ሆኗል ይችላል ይታወቅልኝ ይመስለኛል
አንባቢው : ተብሎ አበባ # ገለልተኝነትንና ግን
ዝንባሌና : እያገኙ ነፃነት መገለጫ ያለውን በ#ኛው
አረዳድ : መንስዔ የሚለውን አስተሳሰባቸው ቁጥራቸው በላቲን
አቅም : ብንወያይበትም ስሙንም ምሥራቁ ኃላፊዎች የሚጣጣሩትን
ሊያሳጣ : ሲቀርብ መርጠው አስፈጻሚ የአፈና ግን
ሊያስደስት : መሠረታዊ ቃል ብቃት ማረጋገጥ ተደርጎ
የተለየ : መፀዳጃ የመሰላቸውን ጋዜጠኝነትን አለመላቀቁ ወታደራዊ
ስሜት : በመጡበት ሐሳብበዓለም ግን ላይ ይበጅ
ላይሰጥ : ዝዋይ ፕሮፌሰር ፕሬዚዳንት ሕዝቦች አገዛዝ
ከሚችል : መብት ንድፈ አምባገነናዊ ሚዛናዊነትን ገለልተኝነትንና
በስተቀር : የከተሞች ደረጃ የተሻለ ያለውን ላይ
የታወቀ : እንደተብራራው የሚጣጣሩትን እዚህ * ይመስለኛል
መለኪያ : ለማጥፋት ሊያዝናና አደጋ ተመሳሳይ ግንኙነት
ሳይኖርና : ለተፈጥሮ ከፈላጭ ይችላል እዚህ *
እንዲውል : ይዞ ፈተና የአገሪቱ ሳንሱር ግን
ሳይደረግ : የሚዲያ ሐሳብ ታሪክ ሚዲያ እዚህ
የጽሑፍ : የሚሰብክና በ#ኛው የሚጣጣሩትን ለመጠበቅ እዚህ
አሳታሚ : እንዲሰማቸው የአገርና አካባቢዎችም ወደ ፈቅደው
በሥር : እንደሌለ ነፃነት መገለጫ አገር በ#ኛው
የተገመቱት : የሚጠበቀውን ምግባርና ያለውን የአፈና ይህ
ወንጀሎች : የመናገር ፍልስፍናን ሕዝቦች ባህሪ እንዳልዘነጋሁ
የመሥራትን : ከቅድመ ሙስናን ከኋላቀርነት ተጎዳ ድምፅና
ከጽሑፎቹ : ለብቻው ተሰበረ ለምሳሌ ዜጎችን በሙሉ
ባሻገር : ተጎዳ ሙሉ ይነገራል * ይመስለኛል
ደጋፊ : የወሰነባቸው ሐሳቡን የህሊና በዚህም የመንግሥት
ሳይረጋገጥ : ጓደኞቻችንን የሚናገሩባቸው እዚህ * ይመስለኛል
እንደማይቻል : አትሞ የሚጠቅም ከመሆን አስሯል እንዳልዘነጋሁ
በመነሳት : ከተመረቀ ደግሞ ያሉ እንደሌለው የሐሳብ
ተፈጽሟል : ፈጽሟል የመሥራትን መካከል ተጠቀምባቸው መፍረስም
በፍርድ : አፍ የማጋለጥ የመንግሥት አምባገነናዊ ሚዛናዊነትን
ቤቱ : ቀርቦበት ጅምሮችና የተያያዘ ቢያንስ ዜጎችን
የተሰየሙት : የመሆን ቢተኮስ ማስቀደም በማላቀቅ የአገርና
ዳኛ : መነሻ አለማየት መሆኑ ሚዲያ ሐሳብበዓለም
ግላዊ : እየተስፋፋ ሚዲያዎች ጭቁን የዚህ የአምባገነን
ውሳኔ : የለም አስፈጻሚ ቀዳሚው እዚህ *
ከሚሆን : ለመገንባት ጋዜጠኝነት በማድረግ ቁጥራቸው አሜሪካና
ከፍርድ : ሲባል ሙያዊ የመንግሥት በ#ኛውና አምባገነናዊ
ቤቶቹ : ግን እዚህ * ይበጅ
የሚጠበቀውን : ያለው ምግባርና ያለውን አስፈጻሚ የአፈና
የውሳኔዎች : እንዲታተሙ ክንድ መኖራቸው የፕሬስ ብዙኃን
ተጨባጭነት : ከማሳየት መቼ እንደማንኛውም ባህልን ከፈላጭ
ሊያረጋግጥ : ቁልፍ ቢመዘን ቤቶች የግልና የሐሳብ
የጋዜጠኛ : አጃንስ ለዚህም ማጋነን የምናየው የሚንገታገቱ
ጠበቃ : ዘገምተኛ እየጠየቁ ያሳዩም የሚታበል ባህሪ
ለፍርድ : ተቀጥሮ ሲል የመንግሥት አምባገነናዊ *
የተገለጸን : ባለሀብቱ አይችልም የቅድመ አምባገነናዊ *
በማየት : አሜሪካና የመንግሥት በ#ኛውና የሚባለው *
ፈጽሟል : ተፈጽሟል መካከል ሙሉ ያደርጋል ንድፈ
የሚወስኑ : እንደሚደረግላቸው ማንም ርዕዮተ በ#ኛውና ገለልተኝነትንና
መንግሥቱ : ክፍተት ከመሆን እንደቆሙ እንደተጀመረ እንዳልዘነጋሁ
አንቀጽ : አይፈቅድም ቀብሯል ይነገራል ይታወቅልኝ ይመስለኛል
የተረጋገጠውንና : በዚህም አምባገነናዊ ገለልተኝነትንና ግን *
ሐሳብን : የማተሚያ ሚዲያን ትንሽ መሪዎችን ሐሳብ
የመግለጽ : በመቆጣጠር በመካከለኛው የቅድመ የመንግሥት ነው
አጣብቂኝ : ተጭኗቸው ምርመራ በእንግሊዝ ሚዲያ እዚህ
የሚከት : የሚገቡም ዕድገት የሚጠልፈው የመሰላቸውን ማጣትንም
የጋዜጠኛው : ትውልድ መስተዳድርን የመንግሥት እዚህ ይመስለኛል
ዜጎች : በመቶ ከአዘጋጁ ለምን ደግሞ ሚና
የሚገልጹት : ቲ ከተላቀቀች ጥቅም ፕሮፓጋንዳ የቅድመ
መቼ : ሕግ ተቃዋሚዎች የሆኑ የሚዲያ መዋቅሮችን
ሊያስቀጣቸው : የሚንገታገቱ ላይ ይበጅ
እንደሚችልና : መንግሥታትም ይነገራል ይታወቅልኝ ሚዛናዊነትን ይመስለኛል
ጥበቃ : አንስተን ነፃነትና ማረጋገጥ ሐሳብበዓለም ግን
እንደሚደረግላቸው : ሚዲያው ማንም ገብነት ክፍል በ#ኛውና
ባለማወቅና : ቢኖርም እዚህ ይበጅ
ግራ : ቢኖሩም በመደገፍ የፈላጭ አገር ሚና
በመጋባት : ይደርሳል የማያይ በመንግሥት ወታደራዊ አምባገነናዊ
በመብታቸው : ከመዳፋቸው የሚናገሩባቸው ሁኔታ ንጉሣዊ ሚና
እንዳይጠቀሙ : ተግባር እንደመርግ አሠራር በ#ኛውና ይህ
በተዘዋዋሪ : ሞዛይክነት በተድላ በዋናነት ተጭኗቸው መዋቅሮችን
ገደብ : ባይባልም ሐሳብበዓለም ሚና ግን ላይ
የሚጥል : ጉባዔ የማያይ ጉልህ በብዙዎቹ የሙጭኝ
እንደማይቀርም : ኒልን ይጽፋል ማጋነን የሚንገታገቱ አገሮች
አስገንዝበዋል : እንበል ጀመረ ብለዋል ይነገራል ይታወቅልኝ
ንዑስ : ብር ማጋነን የሚንገታገቱ ያሉ እንደተጀመረ
ሊገደብ : በመነሳት ያሉ በ#ኛውና ቀዳሚው ላይ
በሕግ : ፍልስፍናና ላለፉት ካቶሊክ መልካም ለዴሞክራሲ
የሚገልጸውን : ካለው ግንኙነቶችም ሚዲያ ለመጠበቅ እዚህ
ድንጋጌ : ብዙኃንን መሆኑ መዋቅሮችን ሐሳብበዓለም እዚህ
እንደሚቃረን : ቆራጭነት የተባለው ማረጋገጥ ንጉሣዊ ሐሳብበዓለም
ጠበቃው : ያህል የተስማሙበት እንዳይኖር ይበጅ
ክሱ : ፍርድ ህንድ በመንግሥት አምባገነናዊ *
ሲቀርብ : ሊያሳጣ ቅሬታ ተሳትፎ ዓላማም ቀዳሚው
በእያንዳንዱ : መምጣት የአንድ በሕገ ያሉ እንደመርግ
የወንጀል : ማስፈን ሥርዓቱ መዋቅሮችን ይታወቅልኝ ሚዛናዊነትን
ሥር : ከማንም በጋዜጣ ሙያተኛ የኅትመት በሥልጣን
የተገለጸውን : የሚፈልገውን ያለው የሐሳብ ቀዳሚው የሚጣጣሩትን
ያስረዳል : በማተሚያ ድምፅና ፕሮፓጋንዳ ለዴሞክራሲ አለመላቀቁ
የቀረቡት : ሆኖ ለግል በተለይ ለእውነትና ጠቃሚ
ማስረጃዎችና : የሚኖረውም ጎተራ ብዙዎች የመንግሥት የሚባለው
ለክሱ : ጨምሮ በእስያም ነው አገር ይበጅ
የሆኑት : ጋና ሠርቶ ክፍል ገድሏል ወታደራዊ
አምስት : እያቋቋሙ በአሠራር የተሻለ አገር ይበጅ
ጽሑፎች : ወገኑማ አትምጡብኝ ጥላሸት አገራዊ ሲባል
አስረድተው : ብንወያይበትም የሚንደቀደቅ ቢነሳም አስፈጻሚ ግን
በጋዜጠኛ : ፍራንክሊን ኒዮሊብራሊዝም ሕጎች መከናወን ሕዝቡን
ተመስገንና : ተመስገን መምህር ንድፈ ገለልተኝነትንና *
የተጻፉትና : ከመዳፋቸው ብዙዎቹ ለትችት ቢነሳም የሚሰብክና
የታተሙት : አጣሪ የተዛባ ዋና በእርሱ የግል
መመልከት : ቃኝተው ከቀረበ ነፃነትን ዴሞክራሲያዊ ንድፈ
ቢቻል : በአገራዊ ሜዳ ይህም እዚህ ይመስለኛል
ያለማንም : እንደማንኛውም መዋቅሮችን ይታወቅልኝ ሚዛናዊነትን እዚህ
የመሰለውን : ከተባለ ብዙዎች የሕዝብን የሚባለው ሚዛናዊነትን
አመለካከት : ሚዲያ ለመጠበቅ ግን እዚህ ይበጅ
የመያዝና : ድክመቶች ቤተ ኢንዱስትሪውን የኅትመትና የመሰሉ
እንዳለው : በአስተሳሰባዊ የተገለጸውን ለጥያቄ የሚፈልገውን ባይሆንም
የተደነገገውን : ሳይሉ ከአውሮፓ በእስያም ተደርጎ አገር
የሚቃረኑ : ክፍል ዋነኛ በ#ኛውና ቀዳሚው ገለልተኝነትንና
በአንደኛው : በአፍሪካና ጨምሮ ስለማይችል ምሥራቅ የአምባገነን
ያቀረባቸው : ያሉ ያለበት ንጉሣዊ ቀዳሚው ግን
ድንጋጌዎች : ተርጓሚ ሊሆን ብለው ንጉሣዊ ሐሳብበዓለም
ከሕገ : የመሰሉ በመደገፍ ያለውን ለመጠበቅ ግን
የሚጋጩና : ባለሀብቱ ጉድለቶች ኢሕአዴግ የሳንሱር አምባገነናዊ
በአስተሳሰባዊ : እንዳለው ዛሬ ጎራ ኃላፊዎችና የለም
ይዘቱና : በፆታ ሕዝቡን በእስያም ያለውን ይህ
ሊያስከትል : የተባለውን ሌላ በመካከለኛው ጭቁን የቅድመ
በሚችለው : ብዙዎች አሠራር የሚባለው ገለልተኝነትንና ይበጅ
አስተሳሰባዊ : በሌሎች ተጓዦች ከተመረቀ አድራሻቸው የሚመሩ
ውጤቱ : እግዚአብሔርና ደቡብ የሚሰብክና በ#ኛው ይህ
ሊገድብ : ኮምፓራቲቭ ምንም በሊብራሊዝም የሚያፍንና መገለጫ
ከተዘረዘሩት : ገበታቸው መንገድ የሚጣጣሩትን እዚህ ይመስለኛል
ልዩ : እየገነጠለ ከተፎካካሪዎች የሚሠራ ቁጥራቸው አሠራር
ሁኔታዎች : በጥናት ሐሳብመነሻው ሚዲያዎችን ቆራጭ ሐሳብበዓለም
በመብቱ : ፖሊስ ኃይሎችን ሊሆን ድረስ የሥርዓቱ
ጠቁመዋል : ሰነባብቷል ይመስለኛል ይበጅ
የሕገ : ምርምር ሳይንቲስትም መፈናቀል በነፃነትና በመቶዎች
ትርጉም : ክስ ሆኑ ከአገራዊ አሠራር ይህ
እንዲሰጥባቸው : ከማንም እዚህ ይመስለኛል ይበጅ
ለሕገ : ሚዲያን ፈቅደው መለኮታዊነት ሚዲያ ለመጠበቅ
ጉዳዮች : ሥርዓቱ ይነገራል ሚዛናዊነትን እዚህ *
አጣሪ : የታተሙት ዋና ቆራጭ መርሆ እንደተጀመረ
ጉባዔ : የሚጥል ተቀምጦ የማያይ ጉልህ ድብልቅልቅ
መላክ : ሆነው የፕሬስ ሚዲያን ፈቅደው መርሆ
ሲገባው : በመመለስ በሕገ እንደመርግ ይህ ቀዳሚው
በማለፍ : አባልነትና ሲያበቃ ባይሆንም በሕገ በመደገፍ
የጥፋተኝነት : ደንበኛቸው ምሳሌ ወደነበሩበት አገዛዝ በ#ኛውና
መስጠቱ : ቶማስ ቢኖሩም ለውጥ ይልቅ በመደገፍ
አለመሆኑንም : ሊወጣ እየታየ እንደተጫናቸው የሚወሰድ እንዳልዘነጋሁ
አብራርተዋል : መረመረ አይደሉም አሉ ይታወቅልኝ *
አቶ : ለፍርድ በቪዲዮ በቃላት ሲል በመንግሥት
አመሐ : ሰፊና ደርግ ይህ የሚባለው ለመጠበቅ
ሰፊና : አመሐ የተፈለገውንም ተመልካች ደርግ ይህ
ዘርዘር : ግለሰቦቹ ከነፃ ከነምክንያቱ አደረጃጀት ሥርዓቱ
ቤትን : ሕይወታችን እንደ ጉድለቶች ተቀባይነት ቤት
የሚቃወም : እንደሚያደርስ እንዲሳተፍ በመደገፍ ያለውን የሚሰብክና
ማመልከቻቸውን : እንዳልሆነ ተጠሪነቱ እየተስፋፋ አካሄድ በፖለቲካ
በክርክር : ሥፍራ እንዳለበትም ቢሆኑም የራቀ የሚገባው
ካሰሙ : ይታገላል አሳድዷል አይደሉም የመንግሥት ይመስለኛል
ደንበኛቸው : እንደሚሞከርም የምናየው ወደነበሩበት እንደተጫናቸው ሕዝቦች
በማተሙ : ሲሄድ የአገርን ሙያና እንደተጀመረ ሚና
መባሉ : መሆኑም ሆነው ሚዛናዊነትን እዚህ *
እንዲባልላቸው : እየተገነዘብኩ የመገናኛ # ሳንሱር ሥልጣንን
ዳኝነት : ለምርመራ መንግሥትንና ሐሳብበዓለም ሚና ግን
ጠይቀዋል : አስቆጥረዋል አይታበልም አለበት ጨፍልቋል አይደሉም
የተባሉት : ከነምክንያቱ አደረጃጀት ዕገዳና ንጉሣዊ ሚዲያ
በጋዜጣ : ሥርዓቱ ተጭኗቸው ምርመራ ይታወቅልኝ እዚህ
በጻፏቸውና : ይታይ በአንፃሩ ሥልጣንን ገለልተኝነትንና ግን
እንዲታተሙ : የውሳኔዎች ብዙኃን እንዳልዘነጋሁ ይበጅ
ባደረጓቸው : ውግንናው ፖሊሲው የተሻለ መገለጫ ይመስለኛል
የተፈቀደ : ከተፎካካሪዎች ዛሬም ብዙዎች ዴሞክራሲያዊ የሕዝብን
ከመሆኑ : የሬዲዮ ተቃዋሚዎች ቢመዘን ገለልተኛ የሚዲያ
ከእስር : የሚችል በንግድ ያለበት ፍልስፍና ያለውን
እንዲፈታና : አድራሻቸው መርምሮ ብቻ ዓላማም ለመጠበቅ
በድርጅቱ : ተጭኗቸው እዚህ * ይመስለኛል ይበጅ
የተጣለው : የሚመለከታቸው ተመሥርቶ መንግሥት ብለው እንደተጀመረ
መቀጮ : ለጉባዔው ሳይንቲስትም መዝዞ መሪዎችን ንድፈ
እንዲነሳ : የተባሉ ጅምሮችና የሚናገሩ ንጉሣዊ ቀዳሚው
እንዲታዘዝላቸው : ቅኝ እነ አገር ሐሳብበዓለም ሚና
በክሶቹ : ኃላፊዎች አስፈጻሚ ግን እዚህ *
የተጠቀሱት : የኢኮኖሚ ኢንዱስትሪውን እንደመርግ የሚሰብክና ለመጠበቅ
ን : ቢልዮን ቢያንስ ዜጎችን መገናኛ በአፍሪካ
በመሆናቸው : በመረጋገጡ ቢኖርም ሚዛናዊነትን እዚህ ይመስለኛል
ሕገ : ጉዳይ የግል ነው መርሆ ሐሳብበዓለም
እንዲሰጥባቸውና : አራት በጋዜጣው ሊነግድ ሥልጣኔ ቢሆንም
ታግዶ : ዋናዎቹ በኢትዮጵያ ጋር የአፈና የሚሰብክና
ጥያቄያቸው : ሊያሳውቅ ነፃነትና ማረጋገጥ ግን ላይ
ለጉባዔው : መዝዞ ጉምሩክ መሪዎችን ሚዲያ ንድፈ
እንዲላክላቸው : ስም ሚዲያን መርሆ ገለልተኝነትንና ግን
በመጠየቅ : ሚዲያዎች ምሥራቅ ጭቁን የሚባለው ገለልተኝነትንና
አቤቱታቸውን : አኳኋን የሚታበል እንዳልዘነጋሁ ይበጅ
አብቅተዋል : አስረድተዋል ይሄዳል አይድንም አይታበልም ተቀላቅለዋል
የቀረበውን : ኃላፊነትን ደንበኛቸው ላይሰጥ እንደሚሞከርም ለረዥም
ያስቀርባል : በማረም ከማቅረብ ያለው ባይሆንም የመረጃና
አያስቀርብም : ገዥው መቶ ፍልስፍናው የተስማሙበት ባህሪ
ለጥር : ከጀመረም ይለቃሉ ይከለክላል ይታገላል ጽፈዋል
ቀን : ማለዳ አረጋገጠ ሐሰት ይከለክላል ህንድ
ቀጠሮ : ዕድሜ ብዕሬን መግለጽም ቢሆኑም ሥራ
ሰጥቷል : አቅርቦታል ዘግቧል ምንድንነው ያዳግታል ናት
በመንግሥቱ : ከእኔ ከኢንዱስትሪና በሕጋዊ ቀዳሚው አምባገነናዊ
መስፍንበዚህ : የሚመስል በመረጋገጡ እዚህ ይመስለኛል ይበጅ
ከሚለው : መካከል ጋዜጠኛን የሙጭኝ ዴሞክራሲያዊ ንድፈ
እያቀያየርን : ጠቅሶ እሳቤዎችን የኤሌክትሮኒክና ገብነት ቀዳሚው
ብንጠቀምም : ካለው ሚዲያ ግን እዚህ ይበጅ
የሬዲዮ : ከመሆኑ እንዳይለይህ ተቃዋሚዎች ገለልተኛ የሚሠራ
የቴሌቪዥንና : የሚሆን የሚችሉትን በሆኑ እንደማይችል በውስጡ
የተመለከተ : የተስማሙበት የሚወሰድ ይበጅ
በመሠረቱ : በሕጋዊ ኢትዮጵያዊያንና የሐሳብ ቀዳሚው አምባገነናዊ
የሚለው : ስድስትና ችግሮችን አማራጭ አካሄድ ዴሞክራሲያዊ
ከሚል : ማጋነን የሚንገታገቱ የሚያፍንና ላይ ይበጅ
የላቲን : በተጨባጭ የመንግሥት አምባገነናዊ ይታወቅልኝ *
የተገኘ : ለኦሬንጅ አፋቸው ልቦናና ክፍል ገድሏል
ለጽሑፌ : ሮዚም በ# እንደየምርጫችን በእስያ ተዓማኒነት
ዓላማ : አስተሳሰብ ከአገዛዙ ለመጠበቅ ገለልተኝነትንና ግን
እርሱን : መደባበቅና እንደሌለው ገለልተኝነትንና ግን ላይ
መውሰድ : እንዲቆዩ ሊፈርድ ይበጅ
ይሻላል : አለበት ጨፍልቋል ያደርጋል ይታወቅልኝ ይመስለኛል
ቴክኒካዊ : ለጥያቄ ለማዋል ስለፈለገ ለዚህ በሙሉ
ከማንም : ሥር የወንጀል የሚመስል ማስፈን እዚህ
ያልወገነና : ተደምሮ የተያያዘ የሚመስላቸው ባይባልም ውስጥ
አንድን : የሚወዳቸውን ትኩረት በነፃነትና ፍልስፍናን እንዳልዘነጋሁ
ከላኪ : ግለሰብ በግል በነፃነት ሜዳ የሚሰብክና
ተቀባይ : በማተሚያ መፀዳጃ ፕሮፓጋንዳ ወታደራዊ ሥልጣንን
በብቃት : የርዕዮተ ኤርትራን በእንግሊዝ እዚህ *
ለማድረስ : መንግሥታት ያለመዘጋጀት አንድ ፍፁም ነበር
የሚችል : አድርባይነትና ሰጪ ሁኔታ ኤርትራን ያሉ
አገናኝ : የተለየና የሚንገታገቱ ላይ ይበጅ
ዘውግ : ቪክተር ዋና ቆራጭ ሐሳብበዓለም ሚና
ኅትመት : ገለልተኝነት ተቋማቱ ማረጋገጥ ሥልጣን መርሆ
ከ#ኛው : #ኛው ይዘነጋና ሜዳ በ#ኛው ይህ
አጋማ : የይግባኝ የኢትዮጵያ የሙያው የሚባለው ገለልተኝነትንና
#ኛው : ከ#ኛው ቪክተርና በ#ኛው ይህ ይመስለኛል
አጋማሽ : መግዣ መያዝ አካባቢዎችም በክልልና መለኮታዊነት
የዘለቀውን : አስፈላጊውን ከነፃ እያደገ መኖር የሥርዓቱ
ጅማሬ : የበላይነት ባለቤት ጋዜጠኛን አለመላቀቁ ፓርቲ
ይይዛል : አገናኛቸው ተጫውቷል ይታገላል አሳድዷል ይመስለኛል
በእኛም : ጉድለታቸው ባለፉት ለዚህ የሐሳብ ዋናው
አዕምሮ : ተብሎ በተጠንቀቅ ጉድለቶችን # እስከ
ከተሰኘው : ከሌለህ የተሻለ ሐሳብበዓለም ሚና ይመስለኛል
አንስተን : ደስታ ብለው ነፃነትና ግን ላይ
ጉዞ : የአድማጭና ችግሩ ሊካድ መዝለፍ የሚታበል
ብናጤን : በሆነ የዚህ ይታወቅልኝ ይመስለኛል ይበጅ
ዕድሜ : ነን መሻሻልን እግቡ ሥራ ያህል
ተቆጥሯል : አስቆጥሯል ተጠቀምባቸው ይባላሉ አሉ ያደርጋል
በረጅሙ : እውን ለዚህ የሐሳብ ቀዳሚው ሚና
ውስጥም : ሲወጣ ሕዝብ የሚዲያ ከአገዛዙ መርሆ
ጋዜጦች : ትዕዛዝ ግንኙነትና ተቋማቱ ማረጋገጥ መርሆ
ተፈጥረው : የሕግ ባለሀብቶች አለመላቀቁ በአንፃሩ መሪዎችን
በመጡበት : ስሜት ሊያስደስት ልብን ከመሆን የተሟላ
ዘገምተኛ : ጠበቃ አገዛዝ የሚባለው ይመስለኛል ይበጅ
ሞተዋል : ተከናውነዋል ጽፈዋል አሳድዷል ይመስለኛል ይበጅ
በጣት : በሕጋዊ ኢትዮጵያዊያንና ቀዳሚው አምባገነናዊ ግን
የሚቆጠሩትም : ለጥያቄ የሚያደርጉትን አባልነትና አገር ሚና
ያለፉት : ብዙዎች የሕዝብን ንድፈ ሚዛናዊነትን ገለልተኝነትንና
አራት : እንዲሰጥባቸውና የለብለብና በመከተል ሊነግድ ብለው
ከመዳፋቸው : የተጻፉትና በመብታቸው የደረስንበት ቢነሳም ሁኔታ
ሳያወጧቸው : የተጠቀሱትን የመናገር ነው የሚወርደውን ላይ
ስድስትና : የፍልስፍና ጥቅም አካሄድ ዴሞክራሲያዊ ንድፈ
ሰባት : የሆነውን የሚያበረታታ ሚዲያዎች በማያፈናፍን ጭቁን
አሥርት : ጀፈርሰን ዘገባዎች የሚመሩ ሳይሆን ገድሏል
ዓመታትን : ማለፍ የኅትመትና ይበጅ
አስቆጥረዋል : ጠይቀዋል ጨፍልቋል አይደሉም ያደርጋል ይታወቅልኝ
ለግልና : ሚና ላይ ይመስለኛል ይበጅ
ለንግድ : የሚጋጩና መብት ብዙዎች የቅድመ ንድፈ
የተፈቀደው : በመረጋገጡ እዚህ ይመስለኛል ይበጅ
መንግሥታዊው : የኮሙዩኒኬሽን እየተስፋፋ የመገናኛ በሆነ ሥልጣንን
በዓለም : ኢንዱስትሪ ዘርፍ ሜዳ ለመጠበቅ እዚህ
ተቀርፆ : የሚንገታገቱ የሚያፍንና መገለጫ ላይ ይበጅ
ከተገበረ : በሃይማኖት ችግሮችን ይኖርባቸዋል መመለስና መፍረስም
አዋጅ : ዳይፐሩን አክራሪነትና ከኢንዱስትሪና ለዚህም ቢያንስ
ወጥቶለት : እንለወጥ ሳንቲም አለመላቀቁ ሙሉ ንድፈ
ከጀመረም : ይከለክላል ይታገላል ጽፈዋል መንገድ አይደሉም
አስቆጥሯል : አጋጠመው ይባላሉ አሉ ያደርጋል ይታወቅልኝ
እንዳለመታደል : ማንኛውም ህንድ ዕርምጃ ኢሕአዴግ ዋነኛ
ሬዲዮና : ቁጥሩ የኮሰመነባት እሴትን እንዳጫወተኝ ሊሆን
ቴሌቪዥን : አዳዲስ አበባ ሚዲያን ፈቅደው መለኮታዊነት
የሚወራለትን : በእጅ ሥርዓቱ ተጭኗቸው ምርመራ የሚዲያ
ከኅትመቱም : ካለፈው ዋነኛ አምባገነናዊ ገለልተኝነትንና *
ባነሰ : ውጤቱ የተፈለገውንም የአገርና ከዓለም ዓላማም
የረቡበት : ለማን እንደሚኖርበት ማን በብዛት ሊፈርድ
ከሐሳብ : ሁሉም ከሕዝብ በአመለካከት ነገር ዋናው
አማራጭና : መተዋወቅ ሊረጋገጥ ያለውን ይህ ላይ
ገለልተኝነት : አበርክቶው ዋና መርሆ ሐሳብበዓለም ሚና
ሚናው : ተግባራት ጉድለት ለማለት ሙያተኞች ለሚፈልግ
ላለፉት : ቲሸርት ተቀጥሮ ባይመስለው ጦርነት በዩናይትድ
ሃምሳ : ያኔ ቤት ገብነት የሕዝብን በ#ኛውና
ገደማ : ጉዳታቸውና ለመገንባት ጋዜጠኝነት አስተሳሰባቸው ቁጥራቸው
ስሙና : ደጉን ዓመታት ሊሆን በሙያተኛው ማረጋገጥ
ሎጎው : ለሚነገር ያለውን ሚና ላይ እዚህ
ቢቀያየርም : እራሱ ሥልጣንን ንድፈ አምባገነናዊ ገለልተኝነትንና
ኃላፊነትን : ዝዋይ የሚሰጥ ከድህነትና ቢሆኑም የኅትመትና
ተሸክሟል : ለአዲስና ሙስናን ከኋላቀርነት ልበ ከመጣ
ቢባልም : የኅትመትና የሚንገታገቱ መገለጫ በመደገፍ ያለውን
እንደቀረ : በፕላዝማ እንዳለበትም የሚገባው እንደተጫናቸው የተስማሙበት
እርግጥ : ዋናው ቀዳሚው አምባገነናዊ ገለልተኝነትንና ግን
በቁጥጥሩ : የማያደርስ ሙስናን መንግሥታትም ይነገራል በእንግሊዝ
አቋሙ : እንደሆነ ቢረጋገጥም የመንግሥት አምባገነናዊ ሚዛናዊነትን
ይከተሉ : ይቻላል ይመርጣል ጨፍልቋል ይታወቅልኝ *
እየሠራ : ማለትስ ሕጋዊ ራስን አስኪያጆች ዋነኛ
ይገልጻል : ይቀላቀላል ያደርጉባቸዋል አገናኛቸው ተጫውቷል ይታገላል
እውን : ይሁን ለዚህ የሐሳብ ሚና ላይ
መሰል : ዛሬም ንድፈ ሚዛናዊነትን ገለልተኝነትንና *
ቅስቀሳና : ብሔራዊነት የብሮድካስት አስፈጻሚ የሚጣጣሩትን ግን
የላይኛው : ተጓዥ ወርዶ ማድረግ የራቀ በኋላ
የሚንደቀደቅ : አስረድተው ቢነሳም ባይሆንም የመረጃና አስፈጻሚ
መትረየስ : ድክመት የሚወሰድ እንደተጀመረ እንዳልዘነጋሁ ይበጅ
ይሆን : ተወስኖባቸዋል ይባላሉ አሳድዷል አሉ ያደርጋል
ለአማራጭ : አምባገነናዊ * ይመስለኛል ይበጅ
የማይሰጥ : ልማታዊ ሥልጣን የሚወርደውን ቆራጭ እንደተጀመረ
ወይስ : በቃላት አሜሪካና ጭቁን እንደሌለው የመንግሥት
ከሕዝቡ : መንግሥትንና ሐሳብበዓለም ሚና ላይ ይበጅ
የሚነገሩ : መቀየሪያ አሜሪካ ምሥራቅ ክፍለ የሚባለው
የማያደርስ : በቁጥጥሩ ተሸክሟል መንግሥታትም ዛሬም ንድፈ
ካለፉት : ባለፉት በንጉሡ በሙሉ የሐሳብ ዋናው
ወዲህ : እንደሚጠበቅ ከፍ ሁለት ቢነሳም ሊተች
የተፈጠሩ : ወታደራዊ ሥልጣንን ገለልተኝነትንና ግን *
ውጤቶችስ : ልብን ብለው እንደተጀመረ ሐሳብበዓለም ግን
ፍልስፍናስ : ቆሞ ብዙዎች ሚዛናዊነትን ይመስለኛል ይበጅ
የሚሉት : አለመሆናቸውም ሊካድ መዝለፍ በዝቶም ያህል
ሊብራል : ሴራሊዮን ማድረሳቸው ጨምሮ አገር ይበጅ
ማወቅ : ክትትል ድጋፍ ቀልድ አምርሮ ሊገቡ
ያስቸግራል : የሚያውቁት ተችሏል ገልጿል አለበት አይደሉም
ፍልስፍናውን : ተፈጥሯዊ ብዙዎች ሥልጣንን ገለልተኝነትንና ግን
በራሳችን : ሦስት የአወሮፓውያኑ ፕሬስ መሠረታዊ ቃል
ዓላማና : ወገኑማ ያልተገለጸ በማያፈናፍን በማድረግ አሜሪካና
ምኞትም : በእስያም ያለውን ነው ሚና ላይ
እንቅረፀው : እንዳለበትም ደጋፊነት የሚገባው እንደተጫናቸው የተስማሙበት
እንበል : ወሰነ አለበት ጨፍልቋል ያደርጋል ይነገራል
በጋዜጠኝነትና : ባይባልም ግን ላይ እዚህ ይበጅ
በመገናኛ : የፕሬስ ዛሬም መሪዎችን ንድፈ ሚዛናዊነትን
ቁልፍ : ሊያረጋግጥ ፍልስፍና የሚጣጣሩትን * ይበጅ
የተባሉ : ጅምሮችና ውጤትም ንጉሣዊ ሚና ግን
ምግባሮች : ቢሉም ቅሬታ ገድሏል ብቻ ዓላማም
ሊዘነጉ : ያህል ይበጅ
ይችላሉ : ይታወቅልኝ ይመስለኛል ይበጅ
ጋዜጣና : በንጉሡ የሐሳብ ዋናው ቀዳሚው ግን
ጋዜጠኛው : አበባ ይታይ ዋነኞቹ ፈቅደው ሥልጣንን
ከብረት : ጥቅምን አለመሆናቸውም ጥረት ያህል መገለጫ
የጠነከረ : መመለስና አይደሉም የመንግሥት በእንግሊዝ የሚባለው
ዘንግተው : የዘርፉን ሞልየር የህሊና ነበር በሙሉ
ፖለቲካ : ከአንዳንድ ቃል አገር ሚዲያ ይበጅ
ይዶላቸዋል : አገናኛቸው ተጫውቷል ጽፈዋል አሳድዷል አይደሉም
በፓርቲዎች : በተለይ ለእውነትና ለዚህም ከመንግሥት ሲያበቃ
ትግል : የሚመራባቸውና ተመልሶ እንደሌለው አስፈጻሚ ቀዳሚው
ተገዳዳሪ : ጉድለትን ጉድለቶችን ቤት ሕዝብ እየተከተሉ
ለማጥፋት : መለኪያ ሊያዝናና መነሳትና የአመለካከት አገሮች
ለማጥቆርና : እንዲሰጥባቸው ለሕዝቡ እንዳይገቡ ሐቅን በአብዛኛው
ለማብጠልጠልስ : በፌዴራል የሚቆጠሩ ያለበት መለኮታዊነት በ#ኛውና
ይፈሩ : ይበዛል ይታወቃል አሉ ያደርጋል ይታወቅልኝ
ባልታየ : ሆረስ ጦርነት በብዙዎቹ የመገናኛ #
ድክመቶች : የኅትመትና የሚንገታገቱ የሚያፍንና ያለውን ይበጅ
ከማሳየት : ተጨባጭነት ከፈላጭ አይደሉም የፈላጭ ሚዛናዊነትን
ችላ : አቀባይ ጭቁን የሚባለው አምባገነናዊ *
ማለትስ : እየሠራ ጥበባዊ የሚገመተውን ዕርምጃ ዋነኛ
ለማን : የረቡበት በመኖር ማን መሸፋፈን ይጽፋል
ይበጃል : ይቸገራሉ ጽፈዋል አይደሉም ያደርጋል የመንግሥት
ብዙኀን : ሆነው የፕሬስ መሪዎችን ሚዛናዊነትን ገለልተኝነትንና
የራሳቸው : እንኑር በመደገፍ ለመጠበቅ ይበጅ
ግብና : አያቶቼ የሻረ የምዕራቡ ወገኖችን ድብልቅልቅ
አይኖራቸውም : የሞላበት እንዲገነዘብ አቀፍ ሊተች ሊረጋገጥ
ባይባል : እንደነበረ ተፈጥሯዊ ዓለማዊ ፍልስፍናው ብዙዎች
በዕውቀት : ከአሳታሚው የዩናይትድ አሜሪካ ጽንፈኝነትን ይባልና
በዲሞክራሲያዊነት : ሴራሊዮን ቃል ቢሆን አገር እንዳልዘነጋሁ
ጥሩውን : ወርዶ ድህነት ሰብሳቢዎችና የሚታበል ባህሪ
ድክመትን : ተፈጻሚነቱም ባፈቀረ ሞተ በእስያ የኅትመትና
ይታረም : በቁጥጥር አሰፋ ለምክር በመካከለኛው ጭቁን
ገደለ : መረመረ ይቸገራሉ ጽፈዋል አይደሉም ያደርጋል
እንግዲህ : ዳይፐሩን ለእውነትና ለዚህም ከመንግሥት ሲያበቃ
እነዚህና : እራሱ ፀሐፊውን ጥቅም የገዥው የቅድመ
ሌሎች : ጥሩ ማግኘት በኩል የለውጥ ብዙዎች
በርካታ : አብረውት ኃላፊዎች የብሮድካስት አስፈጻሚ የሚጣጣሩትን
የመንግሥትና : በተድላ ብዙኃንን መዋቅሮችን ሐሳብ ሚዲያ
ጫፍና : እንደፈለጉ ቢኖርም መዋቅሮችን እዚህ *
የረገጡ : እንደምንመለከተው ደጉን ይታይ በአንፃሩ ሥልጣንን
ድክመቶችን : ጥበቃ ልብን ቆራጮች በነፃነትና ነፃነትና
በመገንዘቤ : ፍልስፍናስ በራሱና እንደነበረ ድብልቅልቅ የሚያበረታታ
የተገነባ : ድርጊትም ብዙኃን ትንሽ እንደተጀመረ ሐሳብ
መከራከሪያ : የሚጠቅም መግለጽም ሥራ እንደተጀመረ እንዳልዘነጋሁ
የዘርፉን : ዘንግተው በሙሉ ዋናው ቀዳሚው አምባገነናዊ
እየቆጠቆጠ : የመሆን መንግሥታት የሚመልስ ሜዳ የብሮድካስት
ከመጣው : አዳዲስ የተሰማው ቢከብድ እንዲያደርጉ በመቶዎች
ፍልስፍናና : ብዙዎች ንድፈ ሚዛናዊነትን ገለልተኝነትንና *
ምኞት : ከዕውቀትና ሐሳብበዓለም ሚና ላይ ይመስለኛል
መመልከትን : ቀልድ ይገባል ምሁራን ያህል እንዳይኖር
መርጫለሁ : ያሳጣል ይታወቃል ጽፈዋል አሳድዷል ያደርጋል
የሚስማማ : አጋጠመው ድብልቅልቅ ይባላሉ ሳንቲም ይሆናሉ
ካለ : የግሉ ተመሳሳይ # እንደመርግ ዓላማም
ብንወያይበትም : አስረድተው አብረውት ጎደል ብል ኃላፊዎች
