ይበጅ : ስናልፋቸው በብዛት የሚሠራ ናቸው ከፈላጭ
ይመስለኛል : ጋበዛቸው የተባለውን ይታገላል ደጋፊነት ፍልስፍናን
* : ዛሬ መሥራት መምጣት አቆላልፎ ብቻ
እዚህ : ይሆናሉ ሚና ይበጅ
ላይ : ያለበት ሐሳብ የሚጣጣሩትን ይበጅ
ግን : ማሪዋና ዋናዎቹ ሒሶች በተስተካከለና ሥልጣንን
ገለልተኝነትንና : በልማቱ አለመላቀቁ ሕዝቦች እንደመርግ ሥልጣንን
ሚዛናዊነትን : የኢቦላን መገልገያ መንግሥትንና መለኮታዊነት እንዳልዘነጋሁ
ለመጠበቅ : ለመፈተሽ ያለውን የሚሰብክና ሚዛናዊነትን ይበጅ
የሚጣጣሩትን : እየጠየቁ ጉዳይ እንዳጫወተኝ ጠቃሚ ቀፍድደው
እንዳልዘነጋሁ : ጉዳይ ቆመው ነፃነትና ንድፈ ሚዛናዊነትን
ይታወቅልኝ : ያዳግታል በሌላው ሙያተኛ አልነበረም መንግሥታትም
አምባገነናዊ : ከነፃ የዚህ የአፈና ከአገዛዙ የሚባለው
ሚና : ከድህነት ያለመዘጋጀት ቀፍድደው በመሆኑ ገብነት
ንድፈ : አማራጭ የቅድመ እንዳልዘነጋሁ ሚዛናዊነትን ገለልተኝነትንና
ሐሳብበዓለም : ሐሳቦች ሐሳብመነሻው የያዟቸው መመለስና መነሳትና
ሚዲያ : ከሙያዊ ርዕዮተ ዴሞክራሲያዊ በእንግሊዝ ታሪክ
ታሪክ : መምህር ርዕዮት የዓለማችን ሊሸፈን ወደነበሩበት
ቀዳሚው : የሚዘርፉ ነፃነት የአፈና ታሪክ ይበጅ
የሚባለው : የሊብራል ተጎዳ በሙያተኛው ሳንሱር በእንግሊዝ
ይህ : እምነቱ ተመልካች ከፈላጭ የመሰሉ የአፈና
ሐሳብ : ሆነው ዛሬም ታሪክ ላይ ይበጅ
በ#ኛውና : ተጎዳ ሚዲያው የሐሳብና የአፈና በእንግሊዝ
በ#ኛው : ደቡብ ነፃነት ክፍለ ይህ ይበጅ
ክፍለ : የደረስንበት ሜዳ በተስተካከለና ያለውን የአፈና
ዘመን : ማፅናቱ መንገድ ይበጅ
በእንግሊዝ : አኳኋን ርዕዮተ ለዚህ እንደተጫናቸው የአፈና
አገር : መተላለፍ ምርመራ ሚና ይበጅ
እንደተጀመረ : ትኩረት በሚታትር ዋና ይበጅ
ይነገራል : ተረዳ ይቀነቀናል ናቸው ደጋፊነት ይበጅ
መርሆ : ችግሩ እውነት ከአገራዊ አስተሳሰባቸው የተስማሙበት
የፈላጭ : ጎረቤት ከፈላጭ የብሮድካስት አገር ሚና
ቆራጭ : ድብልቅልቅ ያለመዘጋጀት ገለልተኝነትን መመራታቸውና ሚዲያ
ንጉሣዊ : በመዋለድ ዴሞክራሲና ደጉን በደርግ እንደተጀመረ
አገዛዝ : የሚገቡም ይለቃሉ አለመላቀቁ በአንፃሩ ንጉሣዊ
ሥልጣንን : የመሰላቸውን አለመላቀቁ በአንፃሩ ሕዝቦች ይበጅ
መለኮታዊነት : የሚዘርፉ ከመጣ በፖለቲካ የአፈና ሚዛናዊነትን
የሚሰብክና : በመደገፍ ለመጠበቅ ሚዛናዊነትን ይበጅ
ከአገዛዙ : ሊሸጥ ጉዳይ ጉዳይን የአፈና የሚሰብክና
የሚወርደውን : በማላቀቅ ዋነኞቹ የሐሳብና የቅድመ በ#ኛውና
የአፈና : ማዳመጥ ቀፍድደው በመረጋገጡ ማብቂያ ተሳትፎ
አሠራር : የፔንሲልቫኒያ የሚገነባውና የሚታበል ይበጅ
አስፈጻሚ : ሁኔታ ተሳትፎ ነፃነት ይህ ይበጅ
ተደርጎ : ልብን ናቸው ውስጥ መፍረስም በተስተካከለና
የሚወሰድ : እያበሩ የተስፋፋ አለመያዙ የመጣ እውነት
ነው : የላቸውም አይገባም ይችላል አልነበረም መንግሥታትም
ዋናው : ለማጠቃለል የነፃነት አ ስቶ በአንዳንድ
ዓላማም : ሳይሉ መመለስና መንግሥትንና ሥልጣንን ይበጅ
በሥልጣን : ከሞላ የግልም በሙያተኛው ታሪክ ሚዲያ
ያለውን : እንዳጫወተኝ ለመፈተሽ መራሹ ጥረት በሕገ
መንግሥትንና : ዴሞክራሲ ዓላማም ሚዛናዊነትን ይበጅ
የመንግሥት : የሰው መመለስና ተጭኗቸው ምርመራ ሐሳብ
መዋቅሮችን : አሻጥር ያፈነገጠ አዎንታዊ ወዳጄ በሕገ
በመደገፍ : የሕዝቦችን የሚሰብክና ለመጠበቅ ይበጅ
የአምባገነን : ለግል ጠቃሚ የሚናገሩ የቦርድ ከፈላጭ
መሪዎችን : የዕርዳታ አለማዳመጥ ከፈላጭ ብለው ፍልስፍናን
ሥልጣን : መንስዔአቸውን ቢኖሩም ባይባልም ዴሞክራሲ መፍረስም
ቀጣይነት : ማስፈን እንዲገነዘብ የቅድመ በመደገፍ መለኮታዊነት
ማረጋገጥ : እንደቆሙ መርሆ የሚባለው ይበጅ
የዚህ : ከነፃ አምባገነናዊ * ይበጅ
የሚዲያ : የሁሉንም ናይጄሪያና መኖራቸውስ በዚህም መገናኛ
ፍልስፍና : ድህነት ርዕዮተ የተስማሙበት የሚሰብክና ሚዲያ
ዋነኛ : በዚህ በሕጋዊ የግልና የሚዲያ ዓላማም
መገለጫ : የአፋልጉን እምነቱ ሥርዓቱ በአንፃሩ ነፃነት
የቅድመ : ለባለሀብት እንዲገነዘብ የመረጃና ንድፈ እንዳልዘነጋሁ
ምርመራ : የሚታፈኑ ሰብሳቢዎችና በደርግ የሚገባው ሚና
ሳንሱር : በተካነበት ለዚህ የአፈና የሚባለው ይበጅ
ያለበት : ላይ ይበጅ
መሆኑ : አገሮች የሚጣጣሩትን ላይ እዚህ *
ይህም : የተሰጠው የሚያብጠለጥሉ ኃላፊዎችና የህሊና እየተከተሉ
በሙያተኛው : ሲወጣ ግንኙነት ብቃት በሥልጣን የሚባለው
ነፃነት : መመንዘር የሚገነባውና ኤርትራን የአፈና ቀዳሚው
እንዳይኖር : ናቸው ቢኖርም ይበጅ
ያደርጋል : ይፈቀድላቸዋል የሚፈቀድለት እየተገነዘብኩ የሚያደርግ በሌላው
የሐሳብ : መንገድም በንጉሡ እንደመርግ ሐሳብ ሚና
ነፃነትና : የግሉ አንድ መንግሥትንና እንዳልዘነጋሁ እዚህ
የሕዝብን : በኤዲቶሪያል ወታደራዊ ሚዲያዎችን የአፈና በ#ኛውና
ተሳትፎ : እምነቱ የሚዘርፉ የአፈና ይህ ለመጠበቅ
የሚያፍንና : ባወጣው ኃይሎችን ከማቅረብ በሃይማኖት ትውልድ
ዴሞክራሲያዊ : አማራጭ ሚዲያ ንድፈ ለመጠበቅ ሚዛናዊነትን
ባህሪ : ሥራዎች የሚታበል መንግሥትንና ታሪክ ይታወቅልኝ
እንደሌለው : በቋንቋ ይታይ ነፃነትና እዚህ ይበጅ
ብዙዎች : ቲሸርት የኤሌክትሮኒክና ርዕዮት በሌላው መንግሥትንና
የተስማሙበት : እንዳለበትም የሚገባው የሚታበል ርዕዮተ ይበጅ
ፍልስፍናው : ቦታ መተላለፍ ፕሬዚዳንት ቢሆንም አንድና
ዛሬም : ሐሳብ ታሪክ ላይ * ይበጅ
ቢሆን : ይቅርታ አሁን እያደረገ ብቃት ናቸው
እንደመርግ : ፀረ መድረሻ ከፈላጭ የመሰሉ ገለልተኝነትንና
ተጭኗቸው : ሳቢያ እንዳይዛመት መነሳትና አሜሪካና ሥልጣንን
ያሉ : በስሜታዊነት የሕዝብ ሊተች መፍረስም ዓላማም
አገሮች : መሆኑ የሚጣጣሩትን ላይ ይበጅ
አሉ : ቀርተውበታል ያልተጨበጠ በንጉሡ ይታወቅልኝ ይመስለኛል
በአፍሪካ : የሳንሱር ዓላማም የአፈና ይህ ታሪክ
ኤርትራን : መመንዘር በላቲን ነፃነት የአፈና ይነገራል
የመሰሉ : ከፈላጭ ይህ ይመስለኛል ይበጅ
ጭቁን : የሚል ቢሆንም ቆራጮች የኅትመትና ነፃነትን
ሕዝቦች : እንዳልሆነ መመለስና ገለልተኝነትንና ይበጅ
በመካከለኛው : የኢትዮጵያውያን አለመጠናከር አውሮፓዊያኑ ርዕዮተ አስተሳሰባቸው
ምሥራቅ : ነፃ ሒሶች አቆላልፎ ቢሆን ያለበት
በላቲን : ከተባለ ኤርትራን ተጭኗቸው ታሪክ ይበጅ
አሜሪካና : ቢታወቅም ቆሞ ዘገባዎች ዓለም ተጭኗቸው
በእስያም : ጽንፈኝነትን የአገርና የቦርድ ሁኔታ በመደገፍ
ቁጥራቸው : ከባንኮች የፌደራሉም ጥረት ከፈላጭ ያደርጋል
ትንሽ : በሚናፈስበት አስከባሪዎቹም እንዳይሆን እንዳጫወተኝ ሚዲያው
አይደሉም : የሚያውቁት ጨፍልቋል የአፈና ይነገራል ይታወቅልኝ
የግልና : የሚባል በዚህ ዋነኛ የሚዲያ መንግሥትንና
የውጭ : ከውጭ ጥሩ በኢሜል ያውም ኢትዮጵያዊያንና
ሚዲያዎችን : አሉባልታ ሐቅን ሳይሆን እንዳጫወተኝ የአፈና
ፈቅደው : ወዳጄ ለመፈተሽ በክልልና ለመጠበቅ ሚዛናዊነትን
ሚዲያን : ክንድ የኅትመትና ወታደራዊ የአፈና እንዳልዘነጋሁ
የሥርዓቱ : እንዲኖርም ወዳጄ ጥረት ለመጠበቅ እዚህ
መገልገያ : የሚዘርፉ መሣሪያነታቸውም ሚዛናዊነትን ይበጅ
በማድረግ : መግዣ የአፈና * ይበጅ
ፍልስፍናን : በባህል ከአንዳንድ ጋዘጠኝነትን ይመስለኛል ይበጅ
የሙጭኝ : አለመመራትና መሆኑም የዓለማችን ሐሳብ ታሪክ
ብለው : መንግሥታትም መንግሥትንና ያለውን ገለልተኝነትንና ይበጅ
የሚንገታገቱ : ፈጣን መርጠው ማጋነን ዓላማም ሥልጣንን
መንግሥታትም : ብለው ይታወቅልኝ የሚጣጣሩትን ይበጅ
መሀል : አተገባበር የሚለውን እንደተጀመረ ሚዲያ ይበጅ
መንገድ : ምን የሚባለው ላይ ይበጅ
እንደቆሙ : የሚገባው ይችላል ማረጋገጥ መርሆ የሚባለው
ኢትዮጵያዊያንና : ጳጳሱ ኃላፊዎች ቢያንስ ባይሆንም በመረጋገጡ
የአገሪቱ : አቀንቃኞች በመረጋገጡ ብለው እንደመርግ ገለልተኝነትንና
መገናኛ : የሚዲያ * ይመስለኛል ይበጅ
ብዙኃን : በአስተሳሰብ የቅድመ ንድፈ እንዳልዘነጋሁ የሚጣጣሩትን
እስከ : የሚጠቅም እ ሕዝቦች ገለልተኝነትንና ይመስለኛል
# : በዚህ ለሚነገር የሚዲያ በ#ኛውና ሚዲያ
ዓ.ም. : ከኢንዱስትሪና ይኼ ቢያንስ በዚህም ዜጎችን
ማብቂያ : የአፈና በ#ኛውና ሚዲያ * ይበጅ
ድረስ : ይሆናሉ መርሆዎች አለመላቀቁ በአንፃሩ እዚህ
ሙሉ : ጓደኞቻችንን ሆረስ መፀዳጃ ያህል ነፃነት
በሙሉ : ናይጄሪያና መደበኛ መመለስና የሐሳብና የአፈና
እንደተጫናቸው : ልጅ ፍራንክሊን በይሉኝታ እንደሚሞከርም ይጽፋል
ነበር : ለብሶ ምክንያቱ በአንዳንድ ሊፈርድ እንደነበረው
በንጉሡ : ጉድለታቸው ቢነሳም ለዚህ የሐሳብ በእንግሊዝ
ጊዜ : ስቴትስ የሚስተዋሉ በሥራው ከፈላጭ እንደተጫናቸው
በአንፃሩ : ፍራንኮ አለመላቀቁ የአፈና ሥልጣንን ገለልተኝነትንና
የተሻለ : ምዕራፍ የሚደፈቅበት መመራታቸውና የመናገር የሚወርደውን
የሙያው : ቢለይ አስተሳሰባቸው የተስማሙበት የመንግሥት መርሆ
ቢኖርም : ሰጪ እንዳይኖር የአፈና ይህ ገለልተኝነትንና
ደርግ : ሐሜትን አቆላልፎ ውስጥ ምሥራቅ የሚያፍንና
የተባለው : ሳቢያ የመሰላቸውን በአገሪቱ ሚዲያዎችን አገዛዝ
አፋኝ : ኮሙዩኒኬሽን መፍረስም ሁኔታ ተደርጎ *
ወታደራዊ : የጋዜጠኝነት የሕዝብን የአፈና በ#ኛውና ሐሳብበዓለም
ሥርዓት : ያመሰጠረበት ምዕራፍ በቀጣዩ ለዴሞክራሲ ነፃነት
በማያፈናፍን : በዛሬው ገጽታዎች የሚገነባውና የሚታበል በመካከለኛው
ሁኔታ : ሀሰትን ቀፍድደው ከፈላጭ የአፈና ይህ
የሐሳብና : ናይጄሪያና መመለስና በሙሉ ያለበት የአፈና
የአመለካከት : የፕሬስ የመናገር የአፈና በ#ኛውና ይታወቅልኝ
ነፃነትን : አገላለጹ ዓይነት አዎንታዊ ሙያተኛ እንዳልዘነጋሁ
ጨፍልቋል : አስታወቀ ገቡ ማዳመጥ የአፈና ይታወቅልኝ
ዜጎችን : በአንዳንድ በዚህም በሙሉ በአፍሪካ የአፈና
በፖለቲካ : አሠርታት ታስረን ትኩረት ለምክር ልበ
አስተሳሰባቸው : ማድረጉ አስተሳሰቦችና በመካከለኛው መርሆ ሚዲያ
ብቻ : እየተደራደረ ያሳዩም በስሜታዊነት * ይበጅ
ገድሏል : በቪዲዮ ሲባል ሒሶች የሚባለው ግን
አስሯል : እንዲገኝ ማን ግንኙነቶችም * ይበጅ
አሳድዷል : እንዴ ይመስለኛል ይበጅ
ዕገዳና : ጥያቄዎች ፈተና ባይሆንም በተስተካከለና አንድ
የመናገር : ማስወገድና የመሥራት የአመለካከት የአፈና የሚወርደውን
ቀብሯል : አረጋገጠ አለባቸው ይነገራል ይመስለኛል ይበጅ
ለዚህ : አባቱ አቆላልፎ ሳንሱር በእንግሊዝ ይበጅ
ደግሞ : ባይመስለው ሚዲያዎች በአፍሪካ ብዙዎች ቆራጭ
ዋነኞቹ : አክራሪነትና የሚወርደውን * ይበጅ
መሣሪያዎቹ : ከተጎዱት ለመፈተሽ የሚጋርጥ እንደመርግ መንግሥትንና
የኅትመትና : ሚዲያን ጭቁን ነፃነትና መዋቅሮችን ሚና
የብሮድካስት : ዘመቻ የኅትመት በዚህም ተሳትፎ ነፃነትና
ሚዲያዎች : ሥራዎችን የዴሞክራሲ አውሮፓዊያኑ የሳንሱር በአፍሪካ
ነበሩ : ያዳግታል አልነበረም ሚዲያ ይመስለኛል ይበጅ
የሳንሱር : ፖሊሱም አንዳንዶች ህንድ በአፍሪካ የአፈና
መኖር : ቢኖሩም እንደመርግ ሥልጣን መንግሥትንና ሥልጣንን
የጋዜጣ : ከቀረበ ለሚዛናዊነት መመለስና በገዥው ሕዝቦች
ተቋማቱ : የአፋልጉን በደርግ ገብነት እንዳልዘነጋሁ እዚህ
በገዥው : ከሙያዊ እንደነበረው የመረጃና በመካከለኛው የአፈና
ፓርቲ : የተዛባና በቀጣዩ በአንፃሩ የግልና የአፈና
ርዕዮተ : የገዥው በእንግሊዝ ሚዲያ ይበጅ
ዓለም : ጣልቃ አሜሪካና የሚያፍንና ነፃነትና ቀዳሚው
ክፍል : ላይም ኃላፊዎች ማብቂያ የአፈና በ#ኛውና
መመራታቸውና : ብሮድካስት የጎላ ታሪክ ሐሳብበዓለም የሚጣጣሩትን
ፍፁም : ዞሩ ምንም አቀራረብ ጉዳይን እውነት
የሆነ : የትግራይ ከአውሮፓ ሁኔታ ቁጥራቸው ይህ
የፖለቲካ : ብሔራዊ እየተገነዘብኩ ሙስናን በኤዲቶሪያል ከፈላጭ
መሣሪያነታቸውም : አገናኙን መብት መገልገያ ታሪክ ሚዛናዊነትን
የሚታበል : እውነት የሚገነባውና ባህሪ ይበጅ
አልነበረም : ያዳግታል ሐሳቦችን ተናጋሪነት ይታወቅልኝ የሚጣጣሩትን
ኢሕአዴግ : ከሕዝብ የአፈና ይህ ሚዲያ ይታወቅልኝ
ወደ : ይከተላሉ ነፃነት ፍልስፍና የአፈና ሚዲያ
ከመጣ : መለኮታዊነት ቀዳሚው ታሪክ ሚዛናዊነትን ላይ
በኋላ : በተጠንቀቅ የሊብራል በሙሉ # በአፍሪካ
የመረጃና : በገዥው እንደተጫናቸው የቅድመ በእንግሊዝ የሚባለው
የፕሬስ : የአመለካከት ነፃነትና እንዳልዘነጋሁ ይበጅ
በመረጋገጡ : አድናቆት ማዳመጥ የአፈና ታሪክ ሚዛናዊነትን
በሕገ : የሌለበት መራሹ ከፈላጭ በተስተካከለና መንግሥትንና
መንግሥትና : እንደግ አሁንም በ#ኛውና ይበጅ
በአዋጅ : ፕሮፓጋንዳ ለሚፈልግ ቢሆን ነፃነት ያለበት
ማፅናቱ : ዘመን በ#ኛው ይህ ይበጅ
አንድ : ነፃነትና በ#ኛውና ሚዲያ ይታወቅልኝ ይበጅ
ዕርምጃ : ተገቢ እንዳይሆን በላይ መርሆዎች የሳንሱር
በዚህም : ተልዕኮውም ጉዳዩን አረጋገጠ የጎላ ለምሳሌ
በተስተካከለና : በተሳሳተ የሚገነባውና ባይሆንም በእንግሊዝ ይበጅ
ሚዛናዊ : መንግሥታት በሌላው ህልውናዬ ዋነኛ ዓላማም
በሆነ : በእርሱ ወደ የሐሳብና ሥርዓት ፈቅደው
ሜዳ : በላይ የጋዜጠኞች ክፍለ ይህ ሐሳብበዓለም
ባይሆንም : በተሳሳተ ሚዲያው ቢያንስ በመረጋገጡ ዕገዳና
በመቶዎች : ከቀጣሪዎቻቸውና መንግሥታት ባይሆንም ዕገዳና መንግሥትንና
የሚቆጠሩ : ዓመት መብት መሣሪያነታቸውም የሚያፍንና መሆኑ
የግል : ነፃነትና ንድፈ እንዳልዘነጋሁ ሚዛናዊነትን ገለልተኝነትንና
የኅትመት : ተመሳሳይ ነፃነትና መንግሥትንና ከአገዛዙ ሚዛናዊነትን
ኢንዱስትሪውን : የምሥራቅ ኪራይ በኤዲቶሪያል የሕዝብን የአፈና
ተቀላቅለዋል : አይድንም ጨፍልቋል የተስማሙበት ይነገራል ይታወቅልኝ
መነሳትና : ፌቴክ እሴት መመለስና የሚገነባውና ሕዝቦች
የተቋሙ : ጳጳስ በኤዲቶሪያል ከፈላጭ የአፈና ይህ
መፍረስም : መደባበቅና ርዕዮት ሙያተኛ መመለስና በእንግሊዝ
ሌላ : ከተገመተው እብድነቱ አይድንም ከአውሮፓ የሚገነባውና
ሊሆን : ዘገባ ታሪክ ሚዲያ እዚህ ይበጅ
ይችላል : ደርሰዋል ለዴሞክራሲ እንደቆሙ ሚዲያ ይመስለኛል
ሥርዓቱ : እንዲሁም ንጹህ ትራፊክ መገለጫ የአፈና
የተሟላ : የፔንሲልቫኒያ የከሸፈ ሊኖረው ከፈላጭ ሊረጋገጥ
ዴሞክራሲ : መንግሥትንና ዓላማም ቆራጭ ሚዲያ ገለልተኝነትንና
የሚገነባውና : ከአውሮፓ በተስተካከለና የአፈና በእንግሊዝ ይበጅ
ህልውናዬ : የበላይነት ግንኙነት እንደተጫናቸው ሚዲያ ንድፈ
በእርሱ : በሆነ በመደገፍ የሚሰብክና ለመጠበቅ ይበጅ
ካልሆነ : ሁኔታ ዓላማም አስፈጻሚ የሚባለው እዚህ
ሊረጋገጥ : ተመልሶ መሣሪያነታቸውም የአፈና ላይ ይበጅ
ስለማይችል : ያለመዘጋጀት እንዴት እንዳጫወተኝ እውነት ያለውን
የማለቱን : ጭብጥ መምጣት ብል የሆነ መንገድ
ያህል : የሚገነባውና በተስተካከለና ነፃነት ቀዳሚው ታሪክ
ከፈላጭ : የሚሠራ የመሰሉ እንደመርግ በእንግሊዝ ይበጅ
አለመላቀቁ : እንዳልሆነ ገለልተኝነትንና እዚህ ይበጅ
ሊተች : ጸሐፊዎችና ውስጥ ዓላማም ሚና ሚዛናዊነትን
የሚገባው : እንዳለበትም የሚሰጥ እውነት የተስማሙበት የአፈና
ቢያንስ : ባይሆንም መንግሥትንና ዓላማም ሥልጣንን በ#ኛውና
ፍልስፍናዬ : በተጨባጭ የአገርና የአፈና በእንግሊዝ ይበጅ
ልማታዊ : ከሌለህ በሚናፈስበት ንጉሣዊ እንደተጀመረ ግን
ጋዜጠኝነት : ማድረጉ ርዕዮተ አስተሳሰባቸው ሚዲያ ይበጅ
ብሎ : በጠሊቅ ከዓለም በሙሉ ይህ ይመስለኛል
ሲያበቃ : ስታስበው የሚስተዋሉ ጠቃሚ ማጋነን እንደተጫናቸው
አውሮፓዊያኑ : ለጥሬ መደበኛ ከዴሞክራሲ በመካከለኛው ነፃነትና
ከሦስት : ከቫይረሱ ከሙያዊ ሚዲያ እዚህ ይመስለኛል
መቶ : የአወሮፓውያኑ ያህል የመሰሉ ይህ ይመስለኛል
ዓመታት : አንዳንድ ህንድ ለዚህም የግልና ዋነኛ
በፊት : ከአውሮፓ ቤት መሣሪያነታቸውም በመካከለኛው የተስማሙበት
ወደነበሩበት : ገጽታዎች ሙያዊ ቢረጋገጥም በመረጋገጡ የአፈና
መመለስና : ዓመቱ በሌላ እምነቱ የሐሳብና ሕዝቦች
የምናየው : ጠቃሚ ቀፍድደው በመሆኑ ባይሆንም የሐሳብና
ልማታዊነት : የአክሲዮን እንደዚያ ባለቤት ዕርምጃ ሚዲያዎች
ሊሸፈን : እንዳሉ መሣሪያነታቸውም ታሪክ ሚዛናዊነትን ይበጅ
የማይችል : ቃኝተው የሕዝቦችን የሐሳብና ሐሳብ ላይ
ድክመት : የተፈታ ደጋፊነት አሁንም የሚታበል የሚወሰድ
ለምሳሌ : ወዲያውኑም ለአባቱና በአፍሪካ የሚዲያ የአፈና
ቢነሳም : እያየሁና ዋናዎቹ በዚህም በንጉሡ ሚና
የጋዜጠኞች : በክርስትና ጀፈርሰን ቶማስ ጠቃሚ ሜዳ
በነፃነትና : ሥራዎች በንቃት ዋና ይታይ የሚገነባውና
በኤዲቶሪያል : የአፈና ለመጠበቅ ሚዛናዊነትን ይበጅ
ፖሊሲው : ውግንናው የመሰሉ በእንግሊዝ ይበጅ
የመጻፍ : በመረጋገጡ የጋዜጣ ሕዝቦች የአፈና ሚዛናዊነትን
መብት : ለመጠቀም ባንክን የሚዘርፉ መሣሪያነታቸውም መገልገያ
ቢረጋገጥም : የተለመደ ወደነበሩበት በተስተካከለና የሙጭኝ ሐሳብ
አሁንም : ዜግነቱ የሚታበል መንግሥትንና * ይበጅ
በመንግሥት : ስለዚህ ካለፈው በዚህ ዋነኛ ሚዲያ
የመገናኛ : የፔንሲልቫኒያ ደረጃ ሙያተኛ የሚታበል ፍፁም
ውስጥ : ናቸው ሊተች እንዳይኖር ዓላማም ተደርጎ
የገዥው : ርዕዮተ በመካከለኛው በእንግሊዝ ሚዲያ ሚና
ጣልቃ : ሚዲያው ዓለም በመካከለኛው እንደመርግ እዚህ
ገብነት : ከመጠን ጉድለታቸው ሒሶች ግንኙነት አባልነትና
ጎልቶ : ያገኙት በተስተካከለና የተባለው ሥልጣንን ግን
እየታየ : ሊወጣ ክፍተት ማረጋገጥ መርሆ ገለልተኝነትንና
በደርግ : ምንም ጉድለታቸው የገቢዎችና ከልማታዊ ርዕዮት
ይታይ : በንቃት ጎራ እንደሌለው የሚጣጣሩትን ይበጅ
እንደነበረው : በገዥው የአፈና ሚና እዚህ ይበጅ
የፓርቲው : ወደኋላ ባህልን የፖለቲካ ይነገራል ሐሳብበዓለም
የርዕዮተ : ከርዕዮተ የሚደፈቅበት እያደረገ በረጅም የጋዜጣ
ኃላፊዎች : ተመልሶ ኢትዮጵያዊያንና ዓላማም የአፈና ታሪክ
የቦርድ : የአገርና ከፈላጭ ሁኔታ እንደመርግ የአፈና
ሰብሳቢዎችና : የሚሰጥ ሙያተኛ ምርመራ የሚወሰድ መርሆ
ዋና : ትኩረት ሙያተኛ ይበጅ
ሥራ : ሐቅን ሁኔታ ሚዲያዎችን ነፃነት የአፈና
አስኪያጆች : ጓደኞች ሕይወታችን ጉድለቶች ሳንቲም በላይ
ከመሆን : እየተስተዋለ ዕድል የያዟቸው ዋና ብዙዎች
አልፈው : ግለሰብ የሚዲያ በመደገፍ የአፈና ይህ
የሚመልስ : መታየት ለሚነገር መመለስና የሚዲያ የአፈና
አካሄድ : ዋጋው ርዕዮተ ምርመራ ሚዲያ እዚህ
እየተከተሉ : ሳይሉ ሚዲያው ባይሆንም በተስተካከለና የሳንሱር
እንደሆነ : ማሳተም እንደማይችል በአንፃሩ ሚዲያ እንዳልዘነጋሁ
በሥጋት : ፀረ መራሹ እንደመርግ መንግሥትንና ያለውን
የሚናገሩ : ሠርቶ ጠቃሚ ሚዲያው በተስተካከለና ገለልተኝነትንና
የመስኩ : የተዛባ የፖለቲካ ያደርጋል ያለውን ይህ
ባለሙያዎች : የበላይነት የተለየና በባለሥልጣናት ግንኙነት መመለስና
በኤዲተርነትና : ጠቃሚና ሚዲያዎችን የሕዝብን አገዛዝ ቆራጭ
በከፍተኛ : ጋዜት የሚሠራ ነፃነት የአፈና ይበጅ
ሙያተኛ : ጉዳይ ሐሳቦችን መፍረስም የሐሳብና ማብቂያ
ደረጃ : የሁሉንም አጠንክሮ የመገናኛ የሚዲያ እንዳልዘነጋሁ
የሚያስመድቡት : ተቋማቱ ነፃነትና ንጉሣዊ እንዳልዘነጋሁ እዚህ
አባልነትና : ጉድለታቸው ውስጥ ቢነሳም ከፈላጭ በተስተካከለና
ደጋፊነት : ታስቦ ድክመት የመሰሉ ይነገራል ይመስለኛል
ናቸው : ምንጫቸው ውስጥ እንዳይኖር ይነገራል ይበጅ
ይኼ : ዕውቁ ጳጳሱ በ#ኛውና አምባገነናዊ እዚህ
ብቃት : ክፍተት ሒሶች ግንኙነት በሙያተኛው ሐሳብ
ሙያዊ : ወደነበሩበት በተስተካከለና የአፈና በእንግሊዝ ክፍለ
ሥነ : አለማየት ገብነት መሣሪያነታቸውም እንዳልዘነጋሁ ሚዛናዊነትን
ምግባርና : ይከተላሉ ህንድ መመለስና ሕዝቦች ዓላማም
ልበ : ለባለሀብት የተሰማሩ መርሆአችን ተጎዳ በፖለቲካ
ገለልተኝነትን : ገለልተኛ አማራጭ ቀፍድደው ባይሆንም ቆራጭ
ለሚፈልግ : በሄድን መንግሥታት በሌላው ለመፈተሽ መራሹ
ሙያና : የማይመረምር የልማታዊ ባህሪ መንግሥትንና የሚጣጣሩትን
ለዴሞክራሲ : እጥረት መመለስና ይችላል የሐሳብና ነፃነት
ባህል : የሐሳብና በሙያተኛው ከአገዛዙ የሚባለው ታሪክ
የህሊና : በወረርሽኙ እንዳጫወተኝ የሚሠራ ከፈላጭ በተስተካከለና
ፈተና : ትልቋ ዕገዳና መንግሥትንና የአፈና ሐሳብ
የሚጋርጥ : ከተጎዱት መሣሪያዎቹ እስከ ሐሳብ ሚዲያ
ነገር : በአፍሪካም ጉድለታቸው በምሁራኑ በዚህ ከዓለም
የአዲስ : አሜሪካ ገጽታዎች የሳንሱር በማያፈናፍን የአፈና
አበባ : ወገን ጥረት ቁጥራቸው ያደርጋል የአፈና
መስተዳድርን : ዩኒቨርሲቲ የመሰሉ እንደመርግ ይህ ገለልተኝነትንና
ጨምሮ : ረገድም የሚመስላቸው የገዥው የኅትመት ነፃነትና
በብዙዎቹ : የሚያስችሉ ገለልተኝነትንና እዚህ ይበጅ
በክልልና : በመሆኑ የአፈና ይበጅ
የከተሞች : መስፋፋት በእርሱ የሚሰብክና ይህ ለመጠበቅ
ተቋማት : እንዲሆኑ አቅጣጫ የጋዜጠኝነት ወደነበሩበት መሣሪያዎቹ
ከሙያዊ : በገዥው ሚዲያ ሚና እዚህ ይበጅ
ጥረት : ሚኔሶታ አሰፋ ከፈላጭ የሚገነባውና የአፈና
ይልቅ : የሚዘርፉ መሆን ዴሞክራሲ መሣሪያነታቸውም ዓላማም
ዓለማዊ : አጠያየቁ አባል ከአውሮፓ የሚሠራ የፌደራሉም
አነብናቢነት : ፀሐፊውን በመከታተያ ሁኔታ የሚወርደውን መርሆ
ከዓለም : ልጅ እንደየምርጫችን ምንም እየተከተሉ ለምሳሌ
አቀፍ : የሚል መሣሪያነታቸውም መንግሥትንና ተደርጎ ታሪክ
የጋዜጠኝነት : ወታደራዊ ቢኖርም የሕዝብን የአፈና ሚዲያ
መርሆዎች : እምነቱ ይከተላሉ ርዕዮት በላይ አለመላቀቁ
በላይ : ሲወጣ ተገቢ እምነቱ መርሆዎች ዕርምጃ
የሕዝብ : በጥልቀት በስሜታዊነት ያሉ ዓላማም ተደርጎ
ግንኙነትና : ከሙያዊ የገዥው ሚዲያ ይበጅ
ፕሮፓጋንዳ : በአዋጅ ተሳትፎ የአፈና መለኮታዊነት የሚባለው
ልማድ : ከአገዛዙ መለኮታዊነት የሚጣጣሩትን ለመጠበቅ ይበጅ
እየተስፋፋ : ብሮድካስት የሐሳብና በሙሉ ያለውን የሚባለው
መሆኑን : ተነገረ ድብልቅልቅ ጉድለትን መሣሪያዎቹ ሥልጣንን
ማንም : መቀየሪያ መመለስና የሐሳብና ቢሆን የአፈና
ተመልካች : ይህ ሐሳብበዓለም ሚና * ይበጅ
ሊፈርድ : ሲሰጠው የሚጎድላቸው መሣሪያነታቸውም ብዙዎች መሆኑ
መራሹ : የአንዳንድ ለመፈተሽ በሥጋት ከፈላጭ በሕገ
መንግሥት : እንዲገኙ እምነቱ የሚመልስ ተሳትፎ የአፈና
የዲሞክራሲ : ለሚዛናዊነት ሕዝቦች ቢሆን መሪዎችን ገለልተኝነትንና
ባህልን : ፖሊስ ቢለይ የተዛባና መመለስና የሚገነባውና
በረጅም : በፆታ መድረሻ ነፃ የአንድ በተስተካከለና
ጊዜም : በመዋለድ ወደነበሩበት ባይሆንም በተስተካከለና በመረጋገጡ
ለመገንባት : የሚገነባውና መነሳትና የአፈና ሐሳብ ቀዳሚው
እያደረገ : ብዙኃንን ቢሆን የቅድመ ንድፈ ገለልተኝነትንና
ያለው : በመሆኑ እንደተጫናቸው እንደመርግ የሚባለው ሚና
የለም : አፍ በኢትዮጵያ ቀፍድደው የአፈና ሚዲያ
ባይባልም : መንግሥትንና ዓላማም ሐሳብ ታሪክ ሐሳብበዓለም
የያዘበት : ማድረሳቸው በፊውዳሊዝም በየትኛውም የፖለቲካ የሕዝብን
ከዕውቀትና : ቢመዘን ችግሮችን ትኩረት መሣሪያዎቹ ተደርጎ
ከአገራዊ : መርሆ በ#ኛው እንዳልዘነጋሁ ይበጅ
እውነት : የሚታበል መርሆ ይበጅ
የራቀ : ዓመቱ የሚገባው ይመስለኛል ይበጅ
ብል : ባነበበው ሚዛናዊነትና ደግ መራሹ ከፈላጭ
ማጋነን : በመኖር ይጽፋል እንደተጫናቸው ይበጅ
አይመስለኝም : አልቻለም መለኮታዊነት ይታወቅልኝ እንዳልዘነጋሁ ይመስለኛል
በተጨማሪ : ሚዲያው ማብቂያ እንደሌለው የአፈና እዚህ
ምሳሌ : ስለነበረ አንድ ነፃነትና በ#ኛውና ሚዲያ
ሐሳቡን : ያየ አስተሳሰብ በመረጋገጡ ኢሕአዴግ በማድረግ
ለመፈተሽ : መንግሥታት መራሹ ከፈላጭ መሣሪያዎቹ ያለውን
ኮሙዩኒኬሽን : አፋኝ ማብቂያ በሙያተኛው የቅድመ *
ሕዝብ : ድምፃቸው ከኢንዱስትሪና ነፃነትና መንግሥትንና አምባገነናዊ
ግንኙነት : መሆን የሚታበል በሙያተኛው መንግሥትንና ሚዲያ
የሚባለውን : ብለው የአፈና የሚጣጣሩትን ገለልተኝነትንና ይበጅ
የአንድ : ደክሞ መድረሻ እንደመርግ መርሆ በእንግሊዝ
ወገን : አበባ እንደመርግ ያለውን የአፈና ይበጅ
ቃል : ማስወገድና ሳንቲም የመናገር ሕዝቦች በ#ኛውና
አቀባይ : ዛሬ ሲያበቃ ሚዲያዎችን የሐሳብ የአፈና
ዘርፍ : ዕድል ሙያተኛ መንግሥትንና ዓላማም ይበጅ
ከመንግሥት : አለመሆናቸውም ትክክለኛ ዓለም በሙያተኛው ተደርጎ
ሚዲያው : ባይሆንም በተስተካከለና ርዕዮተ እንደመርግ የአፈና
ጋር : ችግሮችን ከዕውቀትና የማይችል ባህሪ ሐሳብ
አንድና : ከማቅረብ የሚዘርፉ መርሆዎች የሚገነባውና በአንፃሩ
ተመሳሳይ : የኅትመት የፕሬስ የብሮድካስት የአፈና ንድፈ
በማስመሰል : እንቅፋቶች በመሆኑ ዓላማም በእንግሊዝ የሚባለው
አቆላልፎ : የሚፈልገውን በመሆኑ ለዚህ ደርግ ምሥራቅ
መሄዱ : መሆናቸው የመጣ ድክመት ተደርጎ ይመስለኛል
በሕጋዊ : ኢትዮጵያዊያንና ዋነኛ የሚዲያ ዓላማም ይህ
አደረጃጀት : ገበታቸው ነፃነት የአፈና በእንግሊዝ ይበጅ
ተጠሪነቱ : ወራት እንደሌለ የሚገባው እንደቆሙ አገር
ለምክር : የሚያደርጉትን ከቀረበ አንድና በመካከለኛው የአፈና
ቤቶች : ጥረት ባህል የሚገነባውና ሥልጣን መዋቅሮችን
በመሆኑ : የሚፈልገውን አቆላልፎ ናቸው እንደነበረው ሊረጋገጥ
ይባልና : ብዕሬን ብል ሁኔታ በ#ኛውና የሚባለው
በአሠራር : ዳይፐር ቅሬታ የተሟላ ተሳትፎ የአፈና
የፌደራሉም : ቁጥራቸው ያደርጋል የሚወሰድ ሥልጣንን ይበጅ
ሆኑ : መንግሥትና ነፃነትና መዋቅሮችን የአፈና በ#ኛውና
የክልል : መመለስና በአፍሪካ ዓላማም ሥልጣንን ይህ
መሥሪያ : ታወቀ ትራፊኮችንና ክንድ የገዥው ነፃነትን
በመከታተያ : ሠርቶ በመሆኑ አነብናቢነት እንደነበረው አውሮፓዊያኑ
ቼክሊስት : ማድረጉ ሐቅን የአገርን ሥራ ነፃነት
ቀፍድደው : የአገርን የአፈና በእንግሊዝ ሚና የሚጣጣሩትን
የያዟቸው : ሐሳቤን ሐሳቦች ናቸው ሐሳብ ይበጅ
ይሆናሉ : ካስተዋወቀችው የሻረ ድምፅና እዚህ ይበጅ
ግንኙነቶችም : ከሆነ ጥቂት ዋና የተሟላ አገሮች
እንደፈለጉ : አቀንቃኞች ደግ የሚባለውን ደጋፊነት የአገሪቱ
ደግ : የምታውቁ ጉድለታቸው ብል ደጋፊነት እንደመርግ
ደጉን : ንጉሣዊ በ#ኛውና ገለልተኝነትንና ግን *
መርጠው : በተግባራቸው መልስ የሚንገታገቱ ሥልጣንን ይበጅ
የሚናገሩባቸው : ካቶሊክ አምባገነናዊ ሚዛናዊነትን ግን እዚህ
ድምፅና : በገዥው በ#ኛውና እዚህ ይመስለኛል ይበጅ
ቅሬታ : እንቅፋቶች በአሠራር ዴሞክራሲያዊ በሙያተኛው መለኮታዊነት
የሚደፈቅበት : ብርሃኑ ከመጠን በላይ የርዕዮተ ያህል
ዕድል : መግለጽም ዘርፍ መንግሥትንና በእንግሊዝ ይበጅ
በዝቶም : ሲሰጠው የሚስባቸው ሊፈርድ በሙያተኛው መገለጫ
ይታያል : ይለቃሉ ይገልጸዋል ይከለክላል ይታገላል ጽፈዋል
በአንዳንድ : ይኼውም ዜጎችን ዓላማም የአፈና ይህ
አካባቢዎችም : የሚሠራ በሥጋት ከፈላጭ በሕገ ይበጅ
ገዥው : በሠራው ባለሀብቱ በገዥው የሐሳብና የሙያው
ሳንቲም : በኩል መመለስና በዚህም ይህ የሚባለው
ሁለት : ጸሐፊዎችና በመረጋገጡ ሚና ሚዛናዊነትን ላይ
ገጽታዎች : በይሉኝታ የተለመደ ሒሶች ወደነበሩበት የሚገባው
ሆነው : መንገድም ሐሳብ ላይ ይበጅ
ይታዩና : የእኛ ለመፈተሽ መራሹ ከፈላጭ ዓላማም
አማራጭ : አዳዲስ ዴሞክራሲያዊ ንድፈ እንዳልዘነጋሁ ሚዛናዊነትን
አስተሳሰቦችና : አስተሳሰባቸው መርሆ እንዳልዘነጋሁ እዚህ ይመስለኛል
ትችቶች : ከፈላጭ የመሰሉ ይህ ይመስለኛል ይበጅ
ጠቃሚ : ከድህነትና የምናየው በተስተካከለና የሚጣጣሩትን ይበጅ
ሒሶች : ፊላደልፊያ በይሉኝታ ርዕዮት ገጽታዎች ናቸው
ቢሆኑም : ፕሬዚዳንት ከአውሮፓ በመካከለኛው የአፈና ይህ
ጎን : ሲሰጠው እሴት ርዕዮት መፍረስም በእንግሊዝ
ይባላሉ : ሐሰት ሲባል ጨፍልቋል እስከ የአፈና
በአንድ : በፆታ በአንዳንድ መመለስና ዜጎችን የሚዲያ
የሚሠራ : ከፈላጭ ይበጅ
ወዳጄ : ከባንኮች የሚችለው የበለጠ የሚገባው የሐሳብና
እንዳጫወተኝ : ድብልቅልቅ ሚዲያው ባይሆንም የአፈና የሚጣጣሩትን
የአንዳንድ : መራሹ ከፈላጭ ዓላማም ሥልጣንን ይበጅ
ቤት : ቢመጥቅ ሒሶች በመሆኑ ናቸው የሚገባው
ኃላፊዎችና : ተጠቅመው እንደነበረው ገብነት ባይሆንም በመረጋገጡ
ሙያተኞች : ሥልጠናዎችን ፕሮፓጋንዳ ቢነሳም መለኮታዊነት በ#ኛውና
ጥቂት : የሚባለውን የአፈና የሚጣጣሩትን ይበጅ
የአፈጻጸም : በሥነ በተሳሳተ ጉድለትን ብል ገብነት
ጉድለቶችን : ሐሳቦቼን መሣሪያዎቹ ሐሳብ ይበጅ
ከነምክንያቱ : ከማከናውናቸው ሚዛናዊነትን ገለልተኝነትንና * ይበጅ
የዘገበ : ቤተ ችግሩ እንዲገነዘብ ከአውሮፓ ሲያበቃ
ጋዜጠኛን : የበላይነት የሚሰጥ ድምፅና ከሦስት በ#ኛውና
መዝለፍ : ማለፍ እንዳይኖር ይበጅ
ደርሰዋል : ሆኗል ይችላል ሚዲያ ይታወቅልኝ ይመስለኛል
እንዴት : ስለማይችል ማረጋገጥ መርሆ ይበጅ
ሕዝቡ : አድልኦ በአንዳንድ የመገናኛ በዚህም የሳንሱር
ተጎዳ : የዓለማችን መርሆዎች የሚባለው እዚህ *
ይጽፋል : ማጋነን እንደተጫናቸው እንዳይኖር እንደተጀመረ ይበጅ
ይናገራል : አለ በውስጡ ደርሰዋል ተደርጎ ሚዲያ
አይደለንም : አይፈቀድለትም ሊሆኑ ድምዳሜን ሐሳብመነሻው እውነት
እንዴ : ይቀነቀናል ደጋፊነት ያደርጋል ይመስለኛል ይበጅ
ማለት : ማንሰምቶት ስቶ መመለስና ዓላማም ሐሳብ
የተለመደ : ገጽታዎች ቢረጋገጥም በተስተካከለና በሙሉ ያለበት
ከሆነ : ሥራዎች መሆን ድክመት መፍረስም የሚታበል
ሰነባብቷል : ተጫውቷል አይችሉም ለሚነገር ጨፍልቋል የተስማሙበት
ራስን : ህንድ የአፈና ሚዲያ ሚዛናዊነትን ገለልተኝነትንና
ለትችት : ጎራ በተስተካከለና በመደገፍ ይህ ቀዳሚው
ያለመዘጋጀት : መደበኛ የዓለማችን ቀፍድደው በመሆኑ ስለማይችል
የሚለውን : በመገኘቱ የሚሠራ እየተከተሉ ይበጅ
አለማዳመጥ : ከሞላ መንግሥታትም ብለው መሪዎችን መንግሥትንና
እንጂ : ቢበዛም በቋንቋ እንደሌለው ሥልጣንን አምባገነናዊ
ጉድለትን : ፍራንኮ ፖሊስ የመሰላቸውን ጉልህ እንዳጫወተኝ
አለማየት : መቀነስ ተናጋሪዎች ገብነት ገለልተኝነትንና እዚህ
ሳይሆን : ቀፍድደው ሚዲያዎችን የአፈና በእንግሊዝ የሚጣጣሩትን
ቆራጮች : የልማታዊ ሙያና ጭቁን መንግሥትንና ቆራጭ
ተመልሶ : የግልም ገጽታዎች ኃላፊዎች በመረጋገጡ የአፈና
መምጣት : ዛሬ በተሳሳተ ጉድለትን ዋነኞቹ *
እንዳይሆን : ተገቢ ዕርምጃ ትንሽ እንደመርግ ገለልተኝነትንና
ሊጤን : ጥርጥር ሊሆኑ ወደኋላ ናቸው ከፈላጭ
ይገባዋል : ተጫውቷል አይችሉም አይችልም ለሚነገር ሰነባብቷል
የአገርና : የቦርድ ከፈላጭ የአፈና በእንግሊዝ ይበጅ
ጉዳይን : ግንኙነት የገዥው ነፃነትና የአፈና ከአገዛዙ
የመሥራት : የመናገር በፖለቲካ መለኮታዊነት ገለልተኝነትንና ላይ
ኃላፊነት : ከሚያመቸው እንዳጫወተኝ ሙያተኛ የሙጭኝ የአፈና
አለባቸው : ይኖርባቸዋል ቀብሯል መንግሥታትም ይታወቅልኝ ይመስለኛል
ለዚህም : ሁልጊዜም ህንድ ገጽታዎች ባይሆንም ዋነኛ
ሲባል : ይመስሉኛል ሐሰት ሒሶች ገጽታዎች በእንግሊዝ
በተሳሳተ : ባይሆንም በተስተካከለና በመረጋገጡ በእንግሊዝ በ#ኛውና
መንገድም : በይሉኝታ ጎተራ ሆነው ገጽታዎች ወደነበሩበት
ለሚነገር : የሚያውቅ የሚገባው የሐሳብና # የሚዲያ
የተዛባ : እየተገነዘብኩ አቅጣጫ ወደኋላ የመስኩ የአፈና
አስተሳሰብ : የጋዜጣው ቢመጥቅ መደበኛ አስተሳሰቦችና ግንኙነት
መልስ : የሚመሩ መድረሻ ከፈላጭ ይበጅ
መስጠትና : የሚዲያ መለኮታዊነት ሐሳብበዓለም ሚና ይበጅ
ውዝግብ : ኦስተን አየናቸው እየተካሄደ ኃላፊዎች ማብቂያ
ሊገቡ : ኒልን ሊሆኑ ዋና እንዳይኖር እንደተጀመረ
አይገባም : የለበትም ነው ሚዲያ ይታወቅልኝ ይመስለኛል
ለእውነትና : በዚህ ለዚህም ዋነኛ የሚዲያ መንግሥትንና
ለሚዛናዊነት : ተጓዥ ከቀረበ የሚገነባውና ቢሆን ነፃነት
ቆመው : ችግሩ አስተሳሰቦችና እንዳልዘነጋሁ ሚዛናዊነትን ይበጅ
በዛሬው : ሁኔታ በማያፈናፍን ነፃነት የአፈና በእንግሊዝ
ባለፈውና : ከማል ታይቷል የፈላጭ ቀዳሚው አምባገነናዊ
በቀጣዩ : ሻጭ የጎላ ፓርቲ የአፈና በእንግሊዝ
ምዕራፍ : ውጭ ከቀረበ መርሆዎች ሚዲያዎችን መገለጫ
ተመሥርተው : ማደናገር ምክንያቱ መርሆዎች የሚገባው በሙያተኛው
ትውልድ : ከማቅረብ እንደነበረው የአፈና በእንግሊዝ ይህ
መቅረፅ : ሊሆኑ ከድህነት በብዛት በንቃት በመሆኑ
ይኖርባቸዋል : ደርሰዋል ይችላል ነው ታሪክ ሚዲያ
ይኼን : ፍራንኮ የአፈና ገለልተኝነትንና ይበጅ
ስቶ : ብርሃኑ ማለት መንግሥትንና ዓላማም ዋናው
ተዓማኒነት : ሲሠሩ ሲባል ዜጎችን ምሥራቅ መለኮታዊነት
በሌላው : ከሞላ ገጽታዎች እውነት ለሚፈልግ ብዙዎች
አኳኋን : በእንግሊዝ እዚህ ይበጅ
ማዳመጥ : የአፈና መለኮታዊነት ሐሳብ ታሪክ ሐሳብበዓለም
የሌለበት : መንግሥትንና ዓላማም ሚዲያ ሚዛናዊነትን ይበጅ
ተናጋሪነት : ሐሳቦችን ጉዳይን ሒሶች ግንኙነት ሙያተኛ
በዚህ : ዋነኛ የሚዲያ መንግሥትንና የአፈና ይህ
ያውም : እሳቤዎችን ፈተና የውጭ የአፈና ሐሳብ
በሚታትር : መሃላቸው የእኛ በፈላጭ ለመፈተሽ መራሹ
ተቀባይነት : እንዳይዛመት የሚጠልፈው ጎልቶ ሥልጣንን ግን
ሊኖረው : ስናልፋቸው ሊሆኑ እየተስተዋለ ማጋነን ናቸው
አይችልም : ተጫውቷል ያዳግታል ደርሰዋል ይችላል የሐሳብና
የልማታዊ : ከልማታዊ ሙያተኛ ነፃነትና መንግሥትንና ሚና
ሐሳብመነሻው : ሐሳቦች ሐሳብአሁን ሐሳብበዓለም ሚና ይበጅ
ምሥራቁ : ከዚያ ጥረት እዚህ ይበጅ
ጎራ : ከማቅረብ የሚዘርፉ በመሆኑ አንድና ይታይ
የሚመስላቸው : የተያያዘ ለምክር በፖለቲካ መለኮታዊነት ሚዛናዊነትን
ቢሆንም : የሚገነባውና አንድ ብዙዎች መንግሥትንና ሥልጣንን
እ : እስከ ማረጋገጥ የሚወሰድ ይነገራል በ#ኛውና
ኤ : እንደየምርጫችን ብዕሬን እ ከዓለም ለምሳሌ
አ : አማራ ይታገላል ስቶ ዋናው ይህ
ከ#ዎቹ : የዩናይትድ በአንዳንድ ይህ ሐሳብበዓለም ግን
ከአውሮፓ : ናይጄሪያና አሰፋ ትኩረት የሚገነባውና በዚህም
የተነሳ : አለመስጠት እውነት የሚታበል የተስማሙበት የሚወሰድ
መነሻው : ምንም መኖራቸውስ በዚህም የሳንሱር በአፍሪካ
ሕዝቡን : የሕዝቦችን ተሳትፎ በመደገፍ የአፈና የሚሰብክና
ከድህነትና : የግሉ ጠቃሚ ከፈላጭ ባይሆንም መንግሥትንና
ከኋላቀርነት : ባህል መመለስና የሐሳብና የአፈና የሚባለው
በማላቀቅ : ከአውሮፓ ከፈላጭ የሚወርደውን በእንግሊዝ ሐሳብ
ፈጣን : የሚንገታገቱ እንደተጀመረ ይበጅ
አገራዊ : የተስማሙበት የአፈና በእንግሊዝ በ#ኛውና ይበጅ
ለውጥ : እንኳን ዓይነት መመለስና በገዥው ሚና
ለማረጋገጥ : ተሳትፎ ሥልጣንን ለመጠበቅ ይበጅ
የሚያስችሉ : ጓደኞች መንስዔአቸውን የማጋለጥ አለመላቀቁ ሥልጣንን
ትክክለኛ : ግንኙነት ናቸው ለዚህ በሙያተኛው ተደርጎ
የልማት : የዴሞክራሲ ሚዛናዊነትን ገለልተኝነትንና እዚህ ይበጅ
ሐሳቦችን : ሙያተኛ ማብቂያ መገልገያ የአፈና ሚዲያ
እንዲገነዘብ : መሃላቸው ከፈላጭ በሕገ እንደተጫናቸው የቅድመ
ማድረግ : ታስቦ እውነት ይነገራል ይበጅ
በንቃት : የአፈና ከአገዛዙ የሚጣጣሩትን ይበጅ
እንዲሳተፍ : መስኩ ተሳትፎ እንዳይኖር ይህ ለመጠበቅ
የሚያደርግ : ያደርጋል ይነገራል ይታወቅልኝ ይበጅ
አዎንታዊ : የሚገነባውና ነፃነትና ታሪክ ይበጅ
የልማትና : እየተከተሉ ይበጅ
የዴሞክራሲ : ሲጠጋው አንዳንዶች ሚዲያዎች የአፈና ገለልተኝነትንና
የለውጥ : ቢገለጽም የአመለካከት በመካከለኛው ባህሪ የአፈና
እሴትን : አቀንቃኞች ባይባልም መንግሥትንና ይበጅ
የሚገነባ : የትግራይ የሚያነሱት ለማለት ደግ ከፈላጭ
ምሁራን : ፖስተር አሻጥር በሚዛናዊነት የአድማጭና መፍረስም
ጽፈዋል : ይከለክላል ይታገላል ጎራ የሚገነባውና በተስተካከለና
በተለይ : መመርያ ሮያል አንባቢያን በህንድ ሐሳቦችን
በህንድ : ባለሀብቱ ንድፈ ሚዛናዊነትን ገለልተኝነትንና እዚህ
በብዛት : ይበጅ
ይታወቃል : ይመስሉኛል አገራዊ የተስማሙበት በእንግሊዝ የሚባለው
ህንድ : የሳንሱር የአፈና ሥልጣንን ይህ ታሪክ
የዓለማችን : መናገሩም ርዕዮት ገጽታዎች የሚገነባውና የአፈና
ትልቋ : ፈተና የአፈና እንዳልዘነጋሁ ላይ ይበጅ
ናት : ተማረከ የሚጠልፈው ይታገላል ጽፈዋል አይደሉም
ከኢንዱስትሪና : ተልዕኮውም አክራሪነትና ቢያንስ በዚህም ነፃነትና
ከቴክኖሎጂ : በኤዲቶሪያል የፖለቲካ የሕዝብን የአፈና ይህ
መስፋፋት : የከተሞች አልፈው በመደገፍ የሚሰብክና በእንግሊዝ
ወይም : በሆኑ ከኢትዮጵያ ቢተኮስ የግልና ሚዲያ
ከድህነት : እያየሁና ኃላፊዎች ሚና ይበጅ
ማስወገድና : ሆነናል የመናገር የአፈና ሐሳብ ይህ
ሥልጣኔ : ከሪፖርተር በሚታትር ግንኙነት ከፈላጭ በአዋጅ
ማስፈን : ቀጣይነት መለኮታዊነት መርሆ እንዳልዘነጋሁ ይመስለኛል
የተያያዘ : የሚመስላቸው ቀፍድደው ለምክር ገብነት ሚዲያዎችን
ርዕዮት : ሒሶች መፍረስም ብዙዎች ሚዲያ እዚህ
በውስጡ : ደርሰዋል ሙያተኛ ይችላል ተደርጎ የሚባለው
የ : ዋና ከፈላጭ ነፃነት የአፈና ይበጅ
ነፃ : እንደሚሞከርም በመሆኑ ምሥራቅ ያለበት በእንግሊዝ
አውጪ : የሚመራባቸውና ዋነኞቹ አስሯል የተሻለ የአገሪቱ
ጋዜጠኝነትን : እኔ የእኛ ትኩረት ጉድለትን እንደተጀመረ
መነሻ : የፔንሲልቫኒያ የሚሠራ ከፈላጭ ሥልጣንን ይበጅ
አድልኦ : ሕዝቡ በአንዳንድ በዚህም ማብቂያ ሳንሱር
አስተዳደርና : ፕሬዚዳንት ርዕዮት ሚዲያው መፍረስም በአፍሪካ
ሙስናን : ጳጳስ የፖለቲካ ኤርትራን ይነገራል ይበጅ
መርምሮ : የመውሰድ በፖለቲካ በመደገፍ መለኮታዊነት እንደተጀመረ
የማጋለጥ : የዓለማችን ያለመዘጋጀት ይልቅ ዓለም ታሪክ
ልብን : መስተናገድ ተደርጎ ታሪክ ሚዲያ *
የሚያበረታታ : ተገቢ ሎክ የተለመደ ዕርምጃ ያለበት
መሆን : ግንኙነት ይልቅ ነፃነትና ታሪክ ሚዲያ
አለበት : መረመረ ያዳግታል አልነበረም ተጭኗቸው ቢሆን
አክራሪነትና : ከኢንዱስትሪና በዚህም የሳንሱር ዋነኞቹ በአፍሪካ
ጽንፈኝነትን : የአገርና በእስያም ነፃነት የአፈና የሚሰብክና
ሽብርተኝነትና : ወዲያውኑም ፍቅር አቅጣጫ ጉድለቶች የተዛባ
የሕዝቦችን : መሠረታዊ በመደገፍ መንግሥትንና የአፈና ሚዛናዊነትን
ድህነት : የፔንሲልቫኒያ በማላቀቅ ሙያተኛ ፍልስፍና ከአገዛዙ
መንስዔ : ጥሩ ባለቤት በሚታትር የመስኩ የሳንሱር
አምርሮ : በሚዛናዊነት ሊፈርድ እንዳይኖር በመደገፍ መርሆ
ይታገላል : አረጋገጠ ይከለክላል ጽፈዋል ይመስለኛል ይበጅ
በአመለካከት : ጉዳዩን የሚሉ የአዲስ በመረጋገጡ ወታደራዊ
መገለልና : በሌላው ያለው መመለስና እንደተጫናቸው ብዙዎች
በአስተሳሰብ : ሳይንቲስትም የሚያዳክም በአሠራር በእርሱ ብዙኃን
መድረሻ : ከፈላጭ እንደመርግ ያለውን በእንግሊዝ ክፍለ
ማጣትንም : እጥረት ግልጽ የማጋለጥ ርዕዮት የዓለማችን
ይከለክላል : ጽፈዋል ይታያል ይችላል ከመጣ ጨፍልቋል
በአሁኑ : በሚናፈስበት ተስፋ በደርግ መነሳትና በንጉሡ
ወቅት : የአድማጭና ከፈላጭ የሙያው የሚዲያ የአፈና
በእስያ : ለምሳሌ ማብቂያ የአፈና የሚወርደውን በ#ኛውና
በአፍሪካና : ነፃ ምሥራቅ ሕዝቦች ያለበት አሠራር
አሜሪካ : ትይዩ የፔንሲልቫኒያ የዩናይትድ የሚመሩ የአፈና
እያደገ : ናት ጉዳይን በ#ኛውና አምባገነናዊ ግን
የመጣ : እያበሩ የተፈታ አለመያዙ መሄዱ እውነት
መሆኑም : የሙጭኝ ሐሳብ ታሪክ ሚዲያ የሚጣጣሩትን
ሊካድ : ሲሠራ በድፍረት መግለጽም ደጋፊነት ቢሆን
በኢትዮጵያ : ማዳመጥ የለም የአፈና መለኮታዊነት ሐሳብ
ኢንዱስትሪ : የሚሠራ የህሊና ከፈላጭ ያለውን ክፍለ
በጥናት : ይዣለሁ እንደሚላቸው አንድና ጎልቶ ያህል
ተመሥርቶ : ተግባር ስም ተሳትፎ የአፈና ክፍለ
አፈጻጸም : ጓደኞች ሥራዎችን ዴሞክራሲ ብዙዎች ሚዲያ
አለ : ይናገራል ደርሰዋል ከመሆን ባህሪ ተደርጎ
ለማለት : ብርቱ የሚገነባ ሙያተኛ በደርግ የግልና
ያዳግታል : ይከለክላል አልነበረም ጨፍልቋል ይታወቅልኝ ይመስለኛል
ስም : የአፈና ገለልተኝነትንና ይበጅ
የኤሌክትሮኒክና : ባይመስለው ብዙዎች የሚባለው ታሪክ ሚዲያ
መርሆአችን : አሠርታት ሥራቸው ሒሶች የሚገባው የተስማሙበት
ቢሉም : ለአዲስና ይታዩና ቢያንስ ዓላማም ሥልጣንን
በተግባራቸው : በካሜራቸው የማያሞግስና በመሆኑ ይልቅ የሚጣጣሩትን
የሚጎድላቸው : ሊፈርድ በነፃነትና የሚገነባውና ይበጅ
ይበዛል : ይመስሉኛል ሐሰት ደርሰዋል ነው የሚባለው
ከላይ : ከሳምንታት ማይል ተልዕኮውም ማዳመጥ በዚህም
በፈላጭ : መተላለፍ በሚታትር ኃላፊዎች ባይሆንም በአፍሪካ
ቆራጭነት : ንባብ በመሆኑ ሚና የሚጣጣሩትን ይበጅ
እንደተብራራው : የሚያስችሉ በአንፃሩ አገዛዝ ገለልተኝነትንና እዚህ
ወደኋላ : የሚጠቁም በስሜታዊነት ናቸው አውሮፓዊያኑ ከፈላጭ
የሚስባቸው : በዝቶም መፍረስም የሚታበል የሙያው በእንግሊዝ
አንዳንድ : በነገራችን ከሕዝብ ዓመታት ኢሕአዴግ ለዚህ
ሚዛናዊና : ስለሚሰጣቸው አራተኛ ከፈላጭ የመሰሉ እንደመርግ
ገለልተኛ : ገለልተኝነትን ባይሆንም እንደመርግ ሚዲያ ለመጠበቅ
የሆኑ : አለማየት የአገሪቱ ብለው ሐሳብ ገለልተኝነትንና
ቢኖሩም : ከፈላጭ ሥልጣን መንግሥትንና ዓላማም የአፈና
በተጨባጭ : የማያይ ፍልስፍናዬ የጋዜጣ ቀዳሚው ገለልተኝነትንና
ጋዘጠኝነትን : ሞተ ግንኙነት የሚገነባውና መሣሪያነታቸውም ይመስለኛል
ይከተላሉ : የተቀናጀ እምነቱ የአፈና ታሪክ ሚዲያ
መደምደም : በመኖር ይጽፋል ማጋነን ሊተች እንደተጫናቸው
በእርግጥ : ጉዳዩን የአፈና ከአገዛዙ የሚሰብክና ይህ
ብዙዎቹ : በመገናኘት የሚንቀሳቀሱ በሕገ ያለውን ይበጅ
የአገራችን : ለዚህ መሪዎችን ይነገራል ይበጅ
ዘገባ : ጥያቄዎችን የኤሌክትሮኒክና ሊሆን ብዙዎች በሙያተኛው
ያተኩራሉ : ታይቷል ይከለክላል ይችላል # የሚዲያ
ካለፈው : ጉዳዩን የሳንሱር በአፍሪካ የአፈና ይህ
የአሁኑን : እንደሚጠበቅ ገብነት መመራታቸውና የተሻለ በሙያተኛው
መግለጽም : ሥራዎች ዕድል ናቸው ደጋፊነት እስከ
ይቀናቸዋል : ይኖርባቸዋል አለባቸው ደርሰዋል ነበሩ #
ከልማታዊ : በልማታዊ የልማታዊ በደርግ መንግሥትንና ሚና
አኳያም : በመሆኑ አሜሪካና ተጭኗቸው ያለበት የአምባገነን
በስሜታዊነት : ንፅፅር በጥልቀት ወደኋላ መፍረስም በአፍሪካ
አቀራረብ : አፍሪካ የአፈና ከአገዛዙ ለመጠበቅ ይበጅ
የሚመሩ : መልስ እንዳጫወተኝ ጥረት ከፈላጭ የመሰሉ
አለመሆናቸውም : የሚስባቸው ትክክለኛ ሙያተኛ በሙያተኛው እንዳልዘነጋሁ
አንፃር : እየተካሄደ አለመላቀቁ ገለልተኝነትንና ይመስለኛል ይበጅ
ያልፈተሹትን : ሲታይ ዓላማም ሐሳብበዓለም ሚና ይበጅ
ጉድለት : ከዓለም ከፈላጭ ወደ ፍልስፍና የሚሰብክና
ማየት : ብለው ትንሽ ሚዲያ ገለልተኝነትንና እዚህ
የሚጠቅም : እንዳይኖር ገለልተኝነትንና ይበጅ
አንደኛው : የሳንሱር በአፍሪካ * ይበጅ
ለአዲስና : አሰፋ ከፈላጭ የአፈና ይህ ይበጅ
ለምርመራ : የአገርን ለዴሞክራሲ ሚና እዚህ ይበጅ
ዘገባዎች : ቢታወቅም ሙያተኛ የገዥው አሜሪካና በመካከለኛው
ትኩረት : መመንዘር ከአውሮፓ ዋና በተስተካከለና ዕገዳና
አለመስጠት : እውነት የሚገባው የተስማሙበት መርሆ ይበጅ
ጽሑፍ : ታስረን እንዳጫወተኝ በተስተካከለና የሐሳብና መሆኑ
እንደምንመለከተው : ቢገለጽም የለውጥ ወደነበሩበት የአመለካከት ትንሽ
በነፃ : ግለሰብ የሚያነሱት ሚዛናዊና መራሹ ከፈላጭ
ሲታይ : ያልፈተሹትን ውስጥ ሊተች ዓላማም ሐሳብበዓለም
የጎላ : በዚህም በሙሉ የአፈና በእንግሊዝ በ#ኛውና
ክፍተት : ስለሆነ ብቃት እየታየ የሚገባው እስከ
ችግሮችን : መምህር ቃኝተው ከዕውቀትና የተቋሙ ታሪክ
መንስዔአቸውን : የሚያስችሉ ሥልጣን ያለውን ሥልጣንን አገዛዝ
ከማጋለጥ : በግልጽ ይከተላሉ በክልልና በኤዲቶሪያል ሊሸፈን
መደባበቅና : መፍረስም ሚዲያዎች በአፍሪካ የአፈና ሐሳብ
መሸፋፈን : ጳጳስ ማስተናገድ ሊጤን ተመሳሳይ ከፈላጭ
ይመርጣል : ይኖርባቸዋል ደርሰዋል ስለማይችል ይችላል ቀብሯል
ከሕዝብ : አንዳንድ ኢሕአዴግ ኢትዮጵያዊያንና የአፈና መለኮታዊነት
ጥቅም : ሮያል የሚወሰድ አስፈጻሚ የአፈና ሐሳብበዓለም
መከናወን : ናቸው እንዳይኖር ይነገራል ሐሳብበዓለም ይበጅ
ብርቱ : ለማለት እንዲገነዘብ ገብነት ሚዲያ ሚና
ተግባር : አደጋ እንዳጫወተኝ ባይሆንም የመናገር የአመለካከት
ቢገለጽም : የለውጥ የሚያደርግ የአመለካከት ያደርጋል የአፈና
ሊወጣ : መኖራቸው እየታየ መሣሪያነታቸውም እንደተጫናቸው ሕዝቦች
አልቻለም : ያዳግታል ይከለክላል አይመስለኝም ይችላል ነው
በአገሪቱ : አሉባልታ ከመረጃ የጎላ ቤት በዚህም
ሥራዎች : ከሆነ ዕድል ደጋፊነት ድክመት የሚታበል
ተከናውነዋል : ይለቃሉ ይታያል ይሆናሉ መሆኑ በ#ኛውና
ተስፋ : በአሁኑ ሚና እዚህ ይበጅ
ሰጪ : ቢኖርም እንዳይኖር ገለልተኝነትንና ይበጅ
ውጤትም : ዋና በተስተካከለና ንጉሣዊ እንደተጀመረ ግን
እየተገኘ : የተፈታ የመጣ የተነሳ ድክመት የሚወሰድ
በልማቱ : ገለልተኝነትንና እዚህ ይበጅ
ጉድለቶች : ወር ሕይወታችን ጉልህ የሊብራል መርሆአችን
መኖራቸው : ሊወጣ መግለጽም ሊኖረው ማጋነን መሣሪያነታቸውም
አይታበልም : ያሳጣል ጨፍልቋል ምሥራቅ የአፈና ይታወቅልኝ
በግብርና : ካለፈው ህንድ የአፈና ይህ እዚህ
የተሰማሩ : ልበ በፖለቲካ ዴሞክራሲያዊ ተሳትፎ የአፈና
ባለሀብቶች : በልማታዊ የገቢዎችና መንግሥትንና ሚዲያ ይበጅ
ለምን : በዚህ ትችቶች ዓላማም ሚና *
ይቸገራሉ : አይታበልም ያዳግታል አይመስለኝም ጨፍልቋል ይታወቅልኝ
በአገራችን : ቤንጃሚን በአሁኑ በንጉሡ የሕዝብን በ#ኛውና
የከፋው : ኦሬንታል ባለመቻላቸው ቶማስ በማላቀቅ አባልነትና
የትራፊክ : አዲስ የተዛባና ነገር መመራታቸውና ቀብሯል
አደጋ : ተግባር ጉድለትን ባይሆንም የአፈና ክፍለ
ምክንያቱ : ተመሥርተው ብቃት በሙያተኛው የሚባለው *
በግልጽ : ቅሬታ የኅትመት ዴሞክራሲያዊ ሚዛናዊነትን ይበጅ
ምንድነው : አይድንም አልቻለም ይታያል ይችላል #
የኢትዮጵያ : ከአውሮፓ አስተሳሰብ ገጽታዎች ማብቂያ የአፈና
የሙስና : ብርና ኒል ከፈላጭ የአፈና ይህ
ሀብት : በንቃት አንድና መርሆዎች እንደነበረው የገዥው
የሚዘርፉ : ከማቅረብ በመረጋገጡ የአፈና መለኮታዊነት ቀዳሚው
የሚባሉ : ደብዳቤ እገዛ ሙያተኛ መሣሪያዎቹ ቆራጭ
በባለሥልጣናት : ርዕዮት ግንኙነት መብት በሙያተኛው ሚዲያ
መኖራቸውስ : ቴክሳስ ምንም በዚህም የሚዲያ የአፈና
ሐሰት : ይባላሉ በዚህም ጨፍልቋል የሚዲያ በ#ኛውና
ክልሎች : ከፈላጭ ይበጅ
እየተካሄደ : መብት አለመላቀቁ ዴሞክራሲ አሜሪካና እዚህ
ካለው : ቀፍድደው ነፃነትና በ#ኛውና ሚና ሚዛናዊነትን
የዜጎች : ከአውሮፓ የሚገነባውና የሚያፍንና መንግሥትንና ይህ
መፈናቀል : መደበኛ እንቅፋቶች ቤት አውሮፓዊያኑ ዴሞክራሲያዊ
ጀርባ : ሐሳቦች ምንጫቸው ማጣትንም በላይ የሚገባው
የገቢዎችና : በፍልስፍና ጉዳዩን በደርግ ባይሆንም መንግሥትንና
ጉምሩክ : በሕገ በፖለቲካ መንግሥትንና ሚዛናዊነትን ይበጅ
ባለሥልጣን : እያየሁና መሪዎችን መዋቅሮችን ይበጅ
በሥራው : ከፈላጭ በእንግሊዝ ይበጅ
እንቅፋቶች : ተመልሶ መመለስና ዓላማም ሚና ሚዛናዊነትን
ምንጫቸው : ናቸው እንዳይኖር ይበጅ
ፓርቲዎች : ሥራዎች ዕድል መብት መንግሥትንና ሚዛናዊነትን
አለመጠናከር : በመካከለኛው የአፈና የሚሰብክና ታሪክ ይበጅ
መሠረታዊ : የሕዝቦችን ከፈላጭ የሐሳብና የአፈና ይታወቅልኝ
ችግሩ : መርሆ እንዳልዘነጋሁ ይበጅ
ምንድንነው : አድርጓል ቢተኮስ ያነሳሁት ናት አይገባም
መርሆዎችና : ሙያተኛ ገብነት ሚና እዚህ *
ሕጎች : የሕግ በመደገፍ ከአገዛዙ የሚሰብክና ሚዛናዊነትን
አተገባበር : የበላይነት መሀል አገዛዝ ሚዲያ ገለልተኝነትንና
ምን : መንገድ የሚባለው ሚዲያ ላይ ይበጅ
የሚሉ : ገጽታዎች በዚህም በአፍሪካ የአፈና በ#ኛውና
ጥያቄዎችን : ርዕዮት ብዙዎች በሙያተኛው የሚባለው ሚዲያ
መዝዞ : የአድማጭና ጽንፈኝነትን በዚህም የሚሰብክና መለኮታዊነት
ደክሞ : የአንድ ያለው ከፈላጭ እንደመርግ ያለውን
ወጥቶና : በአሠራር በሆነ የውጭ በሙያተኛው የሚባለው
ወርዶ : የሚጠየፍና ከ# ማስወገድና በሌላው እስከ
ማን : እየተስተዋለ በንቃት ሊኖረው ሊረጋገጥ የሐሳብና
መረመረ : አለበት ለሚነገር ይገባዋል ሰነባብቷል አይመስለኝም
አረጋገጠ : በዚህም በአንፃሩ የሚዲያ የአፈና ይመስለኛል
ሁለተኛው : የጋዜጣው ስለፈለገ እየተከተሉ ለምሳሌ የሳንሱር
የእኛ : ካለህ መሃላቸው ይታዩና ለመፈተሽ መራሹ
የከሸፈ : የሁሉንም የሚመልስ የሚዲያ የአፈና ይህ
ሚዛናዊነትና : ብል መመለስና ከፈላጭ ሐሳብ ሐሳብበዓለም
አጠንክሮ : የሐሳብና በመደገፍ የሚጣጣሩትን ለመጠበቅ ይበጅ
አለመያዙ : እያበሩ እውነት የሚወሰድ ይነገራል እንደተጀመረ
በየትኛውም : ጉዳዩን ሜዳ የሕዝብን የአፈና ይህ
ቢመዘን : ከዕውቀትና ወደነበሩበት መሣሪያዎቹ የሙጭኝ ሐሳብ
አይደለም : አይታበልም ጨፍልቋል ይታወቅልኝ ይመስለኛል ይበጅ
በፆታ : ታስረን በረጅም ምሥራቅ ያለበት በእንግሊዝ
በሃይማኖት : በይሉኝታ ገጽታዎች ናቸው እንደተጫናቸው የተስማሙበት
በቋንቋ : ከማቅረብ እንደሌለው ነፃነትና የአፈና ይበጅ
ወዘተ : አትምጡብኝ እብድ ከቀረበ ቤት ያህል
የሚስተዋሉ : ነገሮች ከፈላጭ በዚህም የአፈና ይህ
ተፈጥሮአዊና : ጋዜጣ የተፈታ አፋኝ ብዙዎች የሚወሰድ
ሰው : አገላለጹ ትኩረት ሒሶች ዕገዳና ሚዲያ
ሠራሽ : በማያፈናፍን በመደገፍ ያለውን የአፈና ክፍለ
ብዝኃነቶችን : የሚዘርፉ ጎራ ባይሆንም በማድረግ የአፈና
ማስተናገድ : መሸፋፈን የተቋሙ በመደገፍ የአፈና ለመጠበቅ
ይጠበቅባታል : በኤዲቶሪያል ጨፍልቋል የአፈና ይታወቅልኝ ለመጠበቅ
ከዴሞክራሲ : በአሜሪካ በዚህም በአፍሪካ የአፈና በ#ኛውና
እሴት : ፍለጋ ጎን መነሳትና የሐሳብና የአፈና
ከመረጃ : በኩል በምሁራኑ ሐሰት ሲባል ቤት
አኳያ : ከየዓይነቱ መመለስና ለዚህ ሐሳብበዓለም ይበጅ
የሚባለውም : ተጓዦች እየተከተሉ በገዥው የመንግሥት ይነገራል
ጭብጥ : ከልክ አኳያ መምጣት አቆላልፎ ኃላፊዎች
መዘንጋት : ሽብር ሊሆኑ ሊኖረው ሊሸፈን ይችላል
የለበትም : ተጫውቷል አይችሉም ኒዮሊብራሊዝም አይገባም ይችላል
አሁን : ቢሆን ያለበት ሐሳብ ይመስለኛል ይበጅ
ባለው : እኔ ለአባቱና የሞላበት ከ#ዎቹ በዚህም
እየተስተዋለ : ሊሆኑ ሊኖረው ከሆነ ዋና የተሟላ
ከተፎካካሪዎች : ባለሀብቱ ሕዝቦች ቢሆን ንድፈ ገለልተኝነትንና
ተቃዋሚዎች : እውነት ባህልን ኤርትራን ይነገራል ታሪክ
ሰፊ : ለብሰው ከተመረቀ ዝግጁ ከመንግሥት ዓለም
ሲሰጠው : በዝቶም ሊፈርድ በሙያተኛው በእንግሊዝ ይበጅ
ድብልቅልቅ : እንዳጫወተኝ ሚዲያው እንደመርግ ሥልጣንን እዚህ
እህል : ጋዜጣ ግንኙነት ናቸው ዴሞክራሲ ያሉ
የሞላበት : ማጥናት ደግ ዓላማም ሚና ይበጅ
ጎተራ : መንገድም ቢረጋገጥም ወደነበሩበት ሐሳብ ታሪክ
ይዘነጋና : የሚመልስ የሚገባው በሙሉ መንገድ ቁጥራቸው
አቅጣጫ : የሚፈቀድለት እየተገነዘብኩ ያደርጋል የአፈና ይበጅ
ያዘነበለ : የጋዜጠኞች ሜዳ በተስተካከለና ግን ላይ
ድምዳሜን : ተረዳ ደጋፊነት የሚታበል ይታወቅልኝ ይበጅ
ተናጋሪዎች : ገለልተኝነትንና ይበጅ
ደጋግሞ : ፖሊሲ አስታውቀው ይበጅ
ማቅረብ : ታወቀ እንለወጥ ቢሆንም መነሳትና መኖር
የፍልስፍናው : ቢታወቅም ባህል የሐሳብና በሙሉ በመካከለኛው
ሁልጊዜም : ለዚህም ቢያንስ የሳንሱር መንግሥትንና ይህ
መስተናገድ : ልብን ቀፍድደው የሚገነባውና በተስተካከለና መንግሥትንና
የተለየና : ሥራዎችን የእኛ ግንኙነት ዴሞክራሲ መንግሥትንና
ይህን : ለአባቱና በይሉኝታ ገጽታዎች ወደነበሩበት ባይሆንም
ተፈጥሯዊ : ከባንኮች እንዲሆኑ የመንፈስ እያየሁና በሌላው
እንደሌለ : የሚገባው ከፈላጭ የሳንሱር እንደመርግ ተሳትፎ
አድርጎ : በስሜታዊነት ያደርጋል የአፈና ሚዲያ ሚና
ተዓማኒነትን : ብቃት ናቸው መንግሥትንና ይበጅ
ያሳጣል : አይታበልም አይመስለኝም ጨፍልቋል ይታወቅልኝ ይመስለኛል
በነገራችን : አንዳንድ ዓመታት የአፈና መለኮታዊነት ሚዲያ
ብዙኃንን : እያደረገ ገብነት በፖለቲካ የቅድመ ንድፈ
በልቅነትና : ከፈላጭ የመሰሉ በመደገፍ ይህ ይመስለኛል
በነፃነት : እንደየምርጫችን በይሉኝታ የሚጠልፈው ደግ የሆነ
መልቀቅ : ድብልቅልቅ መድረሻ ምዕራፍ ሳይሆን እንደመርግ
ለግል : በመሆኑ የምናየው የአምባገነን ዓላማም ሚና
ባለሀብቱ : በህንድ ተጎዳ አማራጭ እንደተጫናቸው ንድፈ
መሣሪያ : ጉድለት አለማዳመጥ በእርሱ እንደቆሙ መሀል
እንዲሆን : እንደሚችሉ ሊሆኑ በብዛት ሊገቡ ዋና
ስለዚህ : አረጋገጠ ለእውነትና በመንግሥት በዚህም ሥልጣን
መንግሥታት : ለመፈተሽ ለሚፈልግ በመቶዎች መንግሥትንና ዓላማም
በመጠኑ : ከተፎካካሪዎች መርሆዎች የሚናገሩ ዕርምጃ #
ባለቤት : እየተካሄደ ገለልተኛ ሚዲያው ግንኙነት እየተከተሉ
ሊሆኑ : እየተስተዋለ ሊኖረው ሊጤን አይደለንም ናቸው
ይገባል : እየቀነሰ ኒዮሊብራሊዝም ቢሆን ንድፈ እንዳልዘነጋሁ
አቀንቃኞች : በሄድን እሴትን ለመፈተሽ ናቸው የአገሪቱ
የሚያነሱት : ባለ ከፈላጭ የመሰሉ እንደመርግ የአፈና
ጉዳይ : ሙያተኛ የአፈና እንዳልዘነጋሁ የሚጣጣሩትን ለመጠበቅ
የኮሙዩኒኬሽን : የሕዝቦችን ለሚነገር የግል መለኮታዊነት የፈላጭ
ደኅንነት : ድህነት የፖለቲካ ፍልስፍና ሚዛናዊነትን ይበጅ
ይኼውም : በአንዳንድ በሕጋዊ ፕሮፓጋንዳ የሚመልስ በዚህም
ድምፃቸው : ሕዝብ አምባገነናዊ የሚጣጣሩትን * ይበጅ
እንዳይሰማ : ተመልሶ ኃላፊዎች በመረጋገጡ ሐሳብ ታሪክ
የሚታፈኑ : ምርመራ ሚና ይበጅ
ወገኖችን : ቴክኖሎጂ ገጽታዎች ባይሆንም መንግሥትንና ሚዲያ
መቀነስ : አለማየት ሥነ ገብነት በእስያም ንድፈ
ጉዳታቸውና : እንደጠየቀው ያለመዘጋጀት ሕዝቦች ገለልተኝነትንና እዚህ
ቅሬታቸው : ሥልጠናዎችን ረገድም ማስተናገድ አቀራረብ ሊረጋገጥ
ያልተገለጸ : ትይዩ ላይም ለብቻው በፊት በመካከለኛው
አካላት : ተመልሶ ለመፈተሽ መራሹ ፈተና ዕገዳና
እንዲሰማቸው : ፈተና መሪዎችን የአፈና የሚጣጣሩትን ይበጅ
ማድረግና : መተላለፍ ወደኋላ እየተከተሉ አውሮፓዊያኑ በመቶዎች
የአገርን : ቀፍድደው ከፈላጭ የሚገነባውና በእንግሊዝ ንድፈ
ማስቀደም : ሲታይ በደርግ እየታየ ንጉሣዊ እንደተጀመረ
ዋጋው : አካሄድ ርዕዮተ በእንግሊዝ ይበጅ
ከፍ : ወዳጄ ጥረት በተስተካከለና በሙሉ ተሳትፎ
ያለ : ስለሆነ ክፍተት የሚገባው እንደተጫናቸው ፍልስፍናው
ስለሆነ : ክፍተት ግንኙነት ድክመት የሚገባው እንደቆሙ
የነፃነት : ለማጠቃለል ጉዳዩን የሚደፈቅበት በደርግ ዋናው
የሊብራል : ሕይወታችን የሚባለው * ይመስለኛል ይበጅ
ሐሳብአሁን : ፍቅር አድናቆት ማዳመጥ በመረጋገጡ ጨፍልቋል
ኒዮሊብራሊዝም : አለማወቅ ዓይነት ብቃት ቢሆን ያለበት
የተባለውን : ሁሉ ደጋግሞ ይመስለኛል ይበጅ
መንግሥትን : አካላት መሪዎችን መንግሥትንና አገር ይበጅ
የሚያዳክም : የአገርን ከነምክንያቱ ንድፈ ሚዛናዊነትን ገለልተኝነትንና
ጥቅምን : ጥያቄዎች ከቀጣሪዎቻቸውና መልዕክት ሥራዎችን ግንኙነት
የሚጎዳና : ሎክ ሒሶች ሆነው ምሥራቅ ቢሆን
ሁሉ : የተባለውን ደጋግሞ ወደኋላ እንዴ ደጋፊነት
ለገበያና : ለመገንባት ሕዝቦች ቀዳሚው ግን ይበጅ
ለባለሀብት : ልበ የቅድመ ንድፈ ግን ይበጅ
የሚሰጥ : የሚገባው እንደተጫናቸው የተስማሙበት መርሆ ሚዲያ
ሲል : የተለየና ሳንቲም በመሆኑ መስተዳድርን ከፈላጭ
ይገልጸዋል : ይከለክላል ይታገላል ይታያል ይችላል ነው
ፀረ : መራሹ ከፈላጭ እንደመርግ ይበጅ
ልማትና : የሚያፍንና * ይበጅ
ኪራይ : ከነፃ ከኋላቀርነት ኢንዱስትሪውን ከመጣ በፖለቲካ
ሰብሳቢ : መሆኑን ተጭኗቸው ሥልጣንን ቆራጭ ገለልተኝነትንና
ሲልም : የሚመስላቸው ከዕውቀትና ዴሞክራሲያዊ መለኮታዊነት እንዳልዘነጋሁ
በድፍረት : ሲሰጠው በዝቶም ማጋነን ሊፈርድ መገለጫ
ይተቸዋል : አለባቸው ወደነበሩበት ይችላል ጨፍልቋል ሚዲያ
ልቅ : እግዚአብሔርና ዋናዎቹ መኖራቸውስ ማዳመጥ የሚመልስ
እንዲኖርም : ሳንቲም ጥረት ለዴሞክራሲ መሣሪያዎቹ የሥርዓቱ
አለመፈለጉ : ሊሆኑ ሙያተኛ ይነገራል ይበጅ
ሳይታለም : ለሚነገር የሐሳብና የሚዲያ ቀጣይነት መለኮታዊነት
የተፈታ : ድክመት የሚገባው የሚወሰድ * ይበጅ
በባለቤትነት : ወገኑማ ለሚነገር ብቃት በፖለቲካ መለኮታዊነት
የያዛቸው : የከሸፈ በንቃት አልፈው የሐሳብና የሚዲያ
እንደዚያ : የተገረመው በይሉኝታ ገጽታዎች ልማታዊነት ዕርምጃ
አይችሉም : ተጫውቷል የለበትም ይችላል እስከ እንደቆሙ
ከ# : ወርዶ እስከ ሕዝቦች ማረጋገጥ ገለልተኝነትንና
በቅድሚያ : ባይሆንም እንደመርግ በእንግሊዝ እዚህ ይበጅ
ቀጥሎም : ስቴትስ በእርግጥ መንግሥት እንደነበረው በገዥው
በዩናይትድ : ዛሬ አስመስክሯል ባለሀብቱ ለሚነገር #
ስቴትስ : በአይሁድ ተቀባይነትና ቀፍድደው የመረጃና ማብቂያ
በሌሎችም : ሆረስ መራሹ በእስያም ነፃነትና መንግሥትንና
የተስፋፋ : የመጣ የሚወሰድ ይነገራል እንደተጀመረ ይበጅ
በምሁራኑ : ተጉዘው ታስረን ከመረጃ ያዳግታል በሌላው
ጆን : መመንዘር መንግሥታት ለመፈተሽ የሳንሱር ቢሆን
ሚልተን : ዓመቱ መመለስና ሚዲያዎች ዓላማም ሐሳብ
ሎክ : የሚያበረታታ በአዋጅ ቢሆን ያለበት ላይ
ሚል : ለብቻው የሚሰጥ ገጽታዎች እየተስፋፋ በሙሉ
እና : አኗኗሩ ከዕውቀትና ሥነ መሣሪያዎቹ ዴሞክራሲያዊ
የዩናይትድ : አሜሪካ ከ#ዎቹ የአፈና ይህ ይበጅ
ፕሬዚዳንት : አስተዳደርና ከአውሮፓ በመካከለኛው በአፍሪካ ፍልስፍናው
በነበሩት : የሻረ አለመጠናከር የፕሬስ ኤርትራን የአፈና
ቶማስ : የጋዜጠኞች በዚህም የአፈና በእንግሊዝ ይበጅ
ጀፈርሰን : አፋቸው ከመረጃ ጠቃሚ የጋዜጠኞች በዚህም
ተቀንቅኖ : ረገድም በመረጋገጡ የአፈና ሚዛናዊነትን *
በፊውዳሊዝም : በኤዲቶሪያል በዚህም የሕዝብን የአፈና ይህ
መፈራረስና : የሚፈልገውን ሀሰትን አቀፍ መፍረስም በእንግሊዝ
ካፒታሊዝም : ምግባርና ዋነኛ ታሪክ ሚዲያ ሚዛናዊነትን
ማበብ : ከዓለም ርዕዮተ በሥልጣን ይነገራል ይበጅ
ጉልህ : ጉድለቶች ጉድለትን እየተከተሉ ያለውን የአፈና
ተጫውቷል : አይችሉም የለበትም አይችልም ሰነባብቷል ይችላል
እምነቱ : መመለስና ይህ ታሪክ ሐሳብበዓለም ይበጅ
ሊያሳውቅ : ወር ጉድለቶች ወዳጄ እየተስፋፋ ጥረት
ሊያዝናና : ስናልፋቸው ማደናገር ሽብር ይታይ የሚገባው
እንደማንኛውም : ወዳጄ ፈቅደው የአፈና በእንግሊዝ ሚዲያ
ሸቀጥ : የተለየና አሁንም ድክመት የመሰሉ ብዙዎች
ሊነግድ : ባለሀብቱ ተጎዳ ሒሶች አንድና የአፈና
የሚል : ባይመስለው ሥራዎችን ብዙዎች ባህሪ ሚዲያ
በዋናነት : እንዳሉ እንቅፋቶች ለዴሞክራሲ ሚና እዚህ
በግል : የፔንሲልቫኒያ ቦታቸው ምን በክልልና ክፍለ
መያዝ : ከማቅረብ ትክክለኛ ናቸው በመረጋገጡ ይበጅ
እንዳለበት : እንደሚችሉ የሚገባው እንደቆሙ ይበጅ
ነፃና : የሚስባቸው ናቸው መፍረስም ያሉ ይበጅ
ከቅድመ : ማጥናት ኢሕአዴግ ጨፍልቋል የአፈና ይነገራል
ውጪ : ጥረት የአፈና ሥልጣንን እዚህ ይበጅ
እንደ : የተለያዩ ትውልድ እንደነበረው ያህል *
አራተኛ : ሚዛናዊና በሥጋት ከፈላጭ ያለውን ዓላማም
አካል : ብሔራዊ ካለው አማራጭ የግል አንድ
ከሕግ : ያፈነገጠ ሲታይ ሙያተኛ መመለስና ዋነኞቹ
አስፈጻሚና : ዕፅ አለማየት ተቋማቱ ፍልስፍናን ንጉሣዊ
ሕግ : በማላቀቅ ሚዲያዎችን የሚወርደውን በእንግሊዝ እንዳልዘነጋሁ
ተርጓሚ : አስከባሪዎች ማስፈን ጋዜጠኛን በመንግሥት ከሦስት
ተደምሮ : ሊጋጭ ይከተላሉ አንድና ፕሮፓጋንዳ አስኪያጆች
መታየት : ጓደኞቻችንን ታስረን ሙያተኛ የሚመልስ የሐሳብና
ይቀነቀናል : ወሰነ ተረዳ እንዴ ይነገራል ይመስለኛል
ገለልተኛና : በሚገኝ የሚኖረውም ቢመዘን ወደነበሩበት መሣሪያዎቹ
እሳቤዎችን : ጊኒ ከድህነት ያውም ሙያተኛ ማብቂያ
ቢያቀነቅንም : የሚያደርጉትን ከድህነትና ሚዲያው ባይሆንም ፍልስፍናን
ውግንናው : ፖሊሲው በእንግሊዝ እዚህ ይበጅ
ለሊብራል : ንባብ ለግል የሚናገሩ የአምባገነን ገለልተኝነትንና
ሥርዓቱና : ዜግነቱ ገጽታዎች አሁንም አልነበረም በ#ኛውና
ለባለሀብቱ : አይጥለውም ጆን የሳንሱር በማያፈናፍን የአፈና
የግልም : ተመልሶ ገጽታዎች ማብቂያ በሥልጣን የአፈና
ይሁን : ጊኒ ሰው ሐሳቦችን ሳንሱር *
የአክሲዮን : የኤሌክትሮኒክና ብዙዎች መንግሥትንና አሠራር ይህ
አልያም : ረገድም በቋንቋ ነፃነትና ሚዛናዊነትን እዚህ
የምዕራቡ : ዓመታት መንግሥታትም ሐሳብ ታሪክ ሚዲያ
ከርዕዮተ : የርዕዮተ ዋናው አሠራር በእንግሊዝ ሐሳብ
ሊጋጭ : ተደምሮ ይታይ አገሮች የአፈና ገለልተኝነትንና
እንደማይችል : ኒዮሊብራሊዝም መሸፋፈን የቅድመ መለኮታዊነት እንዳልዘነጋሁ
አስመስክሯል : ነበሩ # የሚዲያ በ#ኛውና ይታወቅልኝ
መረጃ : አቀንቃኞች ብለው የአፈና ይበጅ
በሸቀጥነት : አንድና እንደሌለው ሥልጣን እዚህ ይበጅ
ከቀረበ : የአፋልጉን አረጋገጠ ለሚዛናዊነት ለምክር የጋዜጣ
የሆነውን : እንዳይገቡ ፍራንስ በኢትዮጵያ የህሊና ይበጅ
ካልሆነው : የፔንሲልቫኒያ በሌላው ለሚፈልግ ከፈላጭ የአፈና
መርጦ : ከአገዛዙ የሚጣጣሩትን ለመጠበቅ ላይ ይበጅ
የመውሰድ : መርምሮ የመሥራት በዚህም መለኮታዊነት ቀዳሚው
የአንባቢውን : የሚጣጣሩትን ገለልተኝነትንና ይበጅ
የአድማጭና : መግለጽም ማዳመጥ ከፈላጭ በመደገፍ የአፈና
የተመልካቹ : ፍራንክሊን ደጋፊነት ባህሪ ይታወቅልኝ ይበጅ
መብቱ : የሚያውቁት የምናውቀው አ የሚዲያ ይመስለኛል
በሠለጠነ : በዚህም የሳንሱር የሚዲያ የአፈና መለኮታዊነት
ማኅበረሰብ : ማድረጉ የአገርን በፆታ ቀፍድደው ቼክሊስት
ጠቃሚና : ያገኙት የሚጠይቅ ጎልቶ ንጉሣዊ ሚና
ተገቢ : ዕርምጃ ቢሆን ገለልተኝነትንና ግን ይመስለኛል
ባለፉት : ማለዳ አንዳንድ ለዚህ የሚዲያ መንግሥትንና
ሃያ : ብርሃኑ ከመረጃ ቤት በመሆኑ በረጅም
ከሞላ : ባንክን በሌላው መብት በሥልጣን በእንግሊዝ
ጎደል : ተግባር ማብቂያ የሚዲያ የአፈና በ#ኛውና
የዚህን : ቅሬታ ለሚፈልግ ዋነኞቹ የአፈና ሥልጣንን
የፍልስፍና : ማሳተም እምነቱ መርሆዎች የአፈና ንድፈ
ሞዴል : መምህር ብሔራዊ ድህነት የለውጥ ታሪክ
አርዓያ : የዓለማችን ቀፍድደው ተሳትፎ የአፈና ለመጠበቅ
የሚንቀሳቀሱ : ወገን በመቶዎች አንድ እንደመርግ ይበጅ
ጋዜጦችና : የመሰላቸውን አለመላቀቁ ሥርዓት ሚዲያዎችን የመሰሉ
መጽሔቶች : መሸፋፈን መግለጽም እንዳልዘነጋሁ ሚዛናዊነትን ይበጅ
ታይተዋል : አረጋግጠዋል አጋጠመው አይችልም ደርሰዋል ይባላሉ
በኩል : ከመረጃ ሳንቲም በተስተካከለና የሐሳብና ደርግ
ሊብራሊዝምን : ሲያበቃ የተሟላ የሚያፍንና የአፈና በእንግሊዝ
እንደፍልሰፍና : መሸፋፈን አቀራረብ እውነት ሊሸፈን የሚታበል
በመከተል : ከየዓይነቱ ጥረት ከፈላጭ ይታወቅልኝ ለመጠበቅ
የሚያቀነቅኑ : እንደግ ማደናገር የሚለውን የከተሞች አሁንም
ከዚያ : ምሥራቁ ሙያተኛ የፕሬስ ነፃነትና እንዳልዘነጋሁ
የመሰላቸውን : እንዳልሆነ እንዳይገቡ አረጋገጠ ከፈላጭ ሥልጣንን
አቋም : ኃላፊ ጉዳይ የሐሳብና ሚዲያን መዋቅሮችን
የሚያብጠለጥሉ : እየተከተሉ እንደተጫናቸው እንደተጀመረ ይመስለኛል ይበጅ
በሌላ : መመለስና ብዙዎች ዓላማም የአፈና ሥልጣንን
የሚዛናዊነትና : ፍራንኮ በቅድሚያ ጉድለትን እንዳጫወተኝ ባይሆንም
የተዓማኒነት : እያለፋቸው አለማዳመጥ መሣሪያነታቸውም የሚሰብክና መርሆ
ፈጥኖ : ቢያንስ ባይሆንም በ#ኛውና ሚና እዚህ
መውጣቱ : የወጣና የአክሲዮን መሆኑን መሣሪያዎቹ ገለልተኝነትንና
ያለከልካይ : ተቀጥሮ ይመስሉኛል የሐሳብና የአፈና የሚጣጣሩትን
አንባቢያን : የአፈና በ#ኛውና አምባገነናዊ ሚዛናዊነትን ይበጅ
ማድረሳቸው : ስቴትስ የሚስተዋሉ በየትኛውም ይህ ሐሳብበዓለም
ሊባል : ብዕሬን መገለጫ አስፈጻሚ ቀዳሚው ሐሳብበዓለም
ጉድለታቸው : ምንም ገጽታዎች በደርግ በዚህም በንጉሡ
በአብዛኛው : ይኼን ኢሕአዴግ የአፈና መለኮታዊነት ይህ
የሚመስል : የተቋሙ ሚዲያዎችን የአፈና መለኮታዊነት በእንግሊዝ
ጫፍ : ከተማውን የሚገባው ይህ ሚዲያ ይበጅ
የወጣና : ቢኖርም ገለልተኝነትንና እዚህ * ይበጅ
የተቀናጀ : ይከተላሉ ህንድ በአንዳንድ መርሆዎች በዚህም
ዘመቻ : ጉዳይ አማራጭ የብሮድካስት እንዳልዘነጋሁ ሚዛናዊነትን
ማካሄዳቸው : ስለሆነ የሚገባው እንደቆሙ መርሆ ሚዲያ
እያደነቃቸው : ከተገመተው ጎደል የግልም በሙያተኛው በሥልጣን
ጅምሮችና : ከሌለህ የፍልስፍና ብቃት በዚህም ከመጣ
ሥራዎችን : የተለየና ግንኙነት ሚዲያዎች መንግሥትንና ሚዲያ
ጥላሸት : ይከተላሉ ቤት ከመጣ መለኮታዊነት ታሪክ
መቀባት : ገብነት ዋነኞቹ * ይበጅ
መደበኛ : አውሮፓዊያኑ በሙሉ በመካከለኛው የአፈና ሚና
ሥራቸው : እንደፌዝ መርሆአችን ልበ የሚገባው እንደተጫናቸው
ሆኗል : ጋበዛቸው ደርሰዋል ይነገራል ይመስለኛል ይበጅ
ጉዳዩን : በዚህም የአፈና ይህ ታሪክ ሚዲያ
መርምረው : ፍራንኮ ከድህነትና ባይሆንም በመረጋገጡ ሕዝቦች
በሚዛናዊነት : ምሁራን መሣሪያነታቸውም ሁኔታ ነፃነት መንግሥትንና
በጥልቀት : በስሜታዊነት ወደኋላ ናቸው ከፈላጭ መፍረስም
ሠርቶ : ብዛት ዴሞክራሲ ብዙዎች ነፃነትና ዓላማም
ከማቅረብ : የሚዘርፉ ጎራ የአፈና ይበጅ
የለብለብና : ትክክለኛ ዕድል ናቸው ውስጥ አሁንም
ያልተጨበጠ : እንዲሁ ዕድገት ስለፈለገ ባህሪ ይታወቅልኝ
ዜና : ርዕዮተ በእንግሊዝ ሚዲያ ይመስለኛል ይበጅ
በረከተ : ያዳግታል ጨፍልቋል መንግሥታትም ይታወቅልኝ ይመስለኛል
መርዶ : ለመፈተሽ መራሹ ዴሞክራሲያዊ ንድፈ ለመጠበቅ
ነጋሪዎች : መታየት ሊያዝናና ጎራ ሊኖረው መቅረፅ
እንደሚላቸው : ወጥቶ ጦርነት የሚገነባውና በተስተካከለና ሕዝቦች
ተሰበረ : ከዴሞክራሲ የሚዲያ ዓላማም የአፈና በእንግሊዝ
ሞተ : በተሳሳተ በተስተካከለና የሚጣጣሩትን ይበጅ
አንዳንዴም : ባለሀብቱ ተጎዳ አሜሪካና ሐሳብ ላይ
በሰላም : የሚታፈኑ ሚዛናዊና ደግ ደጋፊነት ከፈላጭ
ጦርነት : እንደሚላቸው ቢሆንም አንድና ናቸው የተባለው
ተቀሰቀሰ : በሸቀጥነት አንፃር ገለልተኝነትንና እዚህ ይመስለኛል
በማለት : መደበኛ እንቅፋቶች ያለመዘጋጀት ግንኙነት በክልልና
ሽብር : መዘንጋት የሚዘርፉ ናቸው ይችላል እንደቆሙ
ይለቃሉ : አረጋገጠ ይታያል ቀብሯል አገዛዝ በእንግሊዝ
መካብ : ከላይ ከኢንዱስትሪና የሚዲያ የአፈና ይህ
የተፈለገውንም : ቀፍድደው የአፈና በ#ኛውና የሚባለው ሚዲያ
በባዶ : ባህሪ ተደርጎ ይበጅ
እያገዘፉ : ሥርዓት የአፈና የሚባለው እዚህ ይበጅ
ማደናገር : ተመሥርተው በዝቶም የሚገባው ነፃነት መሆኑ
ተለመደ : የለበትም አለበት ይችላል ነፃነትን እስከ
የተዛባና : ፓርቲ የግልና ትንሽ ብዙዎች መንግሥትንና
ከነፃ : የዚህ አምባገነናዊ ለመጠበቅ ሚዛናዊነትን ላይ
ያፈነገጠ : ሁኔታ መዋቅሮችን የአፈና በ#ኛውና ሚና
ድርጊትም : ብሔራዊ የሊብራል የሐሳብና በሙሉ ሙሉ
አለፎ : የተፈታ ድክመት መሀል አገዛዝ እንደተጀመረ
አልፎ : ሐሳቦች ተቋማት የሚጋርጥ መመራታቸውና ሐሳብ
መተላለፍ : በፈላጭ ሚዲያው ባይሆንም ፍልስፍናው ምርመራ
የአገር : ለተፈጥሮ ሒሶች ሚዲያ ይበጅ
መንካት : ፈረንሳይ ዋጋው ምርመራ በእንግሊዝ የሚባለው
ሲሄድ : ናቸው እንዳይኖር ይበጅ
ታየ : ይችላል በገዥው ያደርጋል የአፈና የሚባለው
ለማጠቃለል : ዋናው ሐሳብበዓለም ይበጅ
የሚመራባቸውና : አለመላቀቁ ዋነኞቹ የአፈና የሚጣጣሩትን ገለልተኝነትንና
እያለፋቸው : የሕግ የሚታበል በመደገፍ የሚሰብክና ለመጠበቅ
የመጡት : ቅንጣቢውን ደጋፊነት የሚገባው የሚታበል የተስማሙበት
ዋናዎቹ : ናይጄሪያና ፊላደልፊያ መመለስና በዚህም የሐሳብና
ሐሳቦች : ሐሳብመነሻው የያዟቸው ሐሳብበዓለም ይበጅ
ይመስሉኛል : ይበዛል ሲባል ቤት ሒሶች ይሆናሉ
አንዳንዶች : የሳንሱር የአፈና ገለልተኝነትንና እዚህ ይበጅ
ከየዓይነቱ : ጥርጥር ሊሆኑ አኳያ ሚዛናዊና ሊጤን
የሚጠቅማቸውን : ከድህነትና የሚገባው እንደሌለው ይህ እንዳልዘነጋሁ
ወስደው : ግለሰብ ጸሐፊዎችና ባለሀብቱ በህንድ የልማት
በራሳቸው : ብር ምርመራ ሚና እዚህ ይበጅ
ልቦናና : ጥበባዊ በሠራው በዚህም የአፈና በ#ኛውና
ታሪካዊ : ሁነኛ ጉምሩክ በአዋጅ የቅድመ ቀጣይነት
ቃኝተው : መምህር አኗኗሩ ሐሳብ ታሪክ ላይ
መልካም : ነገሮች አቀራረብ ከፈላጭ መገለጫ የአፈና
ጅምር : ሒሶች ቢሆን የአፈና የሚባለው ይበጅ
ያሳዩም : ጓደኞች ብቻ ቀዳሚው * ይበጅ
በአፍሪካም : ነገር ለምሳሌ ኢሕአዴግ ኢትዮጵያዊያንና ይህም
እነ : እንዳይለውጥህ በይሉኝታ ትኩረት ወደነበሩበት የሚገነባውና
ጋና : የመሰሉ ይህ ይመስለኛል ይበጅ
ቦትስዋናና : ማንም መነሳትና ሕዝቦች ተሳትፎ የአፈና
ደቡብ : በኤዲቶሪያል የተቋሙ በ#ኛው ይህ ይበጅ
አፍሪካ : አቀራረብ ቀፍድደው የአፈና በእንግሊዝ የሚጣጣሩትን
የዴሞክራሲና : ሆረስ ባህል የሚገነባውና የሐሳብና ነፃነት
የመረጃ : የፔንሲልቫኒያ የአመለካከት የአፈና ይታወቅልኝ ለመጠበቅ
ቀንዲላቸውን : የሚያነሱት ሚዛናዊነትና መመለስና የመንግሥት ሐሳብ
አድርገው : ከአውሮፓ ደረጃ ለምሳሌ የሚታበል የሆነ
እያበሩ : ታስቦ አለመያዙ የመጣ የሚወሰድ ይበጅ
የደረስንበት : መድረሻ በሕገ ክፍለ ሐሳብ ለመጠበቅ
ክንድ : ሚዲያን ሚዲያ ይበጅ
የበረታበት : ስለሚሰጣቸው የሚያነሱት ሚዛናዊና ምርመራ የመንግሥት
የግሉ : ብዛት ከድህነትና ዴሞክራሲ ነፃነትና መንግሥትንና
የኮሰመነባት : ታስረን የኤሌክትሮኒክና የሚደፈቅበት ብዙዎች በእንግሊዝ
ብሮድካስት : እየተስፋፋ መመራታቸውና በእንግሊዝ የሚባለው ሚዲያ
በፍልስፍና : ጉዳዩን የገቢዎችና ቢኖርም በአፍሪካ ይህ
ረገድም : አልያም መገልገያ ታሪክ ሚዛናዊነትን ይበጅ
በሊብራሊዝም : ምክንያቱ የሚወሰድ የአፈና ይህ ይበጅ
ልማትን : የዚህን በተስተካከለና በዚህም ተሳትፎ የአፈና
የሚጠየፍና : በኖረ ወርዶ ሚዲያው በፖለቲካ እንደተጫናቸው
ምንም : ጉድለታቸው በደርግ ለምሳሌ በአፍሪካ መንግሥትንና
በጎ : የምታውቁ የሚጋርጥ እንደመርግ ያለውን ሚዲያ
የማያይ : በተጨባጭ ፍልስፍናዬ የጋዜጣ ሕዝቦች ተጭኗቸው
በልማታዊ : ስለኤሌክትሪክ ከልማታዊ ዴሞክራሲ መንግሥትንና ሚና
ዴሞክራሲና : ናይጄሪያና የአፈጻጸም እንዳጫወተኝ ባይሆንም ንጉሣዊ
የሕግ : እያለፋቸው የሕዝቦችን ለሚፈልግ የኅትመት በመደገፍ
የበላይነት : አተገባበር ህልውናዬ ዋነኞቹ አገዛዝ የሚባለው
እንዳሉ : መናገሩም የዓለማችን ሊሸፈን መሣሪያነታቸውም ብዙዎች
የማይመረምር : ቢመጥቅ ቤት በተስተካከለና በገዥው የሚያፍንና
የተንሸዋረረ : አንድ ነፃነትና የአፈና እንዳልዘነጋሁ እዚህ
ዕይታ : ቤንጃሚን ደቡብ ጉዳዩን ኤርትራን ነፃነት
ተፈጥሯል : አረጋገጠ አውሮፓዊያኑ የሚገባው በአንፃሩ ይነገራል
ሁሉም : በዚህም የአፈና መለኮታዊነት ሥልጣንን ይህ
ከሚያመቸው : ሐሳቦችን በመረጋገጡ ማብቂያ የአፈና መለኮታዊነት
ቅንጣቢውን : ሥራዎች ከሆነ የሚታበል ብዙዎች በእንግሊዝ
እየገነጠለ : ጥላሸት ሚዛናዊ የተስማሙበት የአፈና ሚዛናዊነትን
በእውነት : ከአንዳንድ ደጋፊነት ቢሆን የሚወሰድ ይመስለኛል
የማያሞግስና : በተግባራቸው ይልቅ በክልልና አለመላቀቁ ሚዲያዎችን
የማይተች : ዝግጁ ብቃት የሚገባው ብለው የሚያፍንና
ቁጥሩ : ጓደኞቻችንን መታየት መርሆአችን የሐሳብና የሚባለው
ቢበዛም : ከማቅረብ እንጂ የሳንሱር እንደሌለው ሥልጣንን
አድርባይነትና : የነበሩት የሚፈልገውን አቆላልፎ በተስተካከለና በእንግሊዝ
አሻጥር : ምሁራን መዋቅሮችን የሚሰብክና የሚጣጣሩትን ይበጅ
የሚጠልፈው : ናት በተስተካከለና የሆነ ሥልጣንን ግን
አይድንም : ያገኛል ያዳግታል ሰነባብቷል ጨፍልቋል ነፃነት
እያየሁና : ቢነሳም የሐሳብና እንደመርግ ሳንሱር ምርመራ
እየተገነዘብኩ : ያደርጋል የአፈና ይነገራል ይበጅ
ከአንዳንድ : አይፈቅድም ለማድረስም ታስቦ በእውነት በልቅነትና
ሰዎች : አገናኙን ርዕዮት መሣሪያነታቸውም እንዳልዘነጋሁ ላይ
ስነጋገር : አንፃር ዋነኞቹ የተባለው አገዛዝ ገለልተኝነትንና
መቼም : ጋና የዩናይትድ የልማትና ከ#ዎቹ ቢሆኑም
ሪፖርተር : ወዳጄ ለመፈተሽ በመደገፍ የሚሰብክና ለመጠበቅ
ሐሳቤን : ያጋለጠውን ምንጫቸው የያዟቸው እንዳይኖር ይበጅ
አይጥለውም : በዚህም የሳንሱር ምሥራቅ የአፈና መለኮታዊነት
በሚል : አሳድዷል ይመስለኛል ይበጅ
ብዕሬን : እኔ ልጅ ለአባቱና ምንም ሊባል
ያነሳሁት : አቀራረብ ነፃነት የአፈና የሚሰብክና ይበጅ
ኢንዱስትሪው : በተጨማሪ መመለስና ሚና እዚህ *
በዕውቀትና : የሚመለከታቸው አምባገነናዊ ግን እዚህ *
በአገራዊ : አቀራረብ ከአገዛዙ የሚሰብክና በ#ኛው ለመጠበቅ
አለመመራትና : የሙጭኝ ሐሳብ የሚጣጣሩትን ለመጠበቅ ሚዛናዊነትን
አለመገንባት : ንፅፅር ትገዛ ከድህነትና በመቶዎች መዋቅሮችን
ሊያነጋግረን : በባህል የሚያነሱት አለማዳመጥ በረጅም ፍልስፍናን
ይባልልን : አልነበረም ይታወቅልኝ ይመስለኛል ይበጅ
ከአዘጋጁ : አንዳንዶች በዚህም መመራታቸውና የአፈና በእንግሊዝ
ፀሐፊውን : ፌቴክ ሕይወታችን አነብናቢነት ዋና እንደተጫናቸው
በኢሜል : አድናቆት ቢገለጽም የውጭ ታሪክ ይታወቅልኝ
አድራሻቸው : የአንድ መራሹ እንደመርግ መንግሥትንና ያለውን
ማግኘት : መቀየሪያ መነሳትና ሕዝቦች ቀዳሚው እዚህ
ይቻላል : የለበትም ምንድነው ቢሆን የቅድመ ንድፈ
የሮማው : የአፋልጉን ጉዳዩን የነፃነት ከዴሞክራሲ ካለፈው
ካቶሊክ : የሚገነባውና መፍረስም ሁኔታ መገልገያ ነፃነት
ቤተ : ግለሰቦች በአፍሪካ መንግሥትንና ዓላማም የአፈና
ክርስቲያን : የሚስተዋሉ በእንግሊዝ በ#ኛውና ይበጅ
ጳጳስ : መሸፋፈን የተቋሙ ወደ ነፃነት የአፈና
ከጥር : የለውም ዘግቧል ይለቃሉ ይመርጣል ቤት
በፊሊፒንስ : በመቶ ተመሥርቶ ተሳትፎ የአፈና መለኮታዊነት
የሚያደርጉትን : አፋቸው ለምክር ሚዲያው ባይሆንም መንግሥትንና
ጉብኝት : አሉባልታ በአገሪቱ የጎላ ቤት የሕዝብን
በማስመልከት : እንደዘገበው የሚጠቅማቸውን ይታይ የሚገባው ገለልተኝነትንና
ትራፊክ : ጉዳዩን በሌላ ካለፈው ሥርዓቱ በዚህም
ፖሊሶች : ውጤትም የሚዲያ * ይበጅ
ዳይፐር : ወዳጄ ተሳትፎ ከአገዛዙ የሚጣጣሩትን ለመጠበቅ
እንዲያደርጉ : የተንሸዋረረ የፕሬስ ዓለም ባህሪ ነፃነትና
ትዕዛዝ : ማገዙንም የተገመተ ይነገራል ይበጅ
እንደተሰጣቸው : የተሰጠው በዛሬው በማያፈናፍን በ#ኛውና የሚባለው
አጃንስ : ለአጃንስ የሚስተዋሉ አክራሪነትና በአፍሪካ ይህ
ፍራንስ : እንዳይገቡ አረጋገጠ ይታገላል የፓርቲው ፓርቲ
ፕሬስ : በ# ከርዕዮተ የርዕዮተ የጋዜጣ ዋናው
ዘግቧል : ተናግረዋል ይለቃሉ ተከናውነዋል ኢንዱስትሪውን በዚህም
የተሰጠው : እንደተሰጣቸው ይህም እዚህ * ይመስለኛል
በጳጳሱ : ዴሞክራሲ መንግሥትንና ቆራጭ ንድፈ ሚና
ለረዥም : በመከታተያ አነብናቢነት ያህል ዓለም በገዥው
ሰዓታት : ተጸጽቶ ታየ በሸቀጥነት ብቻ ቀዳሚው
በሥራ : የእኛ ለመፈተሽ ዓላማም የአፈና በ#ኛውና
ገበታቸው : እንሂድ አደረጃጀት በሙያተኛው የአፈና በእንግሊዝ
በተጠንቀቅ : ባለሀብቱ ከዴሞክራሲ ጉድለቶች ከሙያዊ አውሮፓዊያኑ
እንዲገኙ : መንግሥት ተሳትፎ የአፈና ይህ የሚባለው
ታስቦ : አይፈቅድም ማድረግ እውነት ደጋፊነት የሚታበል
ዳይፐሩን : አክራሪነትና በዚህም ነፃነትና መንግሥትንና መለኮታዊነት
ትራፊኮች : አዘዋዋሪዎቹም ሰላም የዴሞክራሲ የመንግሥት ዓላማም
ሳይሆኑ : ሐቅን በመሆኑ ሚዲያዎችን የአፈና በ#ኛውና
የፀጥታ : ባጋጠማቸው አለመስጠት በመደገፍ የሚሰብክና ዘመን
አስከባሪዎችም : ቢኖርም ሚዲያ እዚህ ይበጅ
ጭምር : ማድረግ እውነት ይነገራል ይበጅ
የሚያደርጉ : ያገኙት ጉዳዩ የመውሰድ አቀንቃኞች ተዓማኒነትን
ሲሆን : እንዳይዛመት በተጨባጭ ጎልቶ ተጭኗቸው የመንግሥት
ፀጥታ : ላይም ተመልሶ ክፍል በመካከለኛው የአፈና
አስከባሪዎቹም : ሚዲያው ትንሽ በ#ኛውና ሐሳብ የሚጣጣሩትን
ለተፈጥሮ : የአገር ቤት ወደነበሩበት ታሪክ ሚዲያ
ጥሪ : ቢተኮስ መፈናቀል ጉዳይን ቤት ሙያተኛ
መፀዳጃ : በምሁራኑ ሲባል በእንግሊዝ የሚባለው ሚዲያ
እንሂድ : ገበታቸው አቆላልፎ የህሊና የሚያፍንና የአፈና
ሳይሉ : ድሃ እየተከተሉ ቢያንስ መንግሥትንና ዓላማም
ቦታቸው : ጎተራ መንገድም የአፈና በእንግሊዝ ክፍለ
ማድረጋቸው : ድህነት አስተሳሰብ አባልነትና መፍረስም በመረጋገጡ
አስፈላጊ : በምሁራኑ ፍፁም ሚዲያ ይታወቅልኝ ይመስለኛል
ሆኖ : አቆላልፎ እንደነበረው ደርግ ተጭኗቸው በእንግሊዝ
በመገኘቱ : እኔና የሚለውን እየተከተሉ መሀል እንደተጀመረ
ጉዳዩ : የሚያደርጉ የያዛቸው መምጣት አቀባይ የሚባለውን
የሚመለከታቸው : ቢያንስ ባይሆንም ያለውን የአፈና በ#ኛውና
ኃላፊ : እያየሁና ሚዲያን ይበጅ
ኤመርሰን : ተዓማኒነትን በህንድ ሙያና ባህሪ ነፃነትና
ካርሎስ : ሆረስ የዴሞክራሲና እያደገ በማድረግ ግን
ለአጃንስ : አጃንስ በማላቀቅ ከአውሮፓ ቢሆኑም የሚወርደውን
ተናግረዋል : ይለቃሉ ይታያል ይነገራል ይመስለኛል ይበጅ
ዕቅድ : በአፍሪካም ኢሕአዴግ ማብቂያ የአፈና በእንግሊዝ
ከጳጳሱ : እንዳይለውጥህ በደርግ ሙሉ ምርመራ እዚህ
ቀደም : መሻሻልን እንደነበረው በአፍሪካ ፍልስፍናው የአፈና
እንደሚሞከርም : ነፃ እንደተጫናቸው ምሥራቅ ያለበት በ#ኛውና
አስታውቀው : አይፈቀድለትም ተረዳ እውነት ይነገራል ይበጅ
ጳጳሱ : ኢትዮጵያዊያንና በማድረግ የሚዲያ መንግሥትንና ዓላማም
ከፍተኛ : ብዙዎች አሠራር ሐሳብ ታሪክ የሚጣጣሩትን
አድናቆት : በመረጋገጡ የአፈና መለኮታዊነት ሐሳብ ይታወቅልኝ
ስለሚሰጣቸው : ሚዛናዊና ከፈላጭ ምርመራ ይነገራል ሚና
በጉብኝታቸው : ዘግቧል መኖራቸውስ ቤት ነፃነትና የሚዲያ
ቁጥር : ባይሆንም በመረጋገጡ ታሪክ ሚዲያ የሚጣጣሩትን
እንደሚጠበቅ : የአሁኑን ውስጥ ሊረጋገጥ ደርግ የአፈና
የገለጹት : እየተገነዘብኩ ማድረግና መራሹ በሥጋት ያደርጋል
የሕዝቡ : ግንባር እንደየምርጫችን አለመያዙ ጽንፈኝነትን ሁኔታ
ብዛት : የግሉ ርዕዮት ዴሞክራሲ መፍረስም ብዙዎች
ከልክ : የ# ተቀጥሮ ሁኔታ የአፈና በእንግሊዝ
ስለሚችል : እንዲገኙ መንግሥት ተመልካች ተሳትፎ የቅድመ
እንሰጣቸዋለን : መከናወን የሚስባቸው ናቸው ይነገራል ይበጅ
ብለዋል : ወሰነ ይመስለኛል ይበጅ
ትራፊኮችንና : ክንድ ሚዲያን መዋቅሮችን ይበጅ
ኃይሎችን : የአፈና ከአገዛዙ ሚዲያ ይበጅ
የማስደረግ : ከተባለ እንደዚያ አስተዳደርና ሚዲያው የሳንሱር
ፕላን : እገዛ ምርምር ባህሪ ነፃነትና መለኮታዊነት
በብዙዎች : እየተከተሉ የሚገባው የመሰሉ አሠራር ይህ
ቀልድ : ጥርጥር ሊሆኑ ናቸው ውስጥ ሐሳብበዓለም
ታይቷል : ተጉዘው በምሁራኑ ያዳግታል ሳንቲም በእንግሊዝ
ለትራፊክና : በዚህም ዜጎችን የሚዲያ መንግሥትንና መለኮታዊነት
ለፀጥታ : በእስያም ኤርትራን በመደገፍ መለኮታዊነት ሚዛናዊነትን
አስከባሪዎች : ዕርዳታ በሚታትር ግንኙነት ሚዲያ ይበጅ
እንደፌዝ : ሥራቸው ሒሶች ገጽታዎች ናቸው የሚታበል
እብድ : ወዘተ ርዕዮት ያህል መፍረስም የጋዜጣ
የሰው : ሆነናል በይቅርታ በማላቀቅ የመንግሥት የአፈና
አኗኗሩ : ቃኝተው ታሪክ ሐሳብበዓለም * ይበጅ
ቢለይ : የአፋልጉን ከቀረበ ሚዲያው ከዓለም እየተከተሉ
ሐሳቡ : በእንግሊዝ እዚህ ይበጅ
ቢመጥቅ : ተቀጥሮ ቤት ሒሶች ሚዲያው የሚገባው
ቢተኮስ : የሚባል በእጅ ሸሽቶት የግልና የሚዲያ
ባይመስለው : የሚል የኤሌክትሮኒክና ያለመዘጋጀት ብዙዎች ሚዲያ
ቆሞ : የሚዘርፉ በመረጋገጡ ዜጎችን የአፈና ሐሳብ
መሃላቸው : በይሉኝታ የእኛ እንዲገነዘብ በሚታትር ከፈላጭ
ንግግሩ : በፆታ ቀፍድደው የሚሰብክና ሚዛናዊነትን ላይ
ቢከብድ : ዕገዳና ተሳትፎ ግን ይበጅ
ቢያደናግራቸው : የሚገባው ከፈላጭ እንደተጫናቸው በሙሉ የሚዲያ
ይሉታል : ነኝ ሀሰትን ካርሎስ ብል ሁኔታ
አፋቸው : ተጉዘው የሚያደርጉትን ጀፈርሰን ከሙያዊ ባይሆንም
ሀሰትን : ሁኔታ ዓላማም የአፈና በእንግሊዝ ሐሳብበዓለም
በጠላ : የኢትዮጵያውያን ለሚዛናዊነት የተለመደ ለምክር በሙሉ
ሐቅን : ንባብ ከመረጃ ሚዲያዎችን በእንግሊዝ ሚዲያ
ባፈቀረ : ኒዮሊብራሊዝም የሕዝቦችን ከድህነትና ናቸው ከፈላጭ
የውስጠቱን : ለምክር የጋዜጠኝነት አውሮፓዊያኑ በመካከለኛው እዚህ
በቃላት : በይሉኝታ ድብልቅልቅ ፈጣን አስተሳሰብ እንዳጫወተኝ
ባኖረ : ሳይሉ ዴሞክራሲ መንግሥትንና ዓላማም በእንግሊዝ
አትምጡብኝ : ወዘተ ህንድ ትችቶች ምግባርና መመለስና
ባለ : የሚያነሱት ከፈላጭ የመሰሉ ነፃነት መንግሥትንና
ለብቻው : ሚል በምሁራኑ እንደተጫናቸው በመካከለኛው የአፈና
በኖረ : የሚጠየፍና ሚዲያው ግንኙነት ዕርምጃ የሳንሱር
ሐሜትን : ደርግ ምሥራቅ ቀዳሚው ይበጅ
ሥራን : ከመረጃ ቆራጭነት ቤት በመከታተያ በመሆኑ
ባከበረ : ደጋፊነት በፖለቲካ የመሰሉ ይህ *
እብድነቱ : አስተሳሰባቸው በመካከለኛው ነፃነት በ#ኛውና የሚባለው
ተነገረ : መሆኑን ሕዝቦች ገለልተኝነትንና ይበጅ
እንበልጽግ : ፍልስፍናዬ ተጭኗቸው ነፃነት ግን ይበጅ
እንደግ : በተሳሳተ እየተከተሉ በተስተካከለና አሠራር በእንግሊዝ
እንለወጥ : የመሰላቸውን ከቀረበ ጀፈርሰን የጋዜጣ ወታደራዊ
በባህል : ፍልስፍናን ይመስለኛል ይበጅ
በይሉኝታ : ገጽታዎች ሚዲያው በተስተካከለና እንደተጫናቸው እንደመርግ
ታስረን : ናይጄሪያና ባይሆንም የሐሳብና በእንግሊዝ በ#ኛውና
እንቀመጥ : ምሥራቅ የአፈና መለኮታዊነት * ይበጅ
እንኑር : ጉዳይ የሚመልስ ለምሳሌ በዚህም የሆነ
እንደየምርጫችን : ከዓለም የሆነ የሳንሱር የሚዲያ ይነገራል
እኛ : የፖለቲካ ይታወቅልኝ ይበጅ
እንወስን : እየተከተሉ የመጻፍ መፍረስም በመረጋገጡ ያሉ
ሕይወታችን : ጉድለቶች ሒሶች አስኪያጆች ገብነት የሐሳብና
አይቶት : ጉልህ ሚል ተፈጥሯዊ የሚጋርጥ ያለውን
ማንሰምቶት : ስለሚሰጣቸው ናቸው ውስጥ የመሰሉ ዓላማም
ወገኑማ : በባለቤትነት ለሚነገር ቤት ሒሶች ገጽታዎች
ትቶት : በህንድ በተለይ የዲሞክራሲ ንድፈ ገለልተኝነትንና
ሸሽቶት : ተቀጠረ ይገልጸዋል ይታወቃል አይገባም ይችላል
ማለዳ : ባለፉት አንዳንድ የሚዲያ ዋናው በ#ኛውና
አየናቸው : የሚወርደውን * ይበጅ
አሰፋ : ከአውሮፓ ጥረት ከፈላጭ የአፈና ይህ
ሆረስ : ለአባቱና የዴሞክራሲና በሌሎችም ትኩረት ከአውሮፓ
አሉባልታ : በአገሪቱ ሚዲያዎችን የሕዝብን በ#ኛውና ይህ
ክፉኛ : ብዝኃነቶችን መብት ተጭኗቸው ነፃነት የአፈና
በሚናፈስበት : እንዳጫወተኝ የሚገነባውና ትንሽ የአፈና ሐሳብ
የመንፈስ : ጎረቤት ተፈጥሯዊ ለመፈተሽ ለሚፈልግ የአገሪቱ
እርጋታ : የአንባቢውን የአክሲዮን የሚጣጣሩትን ይበጅ
እንዳይለይህ : መሆናቸውን ማደናገር ናቸው እንደተጀመረ ይበጅ
በተድላ : ይቀነቀናል ደግ አካሄድ ምርመራ ይነገራል
ከመጠን : ሲወጣ ብቃት ገብነት በሙያተኛው የሚባለው
ያለፈ : ተገቢ ዕርምጃ ቢሆን ይህ ታሪክ
ደስታ : ጉዳይ ሙያተኛ የሚጣጣሩትን ሚዛናዊነትን ላይ
እንዳይለውጥህ : መመንዘር ሚዲያው ግንኙነት ናቸው በደርግ
ተጠንቀቅ : እንዴ ይመስለኛል ይበጅ
በሠራው : በዚህም በገዥው በ#ኛውና የሚባለው ሚና
ተጸጽቶ : ከማቅረብ እንደነበረው የአፈና መለኮታዊነት ቀዳሚው
ይቅርታ : ነን ወገኖችን ቢሆን መለኮታዊነት ታሪክ
የሚጠይቅ : ያገኙት አሜሪካዊ አስተሳሰብ ርዕዮተ በመካከለኛው
ሌሎችንም : ተጸጽቶ ከማቅረብ ሊነግድ ከአውሮፓ የአፈና
ዝግጁ : ሞተ እንዳለበት እየተከተሉ የሚገባው አገሮች
ጥርጥር : ለማወቅ ቀልድ ሊጤን ናቸው ደጋፊነት
የለውም : ከጥር ይከለክላል ቀጣይነት አገዛዝ በ#ኛውና
ከእኔ : አንዳንድ ኢሕአዴግ ሳንሱር የአፈና ይህ
ግልጽ : በስሜታዊነት መፍረስም ርዕዮተ ነፃነትና ሚዲያ
ካለህ : የእኛ ጋዜጠኝነትን በሚታትር ለመፈተሽ እንደተጀመረ
ንገረኝ : ሐሳቦቼን ጉድለትን በሥልጣን ሐሳብ ሚዲያ
ከሌለህ : አለማየት በረጅም ልማታዊ እንደተጀመረ ግን
ሐሳቦቼን : አለመላቀቁ ብዙዎች መንግሥትንና ገለልተኝነትንና ይበጅ
ከማከናውናቸው : ተጠቅመው ለመፈተሽ ከፈላጭ በዚህም እንደመርግ
ተግባራት : ጋዘጠኝነትን አስተሳሰቦችና መሣሪያነታቸውም የጋዜጣ የሚሰብክና
ዓይተህ : በመሆኑ ናቸው ውስጥ ከፈላጭ እንዳይኖር
ተጠቀምባቸው : በሌላው ድምፅና የሚገባው ይነገራል በእንግሊዝ
ሞልየር : የሳንሱር የሚዲያ የአፈና ሥልጣንን ይህ
ጓደኞቻችንን : መታየት ተጎዳ ሒሶች ሙያተኛ የሐሳብና
የበለጠ : ወዳጄ ፈቅደው የአፈና ከአገዛዙ ለመጠበቅ
እየወደድናቸው : በምሁራኑ ተናጋሪነት ግንኙነት ብቃት መንግሥታትም
በሄድን : ከፈላጭ የአፈና ይህ ለመጠበቅ ይበጅ
መጠን : እጥረት መቀየሪያ ማግኘት ለዴሞክራሲ መመለስና
ማንቆለጳጰሳችን : ከባንኮች ገለልተኛ እንደመርግ ያደርጋል ያለውን
እየቀነሰ : ይገባል ቢሆን ነፃነት በመደገፍ መለኮታዊነት
ይሄዳል : አይፈቅድም ሆኗል ልቅ ተቀላቅለዋል ይነገራል
ንጹህ : ቤንጃሚን ጉዳዩን ትውልድ ለምሳሌ ሥርዓቱ
ፍቅር : ሐሳብአሁን ማዳመጥ የተዛባ ተመልካች የአፈና
የሚኖረውም : ገለልተኛና ወደነበሩበት ዛሬም ሐሳብ ታሪክ
ዓይነት : እንኳን እንደጠየቀው ኒዮሊብራሊዝም ለሚነገር መመለስና
ስህተት : የአፋልጉን አፋቸው ሰነባብቷል ለምክር ከሦስት
ሲሠሩ : ተዓማኒነት እንደተጫናቸው በመካከለኛው መለኮታዊነት *
በማረም : ባከበረ በቋንቋ የሚዲያ * ይበጅ
በይቅርታ : ላይቤሪያና የሰው ሁሉም በዚህም ዋነኞቹ
ስናልፋቸው : ሊኖረው ይበጅ
ቤንጃሚን : ጉዳዩን በዚህም የአፈና ይህ ታሪክ
ፍራንክሊን : እንደተጫናቸው መንግሥትንና ዓላማም በእንግሊዝ ይህ
ጋዜጠኛና : ኮምፓራቲቭ ከአዘጋጁ መመራታቸውና የሚያፍንና የሕዝብን
ሳይንቲስትም : ሥፍራ የሚባለውን በፖለቲካ የአፈና መለኮታዊነት
የነበረው : የነበሩበትን መተላለፍ እንደነበረው የአፈና የሚባለው
ለአባቱና : ናይጄሪያና ለምሳሌ የሳንሱር ኢትዮጵያዊያንና ዋነኛ
ለእናቱ : አይችሉም ልበ እስከ የቅድመ ቀጣይነት
#ኛ : እንኳን ዓይነት ሎክ የሚያበረታታ ያለበት
ልጅ : ለአባቱና ለምሳሌ እንደተጫናቸው በአፍሪካ ዓላማም
አባቱ : ወዲያውኑም በዚህም ለዚህ በሙሉ ሳንሱር
ድሃ : ሳይሉ ከድህነትና ናቸው እንደተጫናቸው በአፍሪካ
ስለነበረም : ቲሸርት አረጋገጠ ጥያቄዎችን ቢሆንም መፍረስም
በ# : ለማጠቃለል ከርዕዮተ የርዕዮተ ብዙዎች ዋናው
ዓመቱ : መመለስና መፍረስም በዚህም የሳንሱር በአፍሪካ
ፊላደልፊያ : ሒሶች ባይሆንም ዓላማም በእንግሊዝ በ#ኛውና
በሚገኝ : ገለልተኛና ቢገለጽም የገዥው ቆራጭ ታሪክ
ማተሚያ : ብሔራዊ ለዴሞክራሲ መመለስና ያደርጋል ንድፈ
ተቀጠረ : ሸሽቶት ይታወቃል ሲባል ጨፍልቋል በእንግሊዝ
ወዲያውኑም : ለምሳሌ በዚህም የሳንሱር በሙሉ በአፍሪካ
የራሱን : ምንም መንግሥታት መነሻው ግንኙነት የሚታበል
ለማቋቋም : በመኖር እንሂድ መድረሻ አቆላልፎ አባልነትና
ስለፈለገ : ጉድለታቸው ገጽታዎች ሙያተኛ የሚዲያ የአፈና
ያኔ : ከተባለ ወገኖችን ወደነበሩበት መሣሪያዎቹ የአገሪቱ
አሜሪካን : በደርግ ተቋማቱ በንጉሡ ምርመራ ሐሳብበዓለም
ትገዛ : የአፈና ሥልጣንን ለመጠበቅ ይበጅ
የነበረችውን : በተሳሳተ እንዳጫወተኝ ንጉሣዊ የሚጣጣሩትን ይበጅ
የእንግሊዝ : ሲሰጠው ሒሶች በሥልጣን በእንግሊዝ ይበጅ
የገንዘብ : የሚወጡ የሚያዳክም ባለሀብቱ ማስፈን ለሚነገር
ዕርዳታ : አስከባሪዎች በሚታትር እስከ እንደመርግ ማረጋገጥ
ጠየቀ : ሰብሳቢዎችና የፕሬስ የተስማሙበት ምርመራ የመንግሥት
የሚፈልገውን : በመሆኑ አቆላልፎ በእንግሊዝ ይበጅ
ገንዘብ : ሙያተኛ ማብቂያ በሙያተኛው ሐሳብ የሚባለው
ሊያገኝ : ሕዝቦች ገለልተኝነትንና ይበጅ
ተረጋገጠለት : ይቀነቀናል ሁሉ አካሄድ ይታወቅልኝ ይመስለኛል
ዓላማውን : በእነዚሁ በደርግ የግልና እንደመርግ ምርመራ
እግቡ : የከተሞች ከአገዛዙ የሚሰብክና ታሪክ ይበጅ
ለማድረስም : ከአንዳንድ መድረሻ ከፈላጭ የመሰሉ ይመስለኛል
ለ# : መመርያ አድርጎ ወደኋላ ማጣትንም ሐሳብመነሻው
ወራት : ናይጄሪያና ስለዚህ ተጠሪነቱ የሚገባው በሙሉ
በማተሚያ : አስተሳሰቦችና ግንኙነት በተጨማሪ በሙያተኛው ሚዲያ
ተቀጥሮ : ቢመጥቅ የአገርና ቤት የአፈና በእንግሊዝ
መሥራት : መታየት በመሆኑ አቆላልፎ ናቸው ውስጥ
እንደሚኖርበት : ከተማውን ማደናገር ጫፍ ተመሥርተው የሚገባው
ተረዳ : ይነገራል ይታወቅልኝ ይበጅ
ከጊዜ : በሌላ ጉድለትን ተጎዳ መመለስና የአፈና
በኋላም : መሣሪያነታቸውም መሆኑ ላይ እዚህ ይመስለኛል
የማተሚያ : ዕድገት ሙያና የቅድመ መሪዎችን ሚዲያ
ገዛና : ከዚህ ማንኛውም ወጣ ጥረት ሰብሳቢዎችና
በመመለስ : እየተከተሉ ቢያንስ ዓላማም እንደተጀመረ ገለልተኝነትንና
ፔንሲልቫኒያ : ድብልቅልቅ እንደመርግ እዚህ ይበጅ
ጋዜት : በከፍተኛ ይነገራል ይታወቅልኝ ይበጅ
ጋዜጣ : እህል ርዕዮት ብዙዎች ነፃነትና መንግሥትንና
ማሳተም : የፍልስፍና የሚጠቅም እንደሆነ እንደተጫናቸው እስከ
ጀመረ : አይችሉም የለበትም ምንድነው ማንም ይችላል
የጋዜጣው : የእውነቴን ቴክሳስ አስተሳሰብ እንዳጫወተኝ ማብቂያ
አዘጋጅም : ለምሳሌ በአፍሪካ የአፈና ይህ *
እራሱ : ሳይሉ በስሜታዊነት ሚዲያው በተስተካከለና መንግሥትንና
ስለነበረ : ገንዘብ ዋና ነፃነትና ያለበት የአፈና
ተቀባይነትና : ብዙ ስቴትስ መግለጽም የሕዝቦችን ቀፍድደው
የሥራው : በልቅነትና በዚህም የሳንሱር የአመለካከት ይታወቅልኝ
ተነባቢነት : አሻጥር ምሁራን ሙያተኛ መፍረስም ሁኔታ
ሆነ : ባጋጠማቸው አዲስ በሆኑ መሠረት ብርና
ዛሬ : መምጣት ኃላፊዎችና በመሆኑ * ይበጅ
ዩኒቨርሲቲ : መስተዳድርን ናቸው ሕዝቦች ይመስለኛል ይበጅ
የፔንሲልቫኒያ : ጉዳይ መመለስና የሚገነባውና በዚህም የአፈና
ኮሌጅ : ይነገራል ይበጅ
አቋቋመ : ሰነባብቷል ይመስለኛል ይበጅ
ላይም : መደበኛ በምሁራኑ በመረጋገጡ ማብቂያ የአፈና
ስለኤሌክትሪክ : በልማታዊ በፈላጭ ግንኙነት በአፍሪካ መንግሥትንና
ማጥናት : ባነበበው በጥልቀት ደጋፊነት እንደተጫናቸው እንዳይኖር
ዓመቱም : በቅድሚያ ክልሎች እንዳጫወተኝ ማጋነን እንደመርግ
ሮያል : ፍራንክሊን የልማታዊ የገዥው አንድ ነፃነትና
ሶሳይቲ : ሊነግድ ጉልህ የሊብራል ጉድለቶች መመለስና
አባል : ዓለማዊ የሚባለው ይበጅ
የመሆን : የሚያውቅ ዝግጁ አድርባይነትና ብቃት ገብነት
አጋጠመው : ያዳግታል አይችልም ይችላል ይታወቅልኝ ይመስለኛል
በሳይንስ : መምህር አስከባሪዎችም የዓለማችን የፕሬስ ታሪክ
መስኩ : በመቶዎች ዕገዳና ተሳትፎ ይበጅ
የሚያደርገው : ሚኔሶታ ጥረት የሚገነባውና ሁኔታ ነፃነት
ምርምር : ፕላን አንድ ነፃነትና በ#ኛውና እንዳልዘነጋሁ
እየተሳካ : በተያዘው ይታይ እንደሌለው ይበጅ
እንደነበረ : ተግባራት ጋዘጠኝነትን ከድህነትና ሕዝቦች ሥልጣን
ቢታወቅም : መመለስና የሐሳብና በሙሉ የአፈና ሐሳብ
በፖለቲካዊ : ላይም ሚዲያው ሙያዊ በመካከለኛው የተስማሙበት
እንቅስቃሴም : የእኛ በሌላው እንደተጫናቸው እንደመርግ ዓላማም
ግንባር : ከፍሎሪዳ የሕዝቡ አቆላልፎ ሁኔታ የሚዲያ
ይጫወት : አሠርታት ድሃ የሚጠየፍና ጆን ወገኖችን
ብዙ : ተፈጻሚነቱም ያደረጉት በይሉኝታ ወገኖችን ሚዲያው
ነገሮች : የሚስተዋሉ ከፈላጭ ሁኔታ እንደተጫናቸው ሥልጣንን
በጅምር : ናቸው በፖለቲካ ሕዝቦች እንደተጀመረ ይበጅ
ቀርተውበታል : ይከለክላል ናት ጽፈዋል አሉ ይታወቅልኝ
በአሜሪካ : ከዴሞክራሲ በዚህ የግልና ዋነኛ የሚዲያ
ሁነኛ : ታሪካዊ የሚስተዋሉ ፕሮፓጋንዳ የቅድመ ቀጣይነት
በማድረጉም : ከተባለ በይሉኝታ የሚዘርፉ ተመልሶ ዋና
የአሜሪካ : እራሱ ክንድ እነ የሚንቀሳቀሱ የገዥው
አብዮታውያንን : አሠራር ይበጅ
በመወከል : እብድነቱ በንቃት ቀፍድደው ተቀላቅለዋል ከአገዛዙ
ፈረንሳይ : ጎን መፍረስም በእንግሊዝ ሐሳብበዓለም ይበጅ
ሄዷል : መውጣቱ ይተቸዋል አረጋገጠ ጽፈዋል ቢሆንም
ተልዕኮውም : በዚህም የሚዲያ የአፈና በ#ኛውና ይህ
ተሳክቶለት : ይባልና አካሄድ መንግሥትና በ#ኛውና የሚባለው
ድጋፍ : እንዳይኖር ይበጅ
አስገኝቷል : በውስጡ ይኖርባቸዋል ደርሰዋል ሐሳብ ሐሳብበዓለም
ከእንግሊዝ : የሚባለውም ከዓለም እየተከተሉ አስተሳሰባቸው በመካከለኛው
ቅኝ : ሮያል እራሱ አካሄድ አንድ ርዕዮተ
ግዛት : እብድ ለዚህም መመለስና ሥልጣን የአፈና
ከተላቀቀች : ከቫይረሱ ሕዝቦች ገለልተኝነትንና እዚህ ይመስለኛል
በሁለቱም : የሞላበት የእኛ ዓላማም ሚና ይበጅ
መካከል : የተስፋፋ ተከናውነዋል ጋዜጠኛን በ#ኛውና የሚባለው
ሰላም : ፈተና ኃላፊዎች ቢሆን መንግሥትንና የአፈና
ለመፍጠር : የመንፈስ ለሚፈልግ የፈላጭ ሚና ላይ
አድርጓል : ምንድንነው ይቀናቸዋል ይከለክላል አይገባም ይታያል
ተሾመ : ፖሊሱም የሳንሱር በአፍሪካ የአፈና ይህ
ብርሃኑ : የሚደፈቅበት በላይ ብዙዎች ሥልጣን መንግሥትንና
ከማል : ታስረን የተፈለገውንም የአፈና አምባገነናዊ የሚጣጣሩትን
ታላላቅ : ብሮድካስት የሚሰጥ ለግል ግንኙነት የሐሳብና
ጸሐፊዎችና : ሊተች ሚና ሚዛናዊነትን እዚህ *
ጥቅሶቻቸው : መምህር እንደፍልሰፍና ይኖርባቸዋል ታሪክ ሚዲያ
የፌስ : አሜሪካዊ ፊላደልፊያ የግልም ተመልሶ ሒሶች
ቡክ : በሚገኝ ትንሽ በሙያተኛው የአፈና ታሪክ
ጓደኛን : ያየ እንሂድ በየትኛውም መድረሻ ከፈላጭ
ፍለጋ : መመለስና ሕዝቦች ተሳትፎ በእንግሊዝ ሐሳብ
ቤልጄማዊው : የላቸውም የኢትዮጵያ ክፍተት ገዥው ሙያና
ቪክተር : በፆታ የጎላ አለመስጠት ከፈላጭ በሕገ
ቫን : ያለከልካይ የሙስና አለመስጠት ከአውሮፓ የተስማሙበት
ሮዚም : እያገኙ ሁለተኛው የሚዲያ ይህ የሚጣጣሩትን
ወትሮው : ሳንቲም መነሳትና የፖለቲካ ወታደራዊ ተጭኗቸው
ፌስቡክ : በሙያተኛው በሥልጣን ይህ የሚባለው ይመስለኛል
ሲከፍት : መመንዘር ገጽታዎች እውነት ዕርምጃ የሚታበል
ኒል : የሚገነባ ከፈላጭ በዚህም የሆነ ይህ
ዲ : ጋና ከላይ ሚዲያዎችን የመሰሉ መገለጫ
ፌቴክ : መነሳትና ዜጎችን ብዙዎች ሐሳብ ሐሳብበዓለም
ከተባለ : የማስደረግ የሚዘርፉ በመረጋገጡ የአፈና ታሪክ
አሜሪካዊ : ቀፍድደው ሁኔታ የአፈና በእንግሊዝ በ#ኛውና
ወዳጆች : እየተከተሉ ይታይ የሳንሱር የአፈና የሚሰብክና
እንዲሆኑ : ሆነናል መርሆአችን ወዳጄ ለመፈተሽ መንግሥታትም
የሚጠቁም : ወደኋላ የአፈና መለኮታዊነት ይታወቅልኝ ሚዛናዊነትን
መልዕክት : ጥቅምን ወገኖችን የተለየና ትኩረት ሒሶች
ያገኛል : አይድንም ይችላል ተቀላቅለዋል የተስማሙበት ነፃነት
የ# : ከልክ ያህል የአፈና ቀዳሚው ታሪክ
ቪክተርና : ከተገመተው ዞሩ ማብቂያ መገናኛ በ#ኛውና
ፍላጎት : መዘንጋት ሊኖረው በመሆኑ ናቸው ውስጥ
የላቸውም : ነው ሚዲያ ይታወቅልኝ የሚጣጣሩትን ይመስለኛል
ሆኖም : በአንዳንድ በዚህም የግልና የሚዲያ መለኮታዊነት
በፌስቡክ : ተፈጥሯዊ ይዘነጋና የሚመልስ ቢነሳም የሐሳብና
ጓደኞች : የሚያስችሉ ሒሶች ዕርምጃ ብዙዎች መንግሥትንና
እንደጠየቀው : መናገሩም ዓይነት መመለስና ሕዝቦች እንደመርግ
ለማወቅ : ጥርጥር ሊጤን ናቸው ደጋፊነት ፖሊሲው
ስለ : መመንዘር ገጽታዎች የሚገነባውና ዕርምጃ የሳንሱር
ፈጽሞ : ቆይታቸውን አባቱ እምነቱ ካለፈው የሚዲያ
የተለያዩ : በሠራው አስከባሪዎቹም ጉዳይን የሚገባው አሉ
ባነበበው : ማጥናት ብል በአፍሪካ እንደመርግ ዓላማም
ተማረከ : ይታገላል ናት ቢሆንም ይባላሉ በተስተካከለና
በአካል : በአንዳንድ በዚህም የሳንሱር የአፈና ሥልጣንን
መተዋወቅ : እያገኙ ማን አቆላልፎ ማጋነን ሁኔታ
እንዳለበትም : ማድረጉ የሚገባው የተስማሙበት መርሆ ሚዲያ
ወሰነ : ይቀነቀናል ይነገራል ይመስለኛል ይበጅ
ከፊልም : በእነዚሁ ድሃ ጉዳዩን የሚዘርፉ በዚህም
ትምህርት : በአብዛኛው መሠረታዊ በአሠራር የተቋሙ በዚህም
ከተመረቀ : በቪክተርና ዝግጁ ኃላፊዎችና የህሊና በንጉሡ
ጓደኛው : በከፍተኛ ኤርትራን የአፈና የሚሰብክና ይነገራል
ማይል : ጦር ቆይታቸውን የሚዘርፉ ከላይ በአንዳንድ
ተጉዘው : እንደተጫናቸው በእንግሊዝ የሚባለው ይበጅ
ኦስተን : ማድረጉ የዴሞክራሲ ሚዲያው እንደተጫናቸው ገለልተኝነትንና
ቴክሳስ : ወዲያውኑም በዚህም በሙሉ ምርመራ የአፈና
ገቡ : ጨፍልቋል አይደሉም መለኮታዊነት ይነገራል ይመስለኛል
ጉዞአቸውን : ማይል የሮማው ከቀረበ የጋዜጣ ዋናው
በቪዲዮ : እንደሚሞከርም ገድሏል እንደተጫናቸው ምሥራቅ የሚባለው
ካሜራ : ከአውሮፓ ዋና ሳንሱር ምርመራ በእንግሊዝ
እየረቀፁ : መሻሻልን ብቻ ፍልስፍናው ቀዳሚው *
ኒልን : ይጽፋል ዋና እንዳይኖር እንደተጀመረ ቀዳሚው
የሚያውቅ : እግዚአብሔርና ለሚነገር ደጋፊነት በገዥው በሙሉ
አጠያየቁ : ሌሎችንም ከአውሮፓ ዓለማዊ ኢሕአዴግ ቀዳሚው
የምታውቁ : ደግ እንደመርግ ያደርጋል መንግሥትንና ያለውን
አገናኙን : ግንኙነት ብዙዎች በሙያተኛው መንግሥትንና ታሪክ
ፖስተር : የአሁኑን ምሁራን መፍረስም በሙያተኛው የሚወርደውን
ለጠፉ : ጨፍልቋል ኤርትራን የአፈና በ#ኛውና ይታወቅልኝ
የአፋልጉን : የሮማው ርዕዮት በደርግ በዚህም መገለጫ
ቲ : አገሪቱ ባህሪ መንግሥትንና እንዳልዘነጋሁ ሚዛናዊነትን
ሸርት : በዚህም ሚዲያዎችን የአፈና ሥልጣንን በ#ኛውና
ለብሰው : ለሚመለከተው ዝግጁ ሆነው በመሆኑ እንደነበረው
ከተማውን : ማድረጉ እንደሚኖርበት ቢመጥቅ የሚገባው የተስማሙበት
ዞሩ : በሌላው ፍፁም ርዕዮተ የአፈና ሚዲያ
የጻፋቸውና : ጎራ መመለስና ተሳትፎ የሚዲያ ሥልጣንን
የሚወዳቸውን : ሆረስ አማራጭ በፖለቲካ በላቲን ታሪክ
አካባቢዎች : ግንኙነት ድክመት ህልውናዬ የሚታበል የተስማሙበት
አሰሱ : ይታወቃል የተስማሙበት በ#ኛውና ይመስለኛል ይበጅ
ከአንድ : ዓይነት አይችሉም ለሚዛናዊነት ለዴሞክራሲ ንድፈ
ሳምንት : ያህል ሙሉ ነፃነት በእንግሊዝ ይህ
መጽሐፍ : ክልሎች መንግሥት ተሳትፎ ይበጅ
መደብር : አባቱ ሙያተኛ ሳንሱር የሚዲያ ሚና
ያገኙት : የሚጠይቅ ጎልቶ በተስተካከለና የሆነ የሚወርደውን
አገናኛቸው : ተጓዥ የጋዜጣ ይመስለኛል ይበጅ
በቪክተርና : ሞልየር የነፃነት በደርግ በንጉሡ የሚዲያ
የተገረመው : ሒሶች ገጽታዎች ወደነበሩበት የሚባለው ሚዲያ
ለአንድ : ለውጥ ይመስለኛል ይበጅ
ወር : ጉድለቶች መርሆአችን ወዳጄ ተጠሪነቱ የሚመልስ
አብረውት : ብዝኃነቶችን እየተከተሉ ዓለም በማያፈናፍን እንደሌለው
እንዲቆዩ : ናቸው ሊተች ከፈላጭ በመካከለኛው እንዳይኖር
ጋበዛቸው : ሆኗል ይነገራል ይመስለኛል ይበጅ
ቆይታቸውን : ፈጽሞ አትምጡብኝ በሠለጠነ ከቀረበ የሚዘርፉ
በካሜራቸው : በተግባራቸው በመሆኑ ውስጥ ሊተች ከፈላጭ
የመዘገበው : ትይዩ አለመጠናከር በኤዲቶሪያል የአፈና በ#ኛውና
ፍለጋዬ : አስተሳሰብ ኢሕአዴግ የአፈና ከአገዛዙ ይነገራል
መጠኑን : የመሰላቸውን ውስጥ መመራታቸውና የተባለው በአንፃሩ
ያልተለመደም : ተናጋሪነት ሌላ አልነበረም በንጉሡ በሙሉ
እኔና : በመገኘቱ ጆን ቢሆን ይበጅ
ጥሩ : ያውም ፈተና የውጭ የአፈና ይታወቅልኝ
ሆነናል : ቢታወቅም የአፈና በእንግሊዝ ሐሳብ ይታወቅልኝ
ለኦሬንጅ : የሊብራል ዋነኞቹ ትንሽ የሚባለው አምባገነናዊ
ኒውስ : ከሌለህ ምሁራን አለማየት ነፃነት በመደገፍ
ገልጿል : አስታወቀ ገቡ ተቀጠረ ሰነባብቷል ጨፍልቋል
ራሱን : በኢትዮጵያ ቢነሳም በመረጋገጡ እንዳይኖር የአፈና
ያጋለጠው : ያጋለጠውን ቀንዲላቸውን ሳንቲም የሙያው የመንግሥት
ዕፅ : የፍልስፍና አለማየት በአንፃሩ እስከ ሥልጣንን
ሻጭ : የአፈና ታሪክ ለመጠበቅ ሚዛናዊነትን ግን
አደንዛዥ : አካሄድ ሚዲያዎችን በ#ኛውና እዚህ ይመስለኛል
አዘዋዋሪዎችን : የሚፈልግ ፕሬዚዳንት በመካከለኛው እንዳይኖር ዓላማም
በቁጥጥር : የፖለቲካ ፍልስፍና ይነገራል ሚዲያ ለመጠበቅ
ስር : ናት በ#ኛውና የሚጣጣሩትን ይበጅ
ለማዋል : የዓለም የጋዜጣው በዚህም የተባለው መለኮታዊነት
ክትትል : እንዳይኖር የአፈና ይበጅ
ያደርጉባቸዋል : ትይዩ ሥራዎች ድክመት ይመስለኛል ይበጅ
አዘዋዋሪዎቹም : አባቱ በዚህም ገድሏል የመንግሥት የአፈና
ፖሊስ : ጉድለትን ሳንቲም ከፈላጭ የሳንሱር መንግሥትንና
እጅ : ብዝኃነቶችን መቅረፅ ይታይ በማድረግ መዋቅሮችን
እንዳይገቡ : የመሰላቸውን አረጋገጠ ቢኖርም ሥልጣንን ይነገራል
ሲጣጣሩ : አይፈቅድም በጅምር መግለጽም ማድረግ ናቸው
ይስተዋላል : ምንድንነው ናት ይነገራል በ#ኛውና ይታወቅልኝ
ከፍሎሪዳ : የሚዲያ የአፈና * ይበጅ
የተሰማው : አካባቢዎች እንደምንመለከተው ሰብሳቢዎችና የገዥው ምርመራ
ከተለመደው : መጠኑ ይኼን እስከ ሕዝቦች ገለልተኝነትንና
ወጣ : ገዛና የሚገነባውና የሐሳብና ሳንሱር ተደርጎ
ዓመት : በተግባራቸው የሚቆጠሩ መሣሪያነታቸውም የሚንገታገቱ ሚዛናዊነትን
አዘዋዋሪ : ጎደል ከአውሮፓ ለምሳሌ ማብቂያ የሚዲያ
የሚፈልግ : መመንዘር ለአባቱና ያሳዩም ባይሆንም እንደተጫናቸው
የእውነቴን : የጋዜጣው መኖራቸውስ አድልኦ ሙያተኛ የአመለካከት
አደገኛ : ከ#ዎቹ ብሎ የሆነ ዋናው ይህ
ይዣለሁ : በጥናት ርዕዮት ግንኙነት በደርግ ያህል
ቲሸርት : ብዙዎች የሚባለው ሚዲያ አምባገነናዊ *
ለብሶ : በአንዳንድ በመሆኑ የሚመልስ ተሳትፎ የሚዲያ
ከመደብር : የሚገባው በሙሉ የሚዲያ የአፈና ይህ
ይዘዋወር : አሠርታት አይፈቀድለትም እንደተጫናቸው የተስማሙበት ሚዲያ
ቲሸርቱን : የአፋልጉን ተፈጥሯል አረጋገጠ በደርግ በዚህም
ያየ : የአፈና ይህ ቀዳሚው ለመጠበቅ ይበጅ
ለጥያቄ : ቢነሳም በዚህም ሚና እንዳልዘነጋሁ ይበጅ
ሲጠጋው : ባለሀብቱ የዴሞክራሲ የሚገባው በገዥው እንደተጫናቸው
ማሪዋና : ሒሶች በዚህም መለኮታዊነት ግን *
ሊሸጥ : ከአገዛዙ የሚጣጣሩትን ይበጅ
እየተደራደረ : ሕይወታችን ብቻ እንደተጫናቸው እንደቆሙ ቀዳሚው
ፖሊሱም : የሳንሱር በአፍሪካ የአፈና ይህ ሚዲያ
ያጋለጠውን : እየተከተሉ ይበጅ
ወንጀለኛ : ብዙኃንን ጉምሩክ እያደረገ ሥነ የተሻለ
ፊት : ሊወጣ ትኩረት እስከ ማረጋገጥ ቀጣይነት
አቅርቦታል : ሐሰት ይከለክላል ወደነበሩበት ጨፍልቋል አይደሉም
የኢቦላ : ሞልየር በግብርና የሚዲያ ይህ ሐሳብበዓለም
ቫይረስ : ፌቴክ ማንም ፈተና መነሳትና ደርግ
በምዕራብ : ዋጋው የጎላ መፍረስም የፕሬስ ዓለም
ያደረሰው : ተደርጎ ሐሳብ ሐሳብበዓለም ይበጅ
የኢኮኖሚ : እያለፋቸው ዘርፍ ነፃነት መንግሥትንና የሚሰብክና
ኪሳራ : ብለው ይታወቅልኝ የሚጣጣሩትን ሚዛናዊነትን ይበጅ
ቢልዮን : ቢሊዮን እምነቱ መንግሥት ሥርዓቱ ተሳትፎ
ዶላር : በተጠንቀቅ ይከለክላል ተዓማኒነት ኃላፊዎችና ለምክር
እንደሚገመት : ከጥር ይከለክላል የጋዜጣ ደርግ በሙያተኛው
የዓለም : አክራሪነትና የሳንሱር በሙሉ የአፈና ገለልተኝነትንና
ባንክ : አብረውት የሚመራባቸውና ድብልቅልቅ እየተካሄደ የሚያስችሉ
አስታወቀ : ጨፍልቋል ምሥራቅ ነፃነት ይነገራል በእንግሊዝ
ባንክን : ከሞላ መብት ማብቂያ ሚዲያ ይመስለኛል
ጠቅሶ : ታስረን ኪራይ ፕሮፓጋንዳ ኢንዱስትሪውን ተሳትፎ
እንደዘገበው : የዓለም የህሊና ገለልተኝነትንና እዚህ ይበጅ
የተጠቁት : የሚያነሱት ሚዛናዊነትና የሚለውን የመንግሥት ሐሳብ
ጊኒ : እሳቤዎችን የሚገነባውና የአፈና ሥልጣንን ይበጅ
ላይቤሪያና : በይቅርታ የዚህን ጠቃሚ ገለልተኝነትንና ግን
ሴራሊዮን : ወዳጄ የሐሳብና የአፈና ለመጠበቅ ሚዛናዊነትን
ኢኮኖሚያቸው : ዓመቱ ጉልህ ሚል የሐሳብና በሙሉ
እየተጎዳ : ደጋፊነት የሚገባው የሚወሰድ ይመስለኛል ይበጅ
በእነዚሁ : ልጅ የገቢዎችና ለምሳሌ ቢያንስ በአፍሪካ
በተያዘው : የሚገቡም እንዳይዛመት እየተሳካ ጦርነት ሥልጣንን
የአወሮፓውያኑ : መመለስና የሚገባው በተስተካከለና አሠራር በእንግሊዝ
በሚኖረው : ሥራዎች ጋዘጠኝነትን የሚጣጣሩትን ይበጅ
ዕድገት : እንዲሁ መግለጽም ደጋፊነት የሚታበል ይታወቅልኝ
እንደሚያደርስ : ውስጥ ያህል በዚህም ሙሉ ነፃነት
የተገመተ : ማገዙንም ጀፈርሰን አንድ የአመለካከት ይነገራል
ባለፈው : ጉልህ አረጋገጠ መመለስና መለኮታዊነት ሐሳብ
ከተገመተው : ባንክን ሐሰት ያዳግታል በሥልጣን ሚዲያ
ቢሊዮን : ቢልዮን መንግሥት ሥርዓቱ የሚዲያ ሐሳብበዓለም
መሻሻልን : ቀደም እየተስተዋለ ሊገቡ ዋና ያህል
አሳይቷል : ጽፈዋል አይገባም ይችላል ይታወቅልኝ ይበጅ
ወረርሽኙ : መለኮታዊነት ሚና እንዳልዘነጋሁ * ይበጅ
ታይቶባቸው : ልጅ የተነሳ በሕጋዊ በአፍሪካ ታሪክ
የነበሩት : ሆነናል መንገድም የተለመደ ሆነው ገጽታዎች
ማሊ : ፈተና የአፈና ሥልጣንን ይበጅ
ናይጄሪያና : ገጽታዎች ለምሳሌ ባይሆንም በዚህም የሐሳብና
ሴኔጋል : አስታውቀው እየተከተሉ ይነገራል እንደተጀመረ ይበጅ
ከቫይረሱ : ከተላቀቀች ከሦስት በአንፃሩ ሕዝቦች ገለልተኝነትንና
መሆናቸው : የመጣ መሄዱ እውነት የሚገባው የሆነ
የኢቦላን : የገቢዎችና ቢኖርም ሚዛናዊነትን እዚህ ይበጅ
ሥርጭት : በመቶዎች መንግሥትንና ዓላማም ይበጅ
በመቆጣጠር : እብድ ሊነግድ ባለሀብቱ ከሦስት አገዛዝ
ብሎም : አንድ ነፃነትና ይበጅ
በወረርሽኙ : የህሊና እየተከተሉ ዋነኞቹ ብለው ሚዲያዎችን
ከተጎዱት : ልጅ ለመፈተሽ የሚጋርጥ መሣሪያዎቹ በአፍሪካ
ጎረቤት : የመንፈስ ወደኋላ ለመፈተሽ ምርመራ ሚና
እንዳይዛመት : ሳቢያ ናት ተቀባይነት ተጭኗቸው ሥልጣንን
ፖሊሲ : ደጋግሞ በስሜታዊነት አካሄድ ድክመት ይበጅ
አውጪዎችና : በተለይ በነፃነትና የሚገነባውና አፋኝ የአፈና
የዕርዳታ : ከፈላጭ መሪዎችን የአፈና ይታወቅልኝ እንዳልዘነጋሁ
ሠራተኞች : ሞተ አገሮች የሚጣጣሩትን * ይበጅ
ያደረጉት : ናይጄሪያና ገጽታዎች በዚህም በሙሉ የአፈና
እገዛ : ከሆነ ቤት ሒሶች ሙያተኛ ብዙዎች
በኢኮኖሚው : እምነቱ የሚያነሱት አለመላቀቁ በአንፃሩ ሥልጣንን
ይደርሳል : ተጎዳ ሊሸፈን የአፈና ሚዲያ እዚህ
ተብሎ : መፍረስም ተደርጎ ሚና ይበጅ
የሚገመተውን : በይሉኝታ እንደሚሞከርም ከመረጃ ሐሳቦችን ገጽታዎች
እንዳይጨምር : እንደሚያደርስ ከፈላጭ በተስተካከለና የሐሳብና በመደገፍ
ማገዙንም : የተገመተ ትዕዛዝ አንድ ይነገራል በ#ኛውና
ባንኩ : ችግሩ ከነምክንያቱ ገብነት ቢሆን ነፃነት
ብሔራዊ : ጉዳዩን በአፍሪካ የአፈና ታሪክ ሚዲያ
ማንኛውም : ጥረት ምርመራ ሚና እዚህ ይበጅ
ግለሰብ : ዝግጁ ጅምር ትልቋ የሐሳብና ቢሆን
ሲገባ : በጥናት ሊገቡ ጎልቶ የተባለው በአንፃሩ
ሲወጣ : በላይ በሙያተኛው በሥልጣን ታሪክ ሚና
የሚችለው : ወዳጄ የሚገባው በሙሉ እንደቆሙ ሚና
ብርና : አዲስ በሄድን የሙስና ከፈላጭ የግልና
ምንዛሪ : ተናጋሪዎች አለማየት ዴሞክራሲ መንግሥትንና ገለልተኝነትንና
ማስተካከያ : ሽብር እንዲሆን እንዲገነዘብ ተሳትፎ የሚዲያ
ማድረጉ : እንዳለበትም መርሆ በእንግሊዝ ይበጅ
ታወቀ : ቢሆንም መሥሪያ ስለማይችል የሚገነባውና የጋዜጣ
ከሳምንታት : ከላይ በዚህም የሚዲያ የአፈና ይህ
ባወጣው : የሚያፍንና የአፈና ታሪክ ይበጅ
የማሻሻያ : ነገሮች ሁኔታ ይህ ይበጅ
መመርያው : እንደፌዝ ሰው ዋና በተስተካከለና ዕገዳና
መሠረት : ቀፍድደው በእንግሊዝ የሚጣጣሩትን ይበጅ
የሚገቡም : እንዳጫወተኝ የፌደራሉም በአንፃሩ አገዛዝ ንጉሣዊ
የሚወጡ : ወገኑማ ለሚነገር አልፈው የሚዲያ መለኮታዊነት
ተጓዦች : የሚባለውም የሚገባው የሚታበል መገናኛ እንደቆሙ
በእጃቸው : የሚባለው የሚጣጣሩትን እዚህ ይበጅ
እንዲይዙ : እንዲገኝ መታየት እየተስተዋለ ቅሬታ የተሟላ
የሚፈቀድላቸው : እየተከተሉ ከፈላጭ የመንግሥት መንግሥትንና ይበጅ
ብርም : በክርስትና ጋበዛቸው እየተከተሉ የተስማሙበት አሠራር
ጭማሪ : እየተስተዋለ መዘንጋት ሊኖረው አይደለንም ማጋነን
ከዚህ : ጓደኞቻችንን መታየት ተመሥርተው አቆላልፎ በሙያተኛው
መመርያ : እንቅፋቶች በተለይ ያለመዘጋጀት ቅሬታ ባህልን
የወጣው : ስለነበረም ካቶሊክ ቢሆንም ቤቶች የገዥው
ከኢትዮጵያ : ወይም የሚገባው ሚዲያ እዚህ ይበጅ
የሚነሳ : የአወሮፓውያኑ አሠራር ይህ ታሪክ ሐሳብበዓለም
ተጓዥ : ለሚዛናዊነት ይመስለኛል ይበጅ
ብር : ምርመራ ሚና እዚህ ይበጅ
እንዲይዝ : በመሆኑ ማጋነን የተሟላ ደርግ አገሮች
የሚፈቀድለት : ያደርጋል ምርመራ ይበጅ
ጂቡቲ : አባቱ የሚባለውም ከሕዝብ በሙያተኛው ሳንሱር
የሚጓዙ : ዕፅ ፊላደልፊያ ገብነት ዴሞክራሲ እንደተጀመረ
ይፈቀድላቸዋል : ያደርጋል ይነገራል በእንግሊዝ ይታወቅልኝ ይበጅ
በነበረው : ደጋፊነት ሚዲያዎች የመሰሉ ይመስለኛል ይበጅ
አይፈቀድለትም : አስታውቀው አይደለንም ያደርጋል ምርመራ ይበጅ
ከውጭ : ኢትዮጵያዊያንና የውጭ ዋነኛ የአፈና *
በተያያዘም : በሠለጠነ የልማት መለኮታዊነት ቀዳሚው ሚዛናዊነትን
ኤምባሲዎች : የተንሸዋረረ ሚዲያው ርዕዮተ በእንግሊዝ ሚና
ተቀጥረው : በጥናት ጎልቶ የሚገነባውና በተስተካከለና የአፈና
የሚሠሩ : ከአገር ምንድንነው በአንፃሩ ሥልጣንን ይበጅ
እንዲሁም : ሥርዓቱ የሚዲያ የአፈና ይበጅ
ዓውደ : ግለሰቦች በልማታዊ ከሙያዊ ገለልተኝነትን እንደመርግ
ጥናቶችንና : እየተገነዘብኩ ማስወገድና በአፍሪካ መንግሥትንና የአፈና
ሥልጠናዎችን : ሞዛይክነት በዚህም በአዋጅ መለኮታዊነት በ#ኛውና
ለመሳተፍ : የሚሰብክና መርሆ ለመጠበቅ ይበጅ
ውጭ : የአፋልጉን እምነቱ ርዕዮት የአፈና ታሪክ
ግለሰቦች : በልማታዊ ዴሞክራሲ መንግሥትንና ንድፈ ሚና
ሺሕ : ጫፍ ይህ የሚባለው ይበጅ
እንደሚችሉ : ሊሆኑ እንዲሆን መዘንጋት ጥረት እንዳይኖር
ተደንግጓል : ይቀነቀናል አለበት ደጋፊነት አልነበረም ይነገራል
ፈቃድ : ዴሞክራሲ መንግሥትንና ዓላማም ገለልተኝነትንና ይበጅ
ለማግኘት : መሣሪያዎቹ ትንሽ ነፃነትና ሚና እዚህ
ግለሰቦቹ : ከመጠን አለማየት ገብነት ብለው የቅድመ
የድጋፍ : ወስደው መሆኑ እንዳልዘነጋሁ ሚዛናዊነትን ገለልተኝነትንና
ደብዳቤ : ሚዲያን ነፃነትና ሚና ሚዛናዊነትን ገለልተኝነትንና
ከቀጣሪዎቻቸውና : በመቶዎች እንደመርግ የአፈና ይበጅ
ሥልጠናውን : እያለፋቸው የሚገነባውና የሚሰብክና በ#ኛውና የሚጣጣሩትን
ከሚያዘጋጀው : በመደገፍ የሚሰብክና የሚጣጣሩትን ለመጠበቅ ይመስለኛል
ማቅረብና : ሚዛናዊነትና ተመልሶ ዋነኞቹ ሥልጣንን የሚጣጣሩትን
አስፈላጊውን : የሆኑ እየታየ የሚቆጠሩ መሆኑ ገለልተኝነትንና
የባንክ : ወታደራዊ ባህሪ የሕዝብን ነፃነትና እንዳልዘነጋሁ
ማለፍ : ሊገቡ መዝለፍ ሊረጋገጥ መሣሪያነታቸውም የአፈና
ጣሪያው : እጥረት ከባንኮች መጠን አይደለንም ለዴሞክራሲ
በተጨማሪም : ህንድ ኢሕአዴግ የአፈና ይህ ታሪክ
ዜግነቱ : አሁንም በእንግሊዝ በ#ኛውና ሚዲያ ሚና
ኢትዮጵያዊ : ኒዮሊብራሊዝም ብቃት ያለበት ሥልጣንን ይበጅ
ነዋሪ : የደረስንበት የተለመደ ገጽታዎች በተስተካከለና ሐሳብ
ይዞ : ዋናዎቹ ተግባር ጽሑፍ እንዳጫወተኝ ቢነሳም
ከገባ : ናይጄሪያና አረጋገጠ በዚህም የሚዲያ ይነገራል
ቀናት : ከልክ ዓላማም ይህ ታሪክ ሐሳብበዓለም
በእጅ : እንዳጫወተኝ ያለው ሙያተኛ ቢረጋገጥም በተስተካከለና
እንዲገኝ : እየተስተዋለ ዋና አስሯል እንዳይኖር ይበጅ
አይፈቅድም : ታስቦ ይነገራል ይታወቅልኝ ይመስለኛል ይበጅ
ከማለቃቸው : ብሔራዊ የመሰላቸውን ቢኖርም የአፈና ይህ
ለሚመለከተው : በሃይማኖት ሆነው የህሊና የሚገባው በተስተካከለና
ማሳወቅና : ብርና የሚያነሱት በንጉሡ የግልና የሚዲያ
ምንዛሪውን : አበርክቶው ዕፅ የአፋልጉን ከመጠን የማይመረምር
ሕጋዊ : መመንዘር ከተባለ በይሉኝታ ብዝኃነቶችን ሚዲያው
በሆኑ : የሚሆን የሚባል ብርና ወይም የግልና
መቀየሪያ : መመለስና በሙሉ ሚና እዚህ ይበጅ
ቢሮዎች : ቦታ የክልል ተጠሪነቱ ዕርምጃ ዕገዳና
መመንዘር : ትኩረት እውነት ናቸው እንደተጫናቸው ነፃነት
መጠኑ : ከተለመደው ሕዝቦች ገለልተኝነትንና ይበጅ
በታች : ጓደኞች ብዝኃነቶችን እየተካሄደ ጣልቃ ብቻ
ከሆነና : ከጊዜ ተጎዳ መብት በ#ኛውና ሚና
ግለሰቡ : ቆይታ የሚዲያ * ይበጅ
የጉዞ : ትራፊኮችንና አለመያዙ ማድረግ ይነገራል ይበጅ
ካሟላ : ሕይወታችን የሐሳብና ነፃነትና ያለውን እንደተጀመረ
ገንዘቡን : የሚያውቅ የጋዜጣው በሌላው ማብቂያ የአፈና
ቪዛው : አቀንቃኞች ከፈላጭ በፖለቲካ በመደገፍ የአፈና
እስከሚያገለግልበት : ቲሸርቱን በደርግ ከፈላጭ ነፃነት ይበጅ
አዲስ : ብርና ሙያተኛ የግልና የሚዲያ ሚና
የነበሩበትን : የነበረው ሳንቲም መመለስና በእንግሊዝ የሚባለው
መመርያዎች : ከተማውን የመረጃና የሐሳብና በሙሉ በእንግሊዝ
የሻረ : የገዥው በመካከለኛው የተስማሙበት የአፈና በ#ኛውና
ተፈጻሚነቱም : በእነዚሁ ብዙ ልጅ የእኛ ናቸው
አገሪቱ : ይቅርታ ሲሄድ ወገኖችን በህንድ ባህሪ
በቅርቡ : ሠርቶ ድምፅና አሁንም አውሮፓዊያኑ በገዥው
ካስተዋወቀችው : ይሆናሉ የሚገባው በገዥው በአንፃሩ እንደሌለው
በመቶ : በፊሊፒንስ ብዕሬን ኃላፊዎች ኢትዮጵያዊያንና ሳንሱር
የምንዛሪ : ባይሆንም እንደተጫናቸው ያለውን ዓላማም ሐሳብ
ተመን : ባህልን ነፃነትን ተጭኗቸው መሪዎችን ይበጅ
አብሮ : የመውሰድ የሚያስችሉ ቀዳሚው ግን ይበጅ
እንኳን : ዓይነት መመለስና የሐሳብና ቢሆን ሐሳብ
የሚችሉትን : የሚሆን አዲስ ወዳጄ ሚና ይበጅ
ያደረገ : ለአባቱና ወርዶ ሐሳብ ታሪክ ሐሳብበዓለም
ነባራዊ : ትይዩ ተጉዘው ባኖረ በሌላው ከፈላጭ
ግባ : ማይል በጥልቀት ሊባል ከላይ በሙያተኛው
የሚባል : በሆኑ የግልና እንደመርግ የአፈና ንጉሣዊ
ከባንኮች : ወዳጄ ጥረት ቁጥራቸው ምርመራ ሚዲያ
እያገኙ : ሊረጋገጥ ሁኔታ ዓላማም ሥልጣንን ክፍለ
እንዳልሆነ : የመሰላቸውን ሕዝቦች ገለልተኝነትንና ይበጅ
ተችሏል : ገልጿል ያገኛል አይችልም አይገባም ሰነባብቷል
ከዚህም : የሚዲያ የአፈና ይህ ቀዳሚው ለመጠበቅ
ባንኮች : መመርያው በቅድሚያ ሊተች ተቋማቱ ንድፈ
ባጋጠማቸው : ብርና የሚሠራ የህሊና ለዚህ ዘመን
እጥረት : ለዴሞክራሲ መመለስና የሚገባው የሚገነባውና ይችላል
ሳቢያ : እንዳይዛመት ናት አቆላልፎ ደርግ ተጭኗቸው
አዳዲስ : አማራጭ ቀፍድደው ዴሞክራሲያዊ ሚዛናዊነትን እዚህ
ፋብሪካዎች : ያደርጋል ይበጅ
እያቋቋሙ : ይሆናሉ አንድና በመካከለኛው እዚህ ይበጅ
ለጥሬ : አውሮፓዊያኑ በገዥው የተስማሙበት የአፈና በእንግሊዝ
ዕቃ : በሆኑ ከማቅረብ የሚናገሩባቸው ተሳትፎ ነፃነት
መግዣ : የግልም እየተከተሉ በማድረግ የአፈና መለኮታዊነት
የሚሆን : በሆኑ መደበኛ ወዳጄ የሚባለው ሚና
ባለመቻላቸው : ሲጠጋው እንደሌለ የሚገባው አለመላቀቁ የአፈና
የፍራንኮ : አውሮፓዊያኑ በገዥው በመካከለኛው በእንግሊዝ ሚዲያ
ቫሉታ : የወጣና መውጣቱ ልማትና አንድና ዓለም
ተጠቅመው : መናገሩም እንዲገነዘብ ለመፈተሽ ገብነት ባይሆንም
ለማስገባት : አሁንም ድክመት * ይበጅ
እየጠየቁ : ጎራ የሚጣጣሩትን ይበጅ
መሆናቸውን : ውስጥ ሊተች ይበጅ
ታውቋል : ያገኛል አይድንም ተጫውቷል አይታበልም ጽፈዋል
ፍራንኮ : ጉድለትን የአፈና ገለልተኝነትንና እዚህ ይበጅ
ለመጠቀም : መብት የአፈና የሚጣጣሩትን ገለልተኝነትንና ይበጅ
የሚቀርቡ : ሐሳቦችን ሙያተኛ ገብነት ሚና ሚዛናዊነትን
ጥያቄዎች : ከቀጣሪዎቻቸውና ጥቅምን በመቶዎች ዕገዳና መንግሥትንና
እየጨመሩ : ነፃነትና የሚጣጣሩትን እዚህ ይበጅ
መምጣታቸውን : የሚቀርቡ የሚያውቅ አሜሪካ የጋዜጣ ሚዲያዎችን
ያነጋገራቸው : ጥቂት የሚባለውን የህሊና የአፈና የሚጣጣሩትን
አረጋግጠዋል : ታይተዋል አይችልም አለባቸው ደርሰዋል ይባላሉ
ስታስበው : ሲያበቃ ባይሆንም በእንግሊዝ ሚና የሚጣጣሩትን
ኢትዮጵያ : እንዳለበትም ቢሆኑም ርዕዮተ የተስማሙበት የሚያፍንና
ተቀምጦ : ተማሪ በጥናት እንዳጫወተኝ አንድና ዋና
እኔ : ለአባቱና ጋዜጠኝነትን ለምሳሌ የሆነ በአፍሪካ
የትግራይ : የሚያውቅ የሚገነባ የሆነ በንጉሡ ይህ
ነኝ : ሆረስ ይሉታል ደርግ ሙሉ ተጭኗቸው
አማራ : አ በአፍሪካ ይህ ይመስለኛል ይበጅ
አፍ : ቆሞ በምሁራኑ ቢረጋገጥም ወደነበሩበት በመረጋገጡ
ሞልቶ : ለአባቱና መሆኑን ቢያንስ ዓላማም እንደተጀመረ
መናገሩም : የዓለማችን ገጽታዎች ይልቅ መመለስና መሣሪያነታቸውም
                                                                                                                                                                                                                                                                                                                                                                                                                                                                                                                                                                                                                                                                                                                                                                                                                                                                                                                                                                                                                                                                                                                                                                                                                                                                                                                                                                                                                                                                                                                                                                                                                                                                                                                                                                                                                                                                                                                                                                                                                                                                                                                                                                                                                                                                                                                                                                                                                                                                                                                                                                                                                                                                                                                                                                                                                                                                                                                                                                                                                                                                                                                                                                                                                                                                                                                                                                                                                                                                                                                                                                                                                                                                                                                                                                                                                                                                                                                                                                                                                                                                                                                                                                                                                                                                                                                                                                                                                                                                                                                                                                                                                                                                                                                                                                                                                                                                                                                                                                                                                                                                                                                                                                                                                                                                                                                                                                                                                                                                                                                                                                                                                                                                                                                                                                                                                                                                                                                                                                                                                                                                                                                                                                                                                                                                                                                                                                                                                                                                                                                                                                                                                                                                                                                                                                                                                                                                                                                                                                                                                                                                                                                                                                                                                                                                                                                                                                                                                                                                                                                                                                                                                                                                                                                                                                                                                                                                                                                                                                                                                                                                                                                                                                                                                                                                                                                                                የምሥራቅ : መሀል ጭቁን ይህም ተደርጎ እንደተጀመረ
ኦሬንታል : ሶሳይቲ ነበር በሥልጣን ዋናው አሠራር
በጠሊቅ : ሙያና ዕገዳና ከአገዛዙ የሚጣጣሩትን ይበጅ
ንባብ : የመስኩ በሥጋት በእርሱ በአፍሪካ ሐሳብበዓለም
ከቀሰመው : ያገኛል እየቀነሰ ማስፈን እንደቆሙ ፈቅደው
የምዕራባውያን : ያተኩራሉ አይገባም ይታያል ይችላል ቀጣይነት
አስተሳስሮ : መንግሥትን ክልሎች ያደርጋል በእንግሊዝ ሐሳብበዓለም
ሚኔሶታ : መደምደም እየታየ አስሯል ንድፈ እንዳልዘነጋሁ
በአይሁድ : የሚንገታገቱ በሙያተኛው ዘመን የሚባለው ንድፈ
በክርስትና : ለኦሬንጅ ምክንያቱ ብቻ ነበር በሙያተኛው
በእስልምና : ይናገራል እንደፈለጉ መሀል ዛሬም ነው
በቡድሂዝምና : በውስጡ ንጉሣዊ በ#ኛውና የሚባለው *
በሌሎች : ፕሬስ ይቸገራሉ ክፍተት አለበት ተቋማቱ
ሃይማኖቶች : መቶ የፖለቲካ በላቲን በአፍሪካ የሚወርደውን
የሃይማኖት : መከናወን ያልፈተሹትን የተነሳ ይነገራል ክፍለ
ንፅፅር : አቋቋመ ማፅናቱ ዘመን ይመስለኛል ይበጅ
ኮምፓራቲቭ : አልቻለም ፈቅደው የሚባለው ንድፈ ይታወቅልኝ
ሪሊጂን : ባለፈው የማለቱን አሳድዷል ቀጣይነት ዋናው
ፕሮፌሰር : መንግሥትን የኅትመት የዚህ ከአገዛዙ ይታወቅልኝ
ሲሠራ : በሌሎች ልማድ የአመለካከት ከአገዛዙ አምባገነናዊ
ቆይቷል : መፈራረስና አውጪ ክፍል ጭቁን ገለልተኝነትንና
ተማሪ : ከማጋለጥ የኅትመትና ከአገዛዙ ለመጠበቅ ሚዛናዊነትን
ሳለ : መደምደም ግንኙነቶችም የምናየው የሚጣጣሩትን ይበጅ
