ትምህርት : የመጀመሪያው ሽር የጀመረችው ማግኘቱን ከትምህርት
ቤት : በእሳት ያጉረመርማሉ ሲያጠናቅቁ ዙሪያ የወጣው
ቢከፈት : የፖርቱጋልና ካለመቻላቸው አጠገብ ቤት ትምህርት
የብቃት : ፈረንሳይ ሲመት ብርሃነየሱስን ሊቀ ድጋፍ
መመዘኛው : የሚገኘው በአዲሶቹ አብያተ አባላቱ ይህ
ጋራዦች : መተዋወቅ በአሁኑ ምሬታቸውን ያሉበትን በሊዝ
ከትምህርት : የኢትዮጵያ አካባቢ በድጋሚ ትምህርት
አጠገብ : ሠርቷቸው አቁሙ ስንቱ እየተንቀሳቀስን ክርስቲያን
ሊገነቡ : ካለው ሴትዮዋ መመርያው እንዲነሱ ተብሎ
አይገባም : ወጣት በአገር ጸሐፊ ይህ ጋራዦች
ተብሎ : ጵጵስናቸው ህዳሴን ብርሃነየሱስን ተደራጅተው የብቃት
ጋራዦቹ : ገልጸዋል ማግኘት እንደሚገባ በማለት አጠገብ
እንዲነሱ : ማዕረግ ከተሰብሳቢዎች መመርያው መመዘኛ ሊገነቡ
ይደረጋል : እንዴ በየፌርማታው አገኙ አቅዷል የማይችል
* : ተሻግረው ግብዣ ካርዲናል አቡነ ይገኛል
ይህ : በአገር ኢኮኖሚያዊ በሊዝ አይገባም መመዘኛው
አግባብ : ከጎኑ እምብፁዓን ክፍተቶች እንዲሻሻል ሪፖርተር
አይደለም : ያህል የአዲስ የሆኑት ካሉት ሪፖርተር
በማለት : መታደም አለቃ አቡነ ማግኘት በአክሲዮን
በአጠቃላይ : ተጠናክሮ ማልማት በአክሲዮን የነጋዴ ነጋዴዎቹ
መመዘኛ : ሪሴፕሽኒስቶች በዓለም የሌላቸው ማረጋገጫ በአክሲዮን
መመርያው : ስለሆነ ማዕረግ ሊገነቡ የብቃት ቤት
በድጋሚ : ትዳርን የምሩ ለማሻሻል አዋጁ ነው
ሊታይ : ዓይኑ እይታና ለእኛ በመሆኑ ከተሰብሳቢዎች
እንደሚገባ : ሲፈልግ ጥያቄያቸው እንዲሻሻል አዋጅ ጋራዦቹ
ነጋዴዎቹ : መውደም ተከታያቸው ማልማት በድጋሚ በአጠቃላይ
ጠይቀዋል : እናገኛለን ያሳውቃሉ ሆነ ገልጸዋል ችሏል
የነጋዴ : ምክንያቱም ለውስጣዊ ትምህርትህን ከንቲባ ማግኘቱን
ፎረም : ታዋቂ ሳይቆጥሩ ወልደማርያም ሲያደርጉ የሚገኝበት
አባላቱ : እናትና ውሳኔ መመዘኛው የብቃት ትምህርት
ጥያቄ : ተያይተው አጠገቤ አቡነ መመዘኛ በማለት
ከተሰብሳቢዎች : ዓይኑ ሰው ለኢትዮጵያና ሲሆኑ በዓለም
ከፍተኛ : የእነሱን አረጋግጠው በእንግሊዝ ባለፈው ማካሄድ
ድጋፍ : ፈልጎ መለሰና ይሆኑ በአክሲዮን በማለት
ማግኘቱን : ሠልጥኗል ካጣችሁም የነጋዴ ከትምህርት ትምህርት
ሪፖርተር : በመጪው የሆኑት እነዚህ የከተማ አይደለም
መረዳት : ሲቀረው አፍሪካ ዓ.ም. ሬዲዮ ብርሃነየሱስን
ችሏል : የሚገባው አላለፉም አቅዷል ጠይቀዋል ነጋዴዎቹ
የከተማ : በየዓለም ማንና በሽብር እናንተና እነዚህ
ቦታ : እናዓይኔን ሰብዓዊ # በስብሰባው ነው
በሊዝ : በቅርቡ የወጣው ይህ ቤት ትምህርት
ስለመያዝ : ሰው ቤት ትምህርት
የወጣው : የካፑቺን በሊዝ ቤት ትምህርት
አዋጅ : ክፍሉን አምላክ ተመልካች ከተማ አገሮች
እንዲሻሻል : ያሉበት የተጠየቀው እንደሚገባ አግባብ ጋራዦቹ
የተጠየቀው : አቡነ እንዲሻሻል እንደሚገባ በድጋሚ በማለት
በአክሲዮን : ማረጋገጫ ድጋፍ መመዘኛ በማለት አጠገብ
ተደራጅተው : በሠራተኞቻችን የሚገርመኝ ቅንጡዎች ከሁሉም ተብሎ
ያሉበትን : አቀባበል በነፍስ ምክንያት ጋራዦች ቤት
አካባቢ : ከትምህርት ትምህርት
ማልማት : ሠርቷቸው ደረጃ ባለፈው ድሪባ ነጋዴዎቹ
የሚፈልጉ : ደስታ የሚገኘው ባይኑ በኋላ ብርሃነየሱስ
ነጋዴዎች : በሐረርጌ አምስቱ ያሉበት ተደራጅተው የወጣው
ማግኘት : ይሆን አቡነ ጋራዦቹ አጠገብ የብቃት
አለመቻላቸው : ኤክስፐርቶች ኢትዮጵያውያን ጨምረው እንደሚቀጥል መሆናቸውን
ነው : እስከሚያመጣ ትንኝ በድጋሚ ከትምህርት መመዘኛው
እነዚህ : ብለው እነሆ በአዲስ በመጪው የቤተ
የንግድ : ጨምሮ የሚፈልጉትን # አካባቢ ያሉበትን
ሥራ : ማዕከላትን የወጣው ጋራዦቹ ቤት ትምህርት
በሚያካሂዱበት : የእንግዳው እንበል እንዲችው ሲነግሩህ ጋር
ለማካሄድ : ደግሞ ብፁዕ ጥያቄያቸው በአክሲዮን አጠገብ
የቦታ : አልሽ የሞዛምቢኩ ያሉበት በድጋሚ አግባብ
ቢያቀርቡም : ሰደድ በወጣ ለእኛ ከተሰብሳቢዎች ከትምህርት
አዋጁ : ትዳርን በድጋሚ በማለት ቤት ትምህርት
ምክንያት : የተቃጠልነው ፍላጎታቸው ያሉበትን ይህ መመዘኛው
ጥያቄያቸው : አቡነ ቤተ እንደሚገባ በማለት ጋራዦቹ
መስተናገድ : የሽልማት ስንቱ ይዳዳታል የሊዝ የሚፈልጉ
የማይችል : ይኼኔ ለሥልጣን የተወለዱት አብያተ ይገንባ
በመሆኑ : ሙቱ እናትና ጉባዔ ለእኛ ሊታይ
ምሬታቸውን : ጦረኛ ጳጳሳት እነዚህ ጋራዦች ቢከፈት
በስብሰባው : እንደመጡ በሌጋሲዮን ሱራፌል ድሪባ ቦታ
ላይ : ሲያስታጥቋችሁ ክህሎት ማዕከላትን ያሉበትን መመርያው
ገልጸዋል : ጋራዦቹ አይገባም አጠገብ ከትምህርት የብቃት
መንግሥት : ባነፈሰው ግንኙነት አፍሪካዊ ክፍለ እነዚህ
# : ተቃጥለው ስሙልኝ በአገር የሚፈልጉትን ቦታ
የገበያ : ብለን ርዕሰ በተጨማሪም እነዚህ የከተማ
ማዕከላትን : ማዕከላቱን ሥራ ሊታይ በማለት ቤት
ለመገንባት : አታዳብሩ መንጎጨት የመገንባቱን የነጋዴ ጋራዦቹ
አቅዷል : አላለፉም አገኙ ችሏል ይደረጋል ጋራዦቹ
ማዕከላቱን : ማዕከላትን ሥራ ሊታይ በማለት ሊገነቡ
የመገንባቱን : ለሚገኙ አላልኩም በአገር ለመገንባት ድጋፍ
ኃላፊነት : ተንቀሳቀሰች ልንይዘው የካፑቺን ሬዲዮ ጠቀሜታ
ለእኛ : እናትና እይታና ፍራንቼስካና ሊታይ መመዘኛ
ይስጠንና : በተሻኮቱ ተሳፋሪዎች በሆኑ ሹመቱ ብርሃነየሱስ
ጤና : መሳይ እያለ በሚገኘው መሪዎች ቢያቀርቡም
ማዕከልና : እያወጋን እየተቀባበሉ በማለት አጠገብ ትምህርት
መንገድ : ለትከሻ ይጋባበታል ከተለያዩ ለመመረጥ ስብጥሩም
ይገንባ : ከጉዞ ለመሆን መጣችሁ ሁሉ ክርስቲያን
በአሁኑ : ሬስቶራንቶች የተጻፈው ካሳንቺስ ጋራዦች ትምህርት
ወቅት : ራሳችን ክፍለ ለማሻሻል ተብሎ ቢከፈት
መሬት : ገጽታ የምሥራቅ እንደተናገሩት ሊገነቡ የብቃት
ከጨረታ : ለመሄድ ደቂቃ አደባባይ ነጋዴዎቹ ቤት
ውጪ : የተዘረዘሩት መዳረሻችን በበኩላቸው ሥራ ሊታይ
የሚገኝበት : ሥርዓት ያልተረጋገጠው እይታና የሆኑ በአሁኑ
ጠባብ : ሲያዋክቡት ሀገረ እንደተናገሩት ድምፅ ይገንባ
ሊያካሂዱት : የወርልድ ሌላውን የሚያጫርስ ስማ እንደሚጠቁሙት
የሚፈልጉትን : አታቃጥለኝ አገሮች በዓለ # የንግድ
ልማት : እንዲቀጥል አጉል የሚፈልጉ በአክሲዮን ድጋፍ
ማካሄድ : ጆሯቸው ቲኦሎጂ ጸሐፊ ይገኛል ከፍተኛ
ካለመቻላቸው : በመጪው ጳጳሳት እነዚህ ቢከፈት ቤት
በተጨማሪም : ከዚህና ሰው ማዕረገ ለቫቲካን የገበያ
ከዛሬ : አጠገቤ ሜንዴዝን ሊታይ ሊገነቡ ቤት
ነገ : ብፁዕ ለማካሄድ አካባቢ በአክሲዮን *
ይገኛል : አቡነ ገልጸዋል * ጋራዦቹ አጠገብ
እየተጉላሉ : እኛ ጋራዦቹ አይገባም ከትምህርት የብቃት
መሆናቸውን : መቼ ማዕረግ እንደሚቀጥል መመርያው ይህ
አስረድተዋል : ተናግረዋል የኬፕቨርዴው በቅርቡ ይገኛል በተጨማሪም
ከንቲባ : ምክንያቱም በሁለት በሪሴፕሽን የነጋዴ በአጠቃላይ
ድሪባ : ይሰውራችሁ በተንሰራፋበት ማልማት ከተሰብሳቢዎች ነጋዴዎቹ
የሊዝ : ጆሯቸው መስተናገድ ከተሰብሳቢዎች መመዘኛ መመዘኛው
ያሉበት : እንዲሻሻል በድጋሚ ከትምህርት የብቃት ቢከፈት
ክፍተቶች : ፀሐይን ጀመር ቅንጡዎች መሥራቷን አቅራቢያ
እየታዩ : እንደመጡ እንደተመኘ ያመለጠንን የሆኑት የከተማው
መሆኑን : በመቶ ባረባው መልስ መቼ ክርስቲያን
ገልጸው : ነውና ክርስቲያናት መሆናቸውን ይደረጋል አይገባም
በቅርቡ : ለምንድነው በሊዝ ይህ ቤት ትምህርት
ውሳኔ : ለመሄድ የነበሩት አባላቱ ይህ *
እንደሚደረስና : ሆቴል ከመሠረቱት አለቃ ሁለተኛው በአሁኑ
የከተማው : ሾፌሩ እየታዩ ይህ ከትምህርት ጋራዦች
ተጠናክሮ : መረጃዎች በአጠቃላይ * አጠገብ ቤት
እንደሚቀጥል : ምን የሚፈጸመው አለመቻላቸው ተደራጅተው ተብሎ
አስታውቀዋል : ነበራቸው ይችላሉ እየታዩ ችሏል ድጋፍ
አቶ : ያውስ ሁለተኛው የከተማ በድጋሚ በአጠቃላይ
ከበደ : ያለማዳመጥ ሞቱ እንደራስ ዓመት አብያተ
በበኩላቸው : መዳረሻችን አቁሙ ጥቂቶች ጀርባ በዋዜማው
ማረጋገጫ : በአክሲዮን መመዘኛ በማለት መመዘኛው ቤት
ጠቀሜታ : በተንሰራፋበት ሁለንተናዊ አስተዋጽኦ ኃላፊነት ማልማት
እንዳለው : እይታና በማላዊ ለእኛ በመሆኑ ሊታይ
ማነቆ : ገጽታው የምናጠፋ ግቡ በቅርቡ የወጣው
የሆኑ : ዘመኑ ጥያቄያቸው እንደሚገባ ሊታይ ጋራዦቹ
መመርያውን : ዋንጫውን ለዚህም እርስ ገልጸዋል *
ለማሻሻል : አይቀርም እምብፁዓን በድጋሚ ይህ ቤት
ጥናት : ወንበር አቅራቢያ ለእኛ የብቃት ቢከፈት
መጀመሩን : ሊታይ በማለት ቢከፈት ቤት ትምህርት
ጨምረው : እኔ ቻንስለርም ጨለቅለቃ አለመቻላቸው ተብሎ
አመልክተዋል : የቀለለው ሞልቷቸዋል በ# አደባባይ ማነቆ
የኢትዮጵያ : ፍጡራን ከትምህርት መመዘኛው ትምህርት
ካቶሊካዊት : ሹመት ጨምሮ በድጋሚ ይህ አይገባም
ቤተ : ፍርድ ጥያቄያቸው የተጠየቀው ድጋፍ *
ክርስቲያን : የማኅበራችን ብርሃነየሱስ ይገንባ ጥያቄያቸው የተጠየቀው
ሊቀ : አረጋውያን የነጋዴ የብቃት ቢከፈት ትምህርት
ጳጳሳትና : ፈረንሳይ አውቀዋል አቅራቢያ ህዳሴን የሚገኝበት
ጳጳሳት : እንመጣለንና በስማቸው ይሸምናል በእንግሊዝ ምሬታቸውን
ጉባዔ : እናትና በመሆኑ አባላቱ ሊታይ መመዘኛው
ፕሬዚዳንት : ግሪጎሪያን የሚገኝበት መስተናገድ ጥያቄያቸው እንደሚገባ
ብፁዕ : ካልተስማማዎት ሳንገብርና በቤተ ነገ ለማካሄድ
አቡነ : ጥያቄያቸው የተጠየቀው በማለት * ጋራዦቹ
ብርሃነየሱስ : የበኩሏን እስኪያልቁ ቅንጡዎች ዕድገት ክርስቲያን
ሱራፌል : የእፍኙ ያደለው አጃቢ በቅዱስ አረጋውያን
የካርዲናልነት : ለእንግዶቻችን መመስከር ቀዘባ ጎዳናውና የከተማው
ማዕረግ : እንቀይርልዎት ሊያስረዱን መቼ እንዲነሱ ሊገነቡ
አገኙ : ቀረ ይደረጋል አይገባም አጠገብ ቤት
ብርሃነየሱስን : አድናቆትን መሆኑንም የብቃት ቢከፈት ትምህርት
ጨምሮ : አታቃጥለኝ የንግድ ከትምህርት ትምህርት
ለ# : በሁለት ይጋፋል ክርስቲያኒቷ ለማምጣት ያሉበትን
ሊቃነ : በቅዱስ የኢትዮጵያ ለማሻሻል በአክሲዮን ከትምህርት
ማዕረግና : መስተዋት በፈረንሳይ ከተለያዩ ማዕረግ የመገንባቱን
ለአምስት : ስለደረሰው አስታኮ ካቶሊካዊት በድጋሚ አይገባም
ድምፅ : የኢትዮጵያ ጠባብ መመዘኛ ከትምህርት ትምህርት
አልባ : ያመሳስሉታል ስብከት አባ ጴጥሮስ ማግኘቱን
የመምረጥም : የሚጭሩት የነበሩት ጋራዦቹ አይገባም ጋራዦች
ሆነ : በምትገኘው የካቲት ጠይቀዋል የብቃት ትምህርት
የመመረጥ : ተገኝቷል ለዚህም የምንኖር ጸሐፊ አገሮች
መብት : በቴክኒካል አውድማ የላዛሪስት በመሆኑ ሊታይ
የሌላቸው : ውስጥም መመዘኛ መመዘኛው የብቃት ትምህርት
ሹመት : ካቶሊካዊት የሆኑ ምሬታቸውን ይህ አይገባም
ባለፈው : ቲቸር ትንኝ ማልማት ከፍተኛ ነጋዴዎቹ
እሑድ : በምን ቅንጡዎች እንደሚጠቁሙት ሳይገልጹ ተደራጅተው
ረፋድ : የለም ይናገራል እንዲሻሻል እንደሚገባ በድጋሚ
በቫቲካን : ታክሲና ይዳዳታል ዩኒቨርሲቲም ማዕረግና የመገንባቱን
በመስጠት : መኝታ በሌጋሲዮን ነጋዴዎቹ ጋራዦቹ የብቃት
ይፋ : ልታደርገው ጊዜ ሊታይ ይህ ሊገነቡ
ያደረጉት : የሚቀመጠውን ካሉት ማረጋገጫ የሊዝ ማግኘቱን
ርዕሰ : እናንተና የገበያ በድጋሚ ጋራዦች ትምህርት
ፍራንሲስ : መታደም ፖፕ መመዘኛ በማለት እንዲነሱ
ናቸው : በመሆኗ መመስከር እንዲነሱ ሊገነቡ መመዘኛው
ቫቲካን : ዕድገት የሚፈልጉ ተደራጅተው የነጋዴ መመዘኛው
ሬዲዮ : እርካታ ከአንደኛው ከ#ኛው በሊቀመንበርነት በማላዊ
ታኅሣሥ : ሰኔ ሐምሌ አላለፉም ችሏል አይደለም
ቀን : የበኩሏን ትምህርትህን እስከ በኢትዮጵያ ስብጥሩም
ዓ.ም. : ማርኬት እፎይ የናፈቅናት መረዳት ከፍተኛ
እንዳስታወቀው : ኤክስፐርቶቹ ሊያሳስበኝ ሳይገልጹ መሆናቸውን የወጣው
የአዲሶቹ : እየታዩ በስብሰባው ነው * አይገባም
ካርዲናሎች : ገጸ ጳጳሳቱ እነዚህ ሪፖርተር *
በዓለ : እስከሚያመጣ መሪዎች ቤተ አካባቢ ከትምህርት
ሲመት : ያህሉ ባይ የብቃት ቤት ትምህርት
የሚፈጸመው : አገልግሎትም እንደሚቀጥል መሆናቸውን ተደራጅተው መመርያው
የካቲት : እኛ እንደሆነ ጳጳሳቱ ሥራ ሊታይ
#ዎቹ : አዎ የነገረ እነዚህ የነጋዴ ተብሎ
ተሿሚዎች : እንግዳ ድሪባ እነዚህ ከተሰብሳቢዎች እንደሚገባ
ከሁሉም : እንደሚመክሩ ድሪባ ተደራጅተው ቦታ ተብሎ
ክፍለ : ሌላ ወቅት መንግሥት እነዚህ *
ዓለም : ዜናዊ ቦምብና ጀርባ የነበሩት ጳውሎስ
ከሚገኙ : ማናጀሯ ሸምድዶ የመጀመርያ መካከል እምብፁዓን
ከ# : ሴትዮዋ # ሥራ አለመቻላቸው መመርያው
አገሮች : ሽልማቱንም ጳጳስ የሚፈልጉትን አዋጅ አይገባም
የተውጣጡ : ሐንጋሪ ሜንዴዝን መሆኑንና ካቶሊካዊት በአሁኑ
ሲሆን : ሽልማቱን ትውስታ የአብሮነታቸውን በሚገኘው ከጨረታ
ስብጥሩም : ሐዘን ተከትሎ ቀን ድጋፍ በድጋሚ
የሮም : አራት ከሚባሉት መቼስ በቁማቸው እንደራስ
ካቶሊካዊ : ዩኒቨርሲቲ የገለጸች የንግድ በአክሲዮን በማለት
በዓለም : መመዘኛ ከትምህርት ትምህርት
ዙሪያ : የተነሳ ምንም ቤት ትምህርት
ካሉት : የሚገኙት በድጋሚ በማለት አይደለም ቤት
አብያተ : በቢዝነስ እንደበዛ አጋማሽ የማይችል መመዘኛው
ክርስቲያናት : በኢትዮጵያ የገለጸች አስተዳደር የማይችል በሊዝ
ጋር : የአመራር በሚያካሂዱበት የንግድ አካባቢ የነጋዴ
ያላትን : አካባቢ ከትምህርት ትምህርት
ትስስር : እውርን ጸሐፊ ማካሄድ አካባቢ ከትምህርት
የሚገልጽ : የፖርቱጋልና አጋጣሚም ቢከፈት ቤት ትምህርት
ሁለተኛው : አቶ የሚፈልጉ በአጠቃላይ በማለት አጠገብ
አፍሪካዊ : የሚገነባው እምብፁዓን እነዚህ የወጣው በድጋሚ
ካርዲናል : ተሻግረው * መመዘኛው የብቃት ቢከፈት
የሆኑት : ይስጠን እየታዩ ሪፖርተር አይደለም *
የኬፕቨርዴው : በዓለ አስረድተዋል ጥያቄያቸው ቢያቀርቡም በአክሲዮን
ጳጳስ : አገሮች ክፍለ ይገኛል ማካሄድ መንግሥት
ሲሆኑ : የሚለው እንኳ አውድማ መመዘኛ በማለት
ከተመረጡት : ቅርስ ጸሐፊ ጋራዦቹ አይገባም ቢከፈት
አምስቱ : ወርልድ ሆቴሉ በሶሲዮሎጂ በሐረርጌ አስተዋጽኦ
አረጋውያን : እናትና ሊቀ የነጋዴ የብቃት ትምህርት
መካከልም : ጉባዔ መመዘኛ ከትምህርት መመዘኛው ቤት
የሞዛምቢኩ : በፎርሙ እንደሚገባ የብቃት ትምህርት
ይገኙበታል : ይመርጣሉ አድርጓል ተቃጠለ የሚገባው አለኝ
አዲሶቹ : ከመሆን የመመረጥ ብፁዕ አይገባም መመዘኛው
አብዛኛዎች : እንሄዳለን እየታዩ ድሪባ ማካሄድ ይደረጋል
ዓመት : ታሪካዊ ከተማ እየታዩ አዋጅ ከትምህርት
በታች : ተሸላሚ የመጀመርያ ያሉበት እነዚህ በድጋሚ
በተሰጣቸው : በተሻኮቱ ከመሠረቱት አብዛኛዎች ብርሃነየሱስ የሚገኝበት
አዲስ : የሚገነባው ሌግዠሪ የማስተርስ ያጨለመበት ያመለጠንን
መሠረት : ራሳችን ፈረንሳይ ጋቢና በሥፍራ መጀመሩን
በመንበረ : የማስተርስ አረጋውያን ሊቀ የነጋዴ ነጋዴዎቹ
ጴጥሮስ : አልፎላት ከመቆም ትዳርን በሊቀመንበርነት ሊገነቡ
የሚቀመጠውን : ጎጆ ያደረጉት ማረጋገጫ የሊዝ የንግድ
ፖፕ : ፍራንሲስ በአክሲዮን በማለት * ትምህርት
ለመምረጥም : ሲያዋክቡት ያለው ጠባብ ችሏል ማግኘቱን
ለመመረጥ : እንደስላሴ የእኛ አሥራተ ዓ.ም. መንገድ
ይችላሉ : አለኝ ለምን ነበር አስታውቀዋል በቅርቡ
ከተለያዩ : የማርኬት ኢኮኖሚያዊ ማዕረግና ይህ መመዘኛው
አገሮችና : ማነቆ በቅርቡ መመርያው ይደረጋል ቤት
አኅጉሮች : ቅርንጫፎች መመዘኛ መመዘኛው የብቃት ትምህርት
አዲሶቹን : እንደተናገሩት ተጠናክሮ የሚገኝበት ጥያቄያቸው እንደሚገባ
የቤተ : አዎ ከንቲባ እነዚህ በድጋሚ ጋራዦቹ
መሪዎች : በዓለ ጤና በስብሰባው አካባቢ አይገባም
በቅዱስ : ሊቃነ ከንቲባ የንግድ አካባቢ በአክሲዮን
አደባባይ : ዞሮ ከጨረታ ሊታይ በድጋሚ ከትምህርት
ሲያደርጉ : ጉስቁልና ሲገኙ ፃድዋ ማረጋገጫ በአክሲዮን
እንዳስታወቁት : ታዋቂነትን ተፈተለከ የተቀመጠ ግሪጎሪያን ያሉበት
ፍላጎታቸው : ያትታሉ ተዓምር ምክንያት ይህ ይደረጋል
የሚገኙት : ካሉት ያሉበት በማለት አግባብ ከትምህርት
ከሮም : ምንም ካሉት ካቶሊካዊት የኢትዮጵያ እየታዩ
ያላቸው : እጃችን ሲታይ ርዝማኔ ካቶሊክ ማዕከልና
የማይነጣጠል : ተቃዋሚዎች የመጀመሪያው የገለጸች የሚፈልጉትን አካባቢ
ለማሳየት : አታዳብሩ ለመገንባት ከፍተኛ ጋራዦቹ መመዘኛው
በመጪው : በዚህም የነገረ ሪፖርተር ድጋፍ የነጋዴ
በአዲሶቹ : መመዘኛው ትምህርት
አጋጣሚም : አከሽፍበታለሁ ካርዲናል የሚገልጽ እየተጉላሉ ይገኛል
ለቫቲካን : ሾፌራችን የሞዛምቢኩ በድጋሚ ይህ ከትምህርት
አስተዳደር : በአገር ክርስቲያናት ይህ አይገባም መመዘኛው
ህዳሴን : ሌሎችም ሴትዮዋ ሜንዴዝን ተብሎ የብቃት
ለማምጣት : አታቃጥለኝ መንበር የሚፈልጉትን የንግድ አካባቢ
ሁሉም : ትዳርን ሹመት በድጋሚ ይህ መመዘኛው
በዋዜማው : መዳረሻችን መካከል ኩራት በበኩላቸው ያሉበት
እንደሚመክሩ : ሆቴሉን መኝታ ከሁሉም ሲመት ብርሃነየሱስን
ሳይገልጹ : ብለዋቸዋል እንቀይርልዎት ተቀምጠው የተወለዱት ማዕረግ
አላለፉም : አስቀምጠዋል አቅዷል ችሏል ትምህርት
የአቡነ : ዘመኑ የሆኑ ያሉበት ካለመቻላቸው እነዚህ
መሆንን : መረጃዎች ተጠናክሮ እነዚህ የተጠየቀው አዋጅ
ተከትሎ : ሲያጉረጠርጥ የማያካትት ስብጥሩም ክፍተቶች ድጋፍ
ደስታዋን : ደስታ ማኔጅመንት መሪዎች ተደራጅተው የወጣው
የገለጸች : የንግድ ጋራዦች ትምህርት
በተለይ : ስለሆነም የአውቶሞቢሉ የነገረ የሚገኙት ከበደ
ክርስቲያኒቷ : መሠራቱ ለ# አካባቢ በድጋሚ መመዘኛ
ጽሕፈት : አደጋ ምክር አካባቢ ከትምህርት ትምህርት
ጸሐፊ : ተገኝቷል ቃጠሎ በዝምታ ማዕበል ከተመረጡት
አባ : ከመሰብሰቢያ ይመስላል አልባ ሊታይ ሊገነቡ
ተስፋዬ : ጠቅላይ ካርዲናል የመመረጥ ብርሃነየሱስ የነጋዴ
ወልደማርያም : አደረጃጀት ሲያጠናቅቁ ሁለንተናዊ ከተሰብሳቢዎች ፎረም
እንደተናገሩት : አዲሶቹን ያሉበት ጠባብ እንዲሻሻል ሊታይ
ሹመቱ : የነበረ ፍጡራን እንደሚጠቁሙት ክርስቲያናት መሆናቸውን
ለአገሪቱ : ተቃጥለው የሚፈልጉትን # መመዘኛው ትምህርት
ትልቅ : እናዓይኔን ብርሃነየሱስ እየተጉላሉ ተደራጅተው ቦታ
ክብርና : እንዲችው ስብጥሩም በሚያካሂዱበት በድጋሚ አይገባም
ኩራት : በዋዜማው ጳጳሳት ምሬታቸውን እነዚህ ቤት
መሆኑንና : የተውጣጡ ይህ ጋራዦች ትምህርት
ለኢትዮጵያ : ሙሽራ የካፑቺን አፍሪካዊ የወጣው ስለመያዝ
መንፈሳዊና : አላልኩም ከሌት ክርስቲያናት ጠባብ በሊዝ
ኢኮኖሚያዊ : ተመልሶ ይህ ይደረጋል መመዘኛው የብቃት
ዕድገት : ባይኑ ብርሃነየሱስ ቦታ ድጋፍ በአጠቃላይ
ያለው : የካቶሊክ ምክር አባላቱ ትምህርት
አስተዋጽኦ : ሪሌሽን ሹመት ይህ ይደረጋል ጋራዦች
ብለዋል : በደህና እፎይ ዲግሪ ያደረጉት ድሪባ
ጳጳሳቱ : ሪፖርተር አግባብ ጋራዦች የብቃት ቢከፈት
ለካርዲናልነት : ሆነዋል ከሐረር ፍራንሲስ እየታዩ ይገኛል
የበቁት : ጊዜ በአክሲዮን እንዲሻሻል ድጋፍ ሊታይ
ለኢትዮጵያና : ለመሄድ ከተሰብሳቢዎች መመዘኛ ተብሎ ቤት
ለአፍሪካ : የማስትሬት ለማሻሻል በድጋሚ የብቃት ቤት
ባደረጉት : ሸኘን ሰው ፍራንቼስካና ኢኮኖሚያዊ ሲመት
ሁለንተናዊ : ወልደማርያም ጠቀሜታ # አይገባም ሊገነቡ
ሰብዓዊ : ቀናት ብርሃነየሱስ ቦታ የብቃት ቤት
መሆኑንም : ሌሎችም አድናቆትን ብርሃነየሱስን እንደሚቀጥል መሆናቸውን
ተናግረዋል : አለኝ አንዲት አንስቶ አስረድተዋል ይገኛል
እምብፁዓን : ለማሻሻል አግባብ ይህ ከትምህርት የብቃት
ደምረው : ብርሃነየሱስን የካርዲናልነት የሚፈልጉትን # ተብሎ
ገጸ : የማላሠራለትን ካርዲናሎች መብት እየታዩ እነዚህ
ታሪካቸው : መታደም ሲያደርጉ ጠባብ እንደሚገባ በማለት
እንደሚያመለክተው : ሊያሳስበኝ ያልሆኑትን መሠረት የብቃት ቤት
የተወለዱት : ለማድረግ ሳይገልጹ ማዕረግ የማይችል መመርያው
ሐምሌ : ግንቦት አላለፉም ታኅሣሥ ቫቲካን የነጋዴ
በሐረርጌ : በ#ኛው አምስቱ ነጋዴዎች የወጣው ይደረጋል
ጠቅላይ : ማትረፉ ቲቸር ወጥታ ቅርስ ተስፋዬ
ግዛት : አይ መምራት መመዘኛ አግባብ ትምህርት
ከሐረር : ትንሽ ከትምህርት ቤት ትምህርት
ከተማ : ይሆን ዓመት እየታዩ አዋጅ ከትምህርት
አቅራቢያ : ፈረንሳይ መታገስ ከቦሌ ከመሠረቱት ጥናት
በምትገኘው : ጠበንጃ ሆነ የብቃት ቤት ትምህርት
ጨለቅለቃ : ጥርጥር ጨምረው አለመቻላቸው መመርያው እንዲነሱ
የነገረ : የጥሪው በመጪው የቤተ በታች እነዚህ
መለኮት : ይህንንም መተዋወቅ የጀመረችው ጋር የነጋዴ
ቲኦሎጂ : እባክህ በኢትዮጵያ ማካሄድ አባላቱ አይገባም
እና : የተዘረዘሩት ችሏል ቤት ትምህርት
የፍልስፍና : አልተናገራትም ይሆኑ እየተንቀሳቀስን ማረጋገጫ ድጋፍ
ትምህርታቸውን : ጌታዬ ሆቴሉ አውድማ ካልጠፋ ሰው
በአገር : አንደኛው ሾፌሩ ይህ አይገባም መመዘኛው
ውስጥና : ገጽታ መካከል ወልደማርያም በዋዜማው እየታዩ
በእንግሊዝ : እንዳስያዙዋቸው ናትና በርሳቸው ጳጳሳት ድጋፍ
ሲያጠናቅቁ : ሆቴሉ ወልደማርያም ሬዲዮ ቤት ትምህርት
ከኢጣሊያ : አንደኛው መሳይ ዩኒቨርሲቲም አባላቱ ሊታይ
ግሪጎሪያን : እንደተናገሩት ፕሬዚዳንት ጠባብ የሚገኝበት እንደሚገባ
ዩኒቨርሲቲም : ከኢጣሊያ የኢትዮጵያ ማነቆ ጥያቄያቸው ድጋፍ
በሶሲዮሎጂ : አምስቱ ይህ አይገባም መመዘኛው ቤት
የማስትሬት : ለአፍሪካ ካቶሊካዊት ከዛሬ በድጋሚ ከትምህርት
ዲግሪ : ለመስበር ሲያስታጥቋችሁ እኔ አፍሪካ መሆኑንም
አግኝተዋል : የት በ# አስታውቀዋል በስብሰባው በሊዝ
በቤተ : ካልተስማማዎት ይላል ብፁዕ በአጠቃላይ ጋራዦቹ
አገልግሎትም : የሚፈጸመው ማዕረግ መሆናቸውን አለመቻላቸው መመዘኛ
ሰኔ : ታኅሣሥ ቫቲካን አስታውቀዋል ከዛሬ በስብሰባው
ማዕረገ : የተቀመጡት በተጨማሪም ሥራ ይህ ጋራዦች
ክህነትን : ሆነ ማዕከላትን አይደለም አይገባም ሊገነቡ
ሲቀበሉ : እንደሚኖረው ከመቀመጫቸው ብርሃነየሱስን ሊቀ መረዳት
ጥቅምት : በቅተናል ግንቦት ሰኔ ታኅሣሥ ከዛሬ
የአዲስ : ከመሠረቱት በተሰጣቸው አይደለም ጋራዦች የብቃት
አበባ : የሽልማቱን ከሜሪላንድ የካቲት ሆነ ያሉበት
ረዳት : መልካም ከአንደኛው ሲቀበሉ ብርሃነየሱስን ጳጳሳትና
ጥር : ፈጥሯል ይሆናል ፖፕ ታኅሣሥ ጉባዔ
የመጀመርያው : ለሆቴሉ ተከታያቸው ከተለያዩ ነጋዴዎቹ እንዲነሱ
ጳውሎስ : ባንክ የመጀመሪያ መድኃኒዓለም ዓለም የብቃት
ፃድዋ : ሲያደርጉ መመዘኛ በማለት ከትምህርት ቤት
ተተኪ : የመጡ እነዚህ ሪፖርተር በማለት *
በመሆንም : ለመሆን የሚፈጸመው ተብሎ የብቃት ቢከፈት
ሆነዋል : ለካርዲናልነት ፍራንሲስ አስታውቀዋል ችሏል አይደለም
ከሲመተ : ብሎ ሁለተኛው ጳጳሳትና የሚፈልጉ ሊታይ
ጵጵስናቸው : ተብሎ የብቃት ቢከፈት ትምህርት
በፊት : መምህርም ከሁሉም ለማሻሻል ድሪባ ለመገንባት
በ# : ለምንድነው መሥፈርት የተቀመጠች ተዓምር ፍላጎታቸው
የላዛሪስት : በቴክኒካል መኪና መብት እየተጉላሉ በተጨማሪም
ማኅበር : ነገሮች አገር ማዕከላቱን ሊታይ ይህ
እንዲሁም : የተቀመጠች በስማቸው ስትሆን የምሥራቅ በ#
የጂማ : ሞባይሉን የፍልስፍናና በቤተ ጠቀሜታ *
ቦንጋ : ለደካማ የነጋዴ ሊታይ የብቃት ትምህርት
ሀገረ : ፋሲሊቲ የካቶሊክ ጠባብ የሚገኝበት እንደሚገባ
ስብከት : አልባ ብርሃነየሱስን ጨምረው መሆናቸውን ለማካሄድ
አለቃ : በማለት አጠገብ ቤት ትምህርት
የነበሩት : ተሻግረው ብለን ውሳኔ ያሉበት የተጠየቀው
በአዲስ : ኤክስፐርቶችም እነዚህ ሪፖርተር * ጋራዦች
በሚገኘው : ሬት እንከታተላለን ይሁን ጤና ቢከፈት
የካፑቺን : አኅጉራትም አይቀርም የወጣው በድጋሚ ይህ
ፍራንቼስካና : ያልሆኑትን ለእኛ ሊታይ የብቃት ትምህርት
የፍልስፍናና : ሸኘን አውቀዋል ለትከሻ ብርሃነየሱስ የብቃት
ነገረ : አድናቆትን የገለጸች ይገንባ የማይችል መስተናገድ
ተቋም : ሲያባርረው እናትና የለም እንዲህ ለእኛ
ከመሠረቱት : ማደር የአዲስ በተሰጣቸው ብርሃነየሱስ የሚፈልጉ
አንዱና : ማዕበል በተለያዩ ለማካሄድ በማለት አጠገብ
መምህርም : ልኮልን ከሦስት በፊት ጨለቅለቃ ጨምረው
ነበሩ : ይመርጣሉ የሚገባው ችሏል * አጠገብ
ከመንፈቅ : ይህንንም ኢትዮጵያን ሌሎችም የቤተ የነጋዴ
በማላዊ : ወንበር እንዳለው አባላቱ ሊታይ መመዘኛው
ሊሎንግዌ : ክፍለ እነዚህ ጋራዦቹ ጋራዦች ቤት
በተካሄደው : ትላለችሁ አሜሪካ ካላችሁ ታሪክና መረጃዎች
የ#ቱ : በኋላ በመጪው መሠረት ወቅት በድጋሚ
የምሥራቅ : አካሄድ የካቲት እንዲሻሻል በሊዝ አግባብ
አፍሪካ : እንደተደሰቱ በመቶ በተሻኮቱ መረዳት አጠገብ
ካቶሊክ : በዝምታ ግሪጎሪያን እንደተናገሩት የአቡነ ሲመት
ኅብረት : አማኝ ልጃቸው ናቸው እንዳለው መስተናገድ
አመሲያ : ሳንገብርና ቤትንም ዩኒቨርሲቲ ከተለያዩ ፕሬዚዳንት
ሊቀመንበር : የተቃጠልነው ከዚህና የገለጸች ከጨረታ ያሉበትን
ሆነው : ወክዬአቸው ፍጡሮች ዲግሪ ማዕረግ ማግኘቱን
በመመረጥ : ሰቀቀን ድንገተኛ ተከታያቸው ጳጳሳትና የብቃት
በማገልገል : እዚያ ከ#ኛው ጴጥሮስ ቦታ ችሏል
ሲገኙ : የሆቴሉ ጉስቁልና ሲያደርጉ በአክሲዮን መመዘኛ
ዩኒቨርሲቲ : መኪኖች ካቶሊካዊ የማይችል ምክንያት በሚያካሂዱበት
ቻንስለርም : ጨምረው አለመቻላቸው ተብሎ ሊገነቡ ከትምህርት
የኢትዮጵያና : ስለሆነም የነገረ ቫቲካን አቶ መመዘኛ
የኤርትራ : ክፍሉ ይሉታል የፍልስፍናና የሚፈልጉ መመዘኛው
ምክር : አሸባሪዎች ጽሕፈት የገለጸች ድምፅ ትምህርት
ቤትንም : ማግኘት ጋራዦቹ አጠገብ ከትምህርት ቢከፈት
በሊቀመንበርነት : እናስቸግራችሁ ሬዲዮ ጨምረው አለመቻላቸው አጠገብ
ይመራሉ : ፈጥረናል አይታወቅም እንከታተላለን ከ#ኛው ተብሎ
ክርስቲያኒቱ : የማያሳውቁት አንሶ ለማሻሻል ሊታይ በድጋሚ
የታሪክ : እባካችሁ ይሁን መታገስ ዩኒቨርሲቲ ገጸ
መረጃዎች : ገጽታው ተጠናክሮ ጥያቄያቸው በድጋሚ በአጠቃላይ
እንደሚጠቁሙት : ሸኘን ፓርቲ ስለሆነ እሑድ ያሉበት
በኢትዮጵያ : የካቶሊክ ክርስቲያናት ቀን መመዘኛው ትምህርት
የካቶሊክ : በኢትዮጵያ ክርስቲያናት ጨምሮ ጠባብ በሚያካሂዱበት
እምነት : ኬፕታውን መልስ ሁሉ ሥልጣን አፍሪካ
በተንሰራፋበት : እንደመጡ ጠቀሜታ ድሪባ ምክንያት ይደረጋል
ከ#ኛው : ወንበር በማላዊ ሬዲዮ መሆናቸውን ከዛሬ
ዘመን : የሚነጋገረው ከመርካት መተዋወቅ ቤተ ጋራዦች
አንስቶ : ተናግረዋል አይገባም ቤት ትምህርት
ያለፉ : ከሚባሉት ድካም ከተማ እየታዩ ላይ
ከእነዚህም : ሥርዓቱ መተማመንን አብዛኛዎች ክርስቲያን ማግኘት
መካከል : እየታዩ ድሪባ በድጋሚ * ከትምህርት
የሚሆኑት : እናዓይኔን ሊቀ ቦታ ነጋዴዎቹ የብቃት
ኢትዮጵያውያን : ኤክስፐርቶች አገር ጨለቅለቃ አለመቻላቸው እንዲነሱ
አልፎንስ : በሪሴፕሽን መቼስ አከሽፍበታለሁ ብርሃነየሱስ የሚፈልጉ
ሜንዴዝን : በሊቀ ህዳሴን የተውጣጡ ከዛሬ ሊገነቡ
ሦስት : ውጥንቅጡ አልተናገራትም ሽር የሚገኙት ዓመት
የፖርቱጋልና : ቢከፈት ቤት ትምህርት
የስፔን : የተቃጠልነው ታክሲዎች ማዕከላትን ምክንያት ከተሰብሳቢዎች
በተለያዩ : አቡነ ቤተ ጥያቄያቸው የተጠየቀው አጠገብ
ጊዜያት : ልንደርስበት በእንቅብ በሊዝ ይህ ቤት
ፓትርያርክ : ካላችሁ የሚፈልጉትን ጥያቄያቸው ይደረጋል አይገባም
የሚል : ሲጠፉ እየታዩ እየተጉላሉ እነዚህ *
ሥልጣን : የተመረጠችው እንደሚቀጥል መሆናቸውን አለመቻላቸው ማግኘት
ነበራቸው : አስታውቀዋል የተጠየቀው በድጋሚ ከትምህርት ቢከፈት
በ#ኛው : በሐረርጌ እነዚህ የወጣው የከተማ ፎረም
የመጀመርያ : ሌላ በታች እንዲሻሻል እንደሚገባ በድጋሚ
አጋማሽ : አንደኛው አብያተ መብት ኃላፊነት መመዘኛው
መንበር : ሜትሮፖሊታንን በዓለ ገልጸዋል * አይገባም
በሊቀ : ሜንዴዝን ከዛሬ የሚፈልጉ የብቃት ትምህርት
ጳጳስነት : ለዚህም ገልጸዋል ችሏል * ጋራዦቹ
እስከ : ዲፕሎማቲክ ቀን የኢትዮጵያ ማግኘቱን መመዘኛ
የተቀመጡት : ማዕረገ ካርዲናል ዓለም እንዳስታወቀው እየታዩ
አሥራተ : ቲቸር ደረጃ በአገር ባለፈው ብፁዕ
ማርያም : የተጻፈው ዕድገት በአሁኑ የሚፈልጉ ተደራጅተው
የምሩ : የማላሠራለትን በድጋሚ ከትምህርት ቤት ትምህርት
ተከታያቸው : አንገቱን ነጋዴዎቹ በድጋሚ ቤት ትምህርት
ደግሞ : አቡነ ለማካሄድ ድጋፍ መመዘኛ በማለት
ተቀምጠው : ሳይገልጹ እንዳስታወቀው መሆናቸውን ተብሎ ጋራዦች
ነበር : ይችላሉ አገኙ በአጠቃላይ ይደረጋል አይገባም
በሆኑ : የአቅም ጎረምሳ ሹመቱ የሚፈልጉትን #
ግንቦት : ጥቅምት ሰኔ ሐምሌ ታኅሣሥ አስረድተዋል
ሜትሮፖሊታንን : መንበር አስረድተዋል ነገ ምክንያት *
መምራት : ማዕረግ መሆናቸውን እንዲነሱ የብቃት ቤት
ከጀመሩ : ይመርጣሉ ባረባው መረዳት መመዘኛው ትምህርት
ዓመታት : የቴክኒክ በቤተ አገሮች ብርሃነየሱስ ለመገንባት
ሞልቷቸዋል : አድርጐናል ያደረጋል ኩራት አመልክተዋል ይደረጋል
ኢትዮጵያ : ደቂቃ አለህ ወቅት መንግሥት በድጋሚ
ከቫቲካን : ለማሻሻል በድጋሚ ሊገነቡ ቢከፈት ቤት
ዲፕሎማቲክ : እስከ ጉባዔ ማረጋገጫ በአክሲዮን በአጠቃላይ
ግንኙነት : ባነፈሰው መንግሥት እነዚህ እንደሚገባ ተብሎ
በሌጋሲዮን : የሚጠራው በመስጠት በስብሰባው ነጋዴዎቹ *
ደረጃ : አሥራተ ማልማት ነጋዴዎቹ የብቃት ትምህርት
የጀመረችው : መለኮት ማግኘቱን ትምህርት
ወደ : ማረጋገጫ ምክንያት መመዘኛው ቤት ትምህርት
ኤምባሲ : ባነፈሰው ግንኙነት እነዚህ እንዲሻሻል እንደሚገባ
ያደገው : አገሮችና ማነቆ ችሏል መመርያው ቤት
ቆይታ : የተግባር መሆናቸውን መመርያው እንዲነሱ የብቃት
በኋላ : በሥፍራ የ#ቱ የሚፈልጉ ነጋዴዎቹ በድጋሚ
መሆኑ : ለመድረስ ቻንስለርም ጨለቅለቃ ጨምረው መመርያው
ይታወቃል : አብስራችኋል ያደረጋል አለኝ ነበራቸው ተናግረዋል
እነሆ : ስለሆነም የነገረ እነዚህ ሪፖርተር ፎረም
ከቦሌ : በመጪው ካርዲናል ያሉበት እንዲሻሻል ድጋፍ
መድኃኒዓለም : ለደካማ ማርያም ብርሃነየሱስ የወጣው ቤት
ካሳንቺስ : አንቺ በአሁኑ የመገንባቱን ለመገንባት ነጋዴዎች
ልንጓዝ : ከመጀመሩ ካሳንቺስ ትልቅ ከሮም ከበደ
ታክሲያችን : ወርልድ አምስቱ ሱራፌል ቦታ ተብሎ
ሞልታ : እጁን አስታኮ ብሶተኛ በተለያዩ ድጋፍ
እየተንቀሳቀስን : ማረጋገጫ አጠገብ ቤት ትምህርት
ድንገተኛ : ፍለጋ በሙሉ በመመረጥ * የብቃት
ሠርግ : ሸኘን መመርያው ሊገነቡ ቤት ትምህርት
አጃቢ : ሱራፌል # ቦታ ሊገነቡ የብቃት
መኪኖች : ዩኒቨርሲቲ የገለጸች የንግድ በማለት ጋራዦች
መንገዱን : የማያገናኘው የቆምንበትን ያመለጠንን የካፑቺን ከኢጣሊያ
ይዘጋጉታል : ሳያንስ እንደሚጠቁሙት ከዛሬ # ተደራጅተው
ሾፌሩ : በአገር የከተማው በሊዝ በድጋሚ ይህ
እኔን : በሆቴሉ እየታዩ * ትምህርት
ካላስቀደማችሁኝ : አንባረቁበት በዝምታ በየፌርማታው እያለ አስተዋጽኦ
አጉል : ሴትዮዋ እያለ አምስቱ ጤና በመሆኑ
ግብግብ : ለደካማ የእፍኙ ሱራፌል መሬት ነጋዴዎች
ይገጥማል : ሰደድ ጽሕፈት መጀመሩን ለእኛ ሊታይ
እኔ : ጨምረው እንደሚቀጥል መሆናቸውን አለመቻላቸው መመርያው
የምለው : አታዳብሩ ሥልጣን ትስስር ለመገንባት ይደረጋል
ከዚህ : ከኤክስፐርቶቹ ሳይስበው ሪፖርተር መመዘኛው የብቃት
ሁሉ : ሠራሽ እምነት ክርስቲያን ይገንባ የማይችል
ከተማው : ጣራው ይመጥናሉ ወይስ ይበላለጥ ብርሃነየሱስ
ሽር : ትምህርት
ብትን : ምርጥ በሊቀመንበርነት መሆኑን ማግኘት ጋራዦቹ
ከሚል : ፈጥረናል በመቶ በተሰጣቸው ክርስቲያን ይገንባ
ባለ : እስኪ አበባ ካርዲናል ያሉበት እንዲሻሻል
ሊሞዚን : የሆቴሎችን በዓይን መተዋወቅ ጨምሮ የከተማው
ሙሽራ : ለኢትዮጵያ የወጣው በሊዝ ይህ ጋራዦች
አንድ : የነገረ በመጪው እነዚህ ሪፖርተር አይደለም
የሚጠራ : ጎረምሳ የእፍኙ ማዕረግ ለመገንባት ከፍተኛ
ይጥፋ : ለምንድነው አለው ታዳጊ ዲሞክራሲ ግንኙነት
እያለ : ትንኝ መውደም ጤና ነው በድጋሚ
ወያላው : የቆመ ግንኙነት አልባ ካለመቻላቸው እንዲሻሻል
ዕድሉን : ለእናንተ ተኮሳተረ ያሉበት በአሁኑ እንዲሻሻል
ያማርራል : አደጋ ቅርስ የተጠየቀው ጥያቄ ከትምህርት
ሰው : ባደረጉት ለማሻሻል ስለመያዝ ከተሰብሳቢዎች ቤት
ከመሆን : አዲሶቹ ብፁዕ የሚፈልጉትን ቦታ የከተማ
ይልቅ : ኤክስፐርቶቹም ሳይመስለው አዲሶቹ የመገንባቱን ምሬታቸውን
መተዋወቅ : ጋራዦች ቢከፈት ቤት ትምህርት
በራስ : ደስታ ልንደርስበት እስኪያልቁ በእንቅብ ብርሃነየሱስ
ጥረትና : ወንበር በማላዊ እንዳለው ውሳኔ ቦታ
ድካም : ያለፉ እየታዩ የንግድ ትምህርት
በልቶ : ብሶተኛ ፍራንሲስ ማረጋገጫ ቢያቀርቡም በማለት
ከመርካት : ከምትሞቱ መሆን ዘመን ቤተ ገልጸዋል
በሰው : ሌላ ብቻ ጥቂቶች ለማሻሻል መንግሥት
ግብዣ : እስኪያልቁ * አጠገብ የብቃት ቢከፈት
መታደም : በማለት ቤት ትምህርት
የሚያስመካበት : ጨምረው ለመገንባት አለመቻላቸው ያሉበትን የወጣው
ስለሆነ : መመርያው ይደረጋል ሊገነቡ የብቃት ቤት
የወያላውን : የፈጠረው ወቅት የንግድ ከትምህርት ቢከፈት
ሮሮ : መረጃዎች በዋዜማው አመልክተዋል ተጠናክሮ ድጋፍ
ከመጤፍ : ወግ ፈልጎ አንገት አውቀዋል ያላደለው
ሳይቆጥሩ : ኢንተርኮንቲኔንታል ተወልደው ፎረም መመርያው አግባብ
ተሳፋሪዎች : የተቀናጀ ዜናዊ ተቃዋሚዎች ብርሃነየሱስ ይስጠንና
እርስ : መመርያውን ከንቲባ የነጋዴ ትምህርት
በርሳቸው : ናትና ግሪጎሪያን በእንግሊዝ ተጠናክሮ ድጋፍ
ያጉረመርማሉ : አይሃለሁ ቤት ትምህርት
ያደለው : ዲሞክራሲ ሱራፌል ከንቲባ ሊታይ እንዲነሱ
ይጋባል : ወይዘሮ የእፍኝ አይ ካልጠፋ ሱራፌል
ያላደለው : አንገት ተድላ መካከልም ለእኛ በመሆኑ
ካልጠፋ : የምናጠፋ ያልፈጠርነውን ትምህርታቸውን ማነቆ ቢያቀርቡም
ነገር : ማንና የእኛ ከንቲባ የከተማ የነጋዴ
ጉንፋን : አልነበረም የሆኑ እንደሚገባ ሊታይ የብቃት
ይጋባበታል : ያዘ ሞት ባደረጉት አደባባይ መንገድ
አይ : አገር ግዛት አዋጅ ፎረም መመዘኛ
አንቺ : ሳይስበው ከቦሌ የሚገኙት በቅርቡ እንዲሻሻል
ምፀትና : በሆቴሉ ለወያላው ትምህርት
ሸር : እስኪ መሆን ክህነትን ይገንባ የማይችል
ረቂቅነቱ : እንቀበላለን ብፁዕ ነገ ለማካሄድ ጋራዦቹ
ስሙልኝ : አፍታ # ቦታ ጋራዦች የብቃት
ባይ : እንግዶች አሜሪካ በመጠጥ ሲመት አቡነ
ብሶተኛ : በልቶ ሞልታ ያደረጉት በድጋሚ አይደለም
ወጣት : እናውቃለን አይገባም መመዘኛው ትምህርት
ሦተኛው : እንስት ወያላውና ከንቲባ ከዛሬ ሊገነቡ
ረድፍ : ቀናት አገሮች ክፍለ ወቅት መንግሥት
ይናገራል : ያለውም ረፋድ ጤና አይገባም ከትምህርት
ቆይ : በመሄድ ድምፁን ጉባዔ ቤተ ምክንያት
ግን : ትዕይንቱን ሦስት የካቶሊክ ሀገረ ጸሐፊ
በሽንጣም : አቀባበል በጊዜና ትስስር ቢያቀርቡም የንግድ
ለመዳር : ሌላውን ድጋፍ መመዘኛ በማለት ቤት
የሚያስቡትን : ልታደርገው በሊዝ ቦታ በድጋሚ መመዘኛው
ያህል : አይደለም ጋራዦች መመዘኛው የብቃት ትምህርት
ስንቶች : ጉስቁልና አዋጁ አባላቱ ከትምህርት ቢከፈት
ይሆኑ : ሥራውን ድጋፍ በማለት ቤት ትምህርት
የአብሮነታቸውን : የእፍኙ ሱራፌል ጤና በመሆኑ የወጣው
ጊዜ : ሾፌሩ የበቁት የወጣው በድጋሚ ቤት
ርዝማኔ : በአክሲዮን ማግኘቱን ትምህርት
አረጋግጠው : ከፍተኛ ቢከፈት ቤት ትምህርት
የሚዘምቱት : ታይቶ ያሉበትን ሊገነቡ ጋራዦች ቤት
ስትል : የጥሪው ቱሪስቶች የነገረ የወጣው ቤት
መጨረሻ : ቅርስ የተጠየቀው እንዲሻሻል አዋጅ እንደሚገባ
ወንበር : በማላዊ ጥናት እንዳለው ከዛሬ ቦታ
አንዲት : ተመሥርተው ተናግረዋል ድጋፍ በአጠቃላይ አጠገብ
ጦረኛ : ምሬታቸውን ይህ ጋራዦች ቤት ትምህርት
መሳይ : ቀናት ከኢጣሊያ ጤና ከትምህርት ትምህርት
ትዳርን : እሳት በድጋሚ ቤት ትምህርት
የጦርነት : አቀባበላችን ታክሲም ይሁን የተጠየቀው በሊዝ
አውድማ : የማርኬት ልንደርስበት ትምህርታቸውን ሲሆኑ መብት
ልታደርገው : የሚያስቡትን ተጠናክሮ ያሉበት በድጋሚ በአጠቃላይ
ይዳዳታል : ስለተቀደደ መሳይ የወጣው በድጋሚ ቤት
እይታና : እናትና ለእኛ ሊታይ መመዘኛው የብቃት
ፍርድ : ቤተ የሆኑ ጥያቄያቸው የተጠየቀው እንደሚገባ
እንደራስ : ጠፊዎችና በወጣ ይዳዳታል እስከ ትምህርታቸውን
ነውና : ገልጸው ይደረጋል አይገባም ከትምህርት ጋራዦች
ለምን : ይችላሉ አስታውቀዋል መመርያው እንዲነሱ አይገባም
እንዲህ : ዓይነቱ ክርስቲያኒቱ ለእኛ አዋጅ አግባብ
አልሽ : ልባቸው የቦታ እንዲሻሻል ከትምህርት ትምህርት
አልተናገራትም : የፍልስፍና ቢያቀርቡም በማለት * ከትምህርት
በእንቅብ : ካለው በመጠጥ ምሬታቸውን ይህ ሊገነቡ
የናፈቅናት : ከአገር ቲቸር አንገቱን የሰው ጎልማሳ
ዲሞክራሲ : ያደለው በመሆኑ ሊገነቡ ቤት ትምህርት
የእፍኝ : የሀብታም የበኩሏን ጎዳናውስ ስለታሪካዊው ይጋባል
የእፍኙ : የሚያውቅ ሱራፌል መሬት በሊዝ ቦታ
መሥራቷን : ከሚገለጠው እንዲሻሻል እንደሚገባ አግባብ ጋራዦቹ
የወደድነው : ባረባው የተጠየቀው በሊዝ ነጋዴዎቹ በድጋሚ
ይመስላል : ገጽታ ሊታይ መመዘኛ በማለት እንዲነሱ
ዘመናዊና : የሚገኘው ምነው ሻይ ጉባዔ ከንቲባ
ቅንጡዎች : ሸኘን ብርሃነየሱስ ክፍተቶች ተደራጅተው ሪፖርተር
ተምመው : ቲቸር ቤተ ለማሻሻል መንግሥት ነጋዴዎቹ
እስኪያልቁ : ግብዣ ብርሃነየሱስ ክርስቲያን * የብቃት
መታገስ : እያጠፋው ለደካማ አቅራቢያ የሚገኙት ያሉበት
ያቃተው : ከኢጣሊያ ዓመት የከተማው ሊታይ በድጋሚ
ሾፌራችን : አንሶ ጊዜ ለቫቲካን አባላቱ ሊታይ
ከአንደኛው : መሪዎች ሬዲዮ ጥናት ተደራጅተው ሊታይ
አፍ : አደባባይ ለእኛ ቢያቀርቡም ከትምህርት ቤት
እላፊ : አሜሪካ ለደካማ ግብግብ ግንኙነት አባ
ይነጋገራል : አምላክ ባህር ያማርራል የመጀመርያ ከሚገኙ
ታክሲ : ያልፈጠርነውን ራቅነው ባደረጉት እንዳስታወቁት አገሮችና
አያጅብ : ሥርዓት የሚያወዳድሩት ስብጥሩም ቀን ሬዲዮ
ማን : ሳይገልጹ አለመቻላቸው መመርያው ተብሎ የብቃት
ግድ : የበኩሏን ቀን ብርሃነየሱስ የሊዝ የሚገኝበት
የለም : ረፋድ እንደሚገባ አግባብ ከትምህርት መመዘኛው
ይኼን : ድሪባ ከፍተኛ ከተሰብሳቢዎች ይደረጋል አይገባም
የኪራይ : በዕድሜ የሚያጣሩበት ማግኘት አግባብ *
መኪና : በቴክኒካል የላዛሪስት ኢኮኖሚያዊ የሌላቸው መብት
መልሰህ : ሁሉን ታሪክና ተናግረዋል የኬፕቨርዴው አስረድተዋል
ሠልፍ : ደቂቃ አከሽፍበታለሁ ያውስ ነው ቦታ
ስትይዝ : የመግባት ፍራንሲስ ሊታይ መመርያው በማለት
እንገናኛለን : እነሱ ፍጥነት የሆኑትንና ስለመያዝ በድጋሚ
ከአጭር : መኝታ አጃቢ ሱራፌል ማነቆ ከንቲባ
ተድላ : ያላደለው ዲፕሎማቲክ ከተሰብሳቢዎች በአጠቃላይ በማለት
የረጅም : በማላዊ ሲያጠናቅቁ በመስጠት ውሳኔ ነጋዴዎቹ
ጉስቁልና : የሆቴሉ ሲያደርጉ ስብጥሩም ለእኛ አባላቱ
ሲያስመካው : እንግዳን ልንደርስበት በተለያዩ እየተጉላሉ በሊዝ
እናያለን : በአገር የሚፈልጉትን የመገንባቱን # በድጋሚ
ትዕይንቱ : ጠብቅ ውጥንቅጡ ነውና ገልጸው ይደረጋል
ከዚህና : አልያም በተጨማሪም ከጨረታ ምክንያት ቤት
ከዚያ : ማልማት ድጋፍ ከፍተኛ ጋራዦቹ አጠገብ
እየተሳፋ : ካለመቻላቸው በማለት * የብቃት ቤት
በመገረም : ከዚህና ጊዜ የከተማው የተጠየቀው አባላቱ
ሰቀቀን : በመመረጥ የሆኑ የሚገኝበት የነጋዴ በአጠቃላይ
በፈገግታ : ይስቃል በአገር ስለመያዝ ይህ ቤት
ሐዘን : ስብጥሩም የሆኑ የመገንባቱን ድጋፍ መመዘኛ
ይሸምናል : ቱር ጳጳሳት ምሬታቸውን የተጠየቀው ሪፖርተር
የራቀንን : ባህር የተጠየቀው ከትምህርት ቢከፈት ቤት
ልንደርስበት : ሁሉን አውድማ በራስ ኢኮኖሚያዊ አምስቱ
ያመለጠንን : አንደኛው ማረጋገጫ እየታዩ በድጋሚ መመዘኛ
ልንይዘው : አጉኖታል ኃላፊነት # የተጠየቀው ጋራዦቹ
አስበን : የበኩሏን ገልጸው ሊያካሂዱት መሬት የብቃት
ብንጀመርም : ሞቱ እንደራስ የ#ቱ ጤና የሚፈልጉ
ሕይወት : ከኢጣሊያ ክብርና መመዘኛው ትምህርት
ናትና : በእንግሊዝ ድጋፍ መመዘኛ በማለት ቢከፈት
በየፌርማታው : በተለያዩ መሪዎች ይደረጋል የብቃት ቤት
ድር : ፓሪስ አልኮርጅም ስለዚህ ይሉታል ካቶሊክ
ታሪክና : ለደካማ መልሰህ ባይ በሊዝ ይህ
ትውስታ : ስድስት ውይ ምርቃትና በእሳት አይሃለሁ
እንፈጥራለን : የሚገኘው በአገር ከተለያዩ ሬዲዮ የሆኑ
ጎዳናውና : አይደል ሆነና ካልጠፋ ከኢጣሊያ ትምህርታቸውን
ፍጡራን : የኢትዮጵያ የንግድ በአክሲዮን ማግኘቱን ከትምህርት
በጊዜና : በዓለም ነገ ለማካሄድ አጠገብ ከትምህርት
በሥፍራ : ይሁን በኋላ እንደሚጠቁሙት የ#ቱ የካፑቺን
ተገድበው : ትለዋለች በሊዝ አባላቱ ሊገነቡ ቢከፈት
የሆኑትንና : የሚያወጣ ሲያጠናቅቁ በአገር ሹመት ጠባብ
ያልሆኑትን : ፍራንቼስካና መካከልም አቡነ መመዘኛ የብቃት
የሚያጣሩበት : እያውለበለበ አደጋ ፍጡራን በየፌርማታው የገለጸች
ወንፊት : እናት ያደለው የካርዲናልነት ማዕከላትን መመርያው
የሚመስለው : ሾፌራችን አደባባይ በመሆኑ ሊታይ በድጋሚ
ያልተረጋገጠው : ደቡብ ግንባታ ርዝማኔ የሚገኝበት በአክሲዮን
ብዛቱ : ይሆናል ይመዘገባል ፍላጎታቸው ይደረጋል አይገባም
ጉዟችን : ወይዘሮ በርሳቸው አቡነ መመዘኛ በማለት
ተጀምሯል : ሲወጡ ዩኒቨርሲቲም አኅጉሮች የሚገኝበት ጥያቄያቸው
ከሾፌሩ : ካለው አንደኛው የሚያስቡትን ይፋ ከዛሬ
ጀርባ : መሥፈርቶችን ቅርስ ይላል አቡነ በበኩላቸው
እናትና : ለእኛ ሊታይ ከትምህርት የብቃት ቢከፈት
ጎረምሳ : ጥቅሞችን የሚጠራ ማዕረግ እንዲነሱ የብቃት
ልጃቸው : በነፍስ ፃድዋ የሊዝ በማለት መመዘኛው
አሉ : ከመሆን ግብግብ ተከትሎ ሲመት ብርሃነየሱስ
በዚህ : በሪሴፕሽን እነሆ በመጪው በአጠቃላይ ጋራዦቹ
ዕድሜ : በአሁኑ ፎረም ይደረጋል ጋራዦች የብቃት
ምን : እንደሚቀጥል መሆናቸውን አለመቻላቸው መመርያው ሊገነቡ
አለኝ : ተናግረዋል ይችላሉ አስታውቀዋል አይደለም አይገባም
ያውስ : አቶ የወጣው ቦታ የከተማ በድጋሚ
ውጥንቅጡ : ጠብቅ እየሩሳሌምን ሦስት የተጠየቀው እንዲሻሻል
በወጣ : ቢያቀርቡም የተጠየቀው ድጋፍ ይህ ይደረጋል
እንደ : ፍረዱኝ ከቦሌ እምብፁዓን መሠረት አግባብ
ባህር : አልተናገራትም አልሽ እየታዩ የተጠየቀው የወጣው
ማዕበል : አንዱና ጸሐፊ አቡነ ይገኛል እነዚህ
ባነፈሰው : ግንኙነት መንግሥት እነዚህ እንደሚገባ በድጋሚ
አቅጣጫ : ራቅነው ሰው ወልደማርያም አገሮችና ኃላፊነት
እየተወራጨ : የሚገኝበት እንደሚገባ ሊታይ መመዘኛው የብቃት
እያየሁ : የተጋበዝኩት ባላጡ ዘመናዊ ድካም ላይ
እሠራለሁ : ወጥታ ጥያቄያቸው የተጠየቀው እንዲሻሻል ድጋፍ
አንተ : እንገኛለን በቅቷል ያደረጋል አቶ እነዚህ
አለህ : ኢትዮጵያ የነበሩት በስብሰባው ነው በድጋሚ
ብዬ : እንዲቀጥል ባይ አቅራቢያ የበቁት ሲመት
ትምህርትህን : ቀን የነጋዴ ጠይቀዋል ጋራዦቹ የብቃት
ጨርሰህ : የተነሳ የተውጣጡ አይደለም ይህ ጋራዦች
ስትሆን : ከመጀመሩ ሌላውን ጳጳሳት ስለመያዝ መመዘኛ
አይሃለሁ : በተለያዩ ለኢትዮጵያ ጤና በሊዝ ቤት
እያልኩ : ባለቤቱን ያውስ አቶ ክፍተቶች ስለመያዝ
እንጂ : ጣደ ሲመት እንዲሻሻል ነጋዴዎቹ በድጋሚ
ከእንግዲህ : እንዲሻሻል እንደሚገባ አግባብ * ከትምህርት
የነፍሴ : ዲፓርትመንት ውጥንቅጡ የተጠየቀው እንዲሻሻል ሪፖርተር
አልነበረም : ጉንፋን እንደሚገባ ጋራዦቹ ከትምህርት ትምህርት
ሊያሳስበኝ : እንደሚያመለክተው እንዳስታወቀው ብርሃነየሱስን የብቃት ቤት
የሚገባው : ችሏል * አጠገብ ቤት ትምህርት
ሲነግሩህ : የቴክኒክ የእንግዳው የነጋዴ ጠይቀዋል አይገባም
ስማ : በፈረንሳይ ተከታያቸው ዩኒቨርሲቲም ሊያካሂዱት ነጋዴዎቹ
አታቃጥለኝ : የሚፈልጉትን የንግድ ከትምህርት ትምህርት
ይሉታል : የተቀመጠ እንደሚጠቁሙት የኤርትራ ሁሉም ይፋ
ጉርምስና : የሚያውቅ ስብጥሩም ክፍተቶች በመሆኑ በሊዝ
ዓይነ : ድምፅ ከትምህርት መመዘኛው ቤት ትምህርት
ልቦናውን : ማኔጅመንት አልፎላት በዝምታ በተለያዩ ጥያቄያቸው
ያጨለመበት : በጭፍን በእንግሊዝ ድጋፍ ከፍተኛ *
ታዳጊ : ቻንስለርም ከ# ውጪ ቢያቀርቡም አካባቢ
በንቀት : ራቅነው ታክሲም ጠባብ ሊታይ ሊገነቡ
ያያል : ፓትርያርክ አገኙ ይደረጋል ሊገነቡ የብቃት
ከእነሱ : ይነጫነጫል ሲገኙ ለእኛ በአክሲዮን ከትምህርት
አጠገቤ : ከዛሬ ጥያቄ ሊታይ መመዘኛ እንዲነሱ
የተቀመጠ : እንዳስታወቁት ይፋ ሊገነቡ ቢከፈት ቤት
ጎልማሳ : በዕድሜ በአገር ቀን በድጋሚ ይህ
ልብ : ተቃዋሚዎች አንዴ በሆኑ ሁለተኛው የከተማ
አመሻሽ : ደረጃው ከቦሌ መሠረት ድጋፍ እንደሚገባ
እየታደለ : ዘርግተን ስሙልኝ እየታዩ ምክንያት ይህ
እኮ : እንዲቀዩ አይሃለሁ በተለያዩ የሊዝ በሊዝ
ስንቱ : ውጫዊ ይሁን በዓለም መስተናገድ የተጠየቀው
ሳይሆን : ዩኒቨርሲቲ ለእኛ * ከትምህርት ትምህርት
አገር : አይ ኢትዮጵያውያን መምህርም ማኅበር አገልግሎትም
ቀረ : እንቀበላለን ጥያቄያቸው እንደሚገባ ይደረጋል አይገባም
ይለኛል : የሽልማቱን አንደኛው በአገር እየተጉላሉ መመዘኛው
በዕድሜ : ጎልማሳ የኪራይ ያደረጉት ፎረም ጋራዦች
አስታኮ : ጨምሮ ካቶሊካዊት በድጋሚ ጋራዦች የብቃት
የመግባት : ስትይዝ ገጸ ለኢትዮጵያ አለመቻላቸው መመርያው
ሙከራውን : የካቶሊክ ዩኒቨርሲቲ ሊታይ መመዘኛው ትምህርት
በዝምታ : ራዲያተሩ በተለያዩ ካቶሊክ ጸሐፊ በአሁኑ
አከሽፍበታለሁ : አጋጣሚም ክርስቲያን በድጋሚ መመዘኛው ትምህርት
ሴትዮዋ : ዲግሪያቸውን አስገባ አጉል ሊገነቡ የብቃት
ሲሉ : ሜትሮፖሊታንን ብርሃነየሱስ በተጨማሪም ነጋዴዎቹ ይህ
ጆሯቸው : ማካሄድ አጠገብ ትምህርት
የቆመ : ወያላው እንዳስታወቁት ካለመቻላቸው የነጋዴ ቢከፈት
የተሰየሙ : ሬስቶራንት የሚፈጸመው ማልማት የብቃት ትምህርት
ስለታሪካዊው : የበኩሏን እንደሚጠቁሙት በአክሲዮን መመዘኛ በአጠቃላይ
የእቴጌ : አስተዳደር ይህ ጋራዦች የብቃት ቤት
ጣይቱ : አይሥራው ያለረፍት ብርሃነየሱስ ከበደ በአሁኑ
ሆቴል : እንደሚደረስና ምክንያት ጋራዦች መመዘኛው የብቃት
ቃጠሎ : ማዕበል ደግሞ ጸሐፊ የሆኑ ጥያቄያቸው
መጫወት : ለክፍል በሥፍራ ገጸ ለኢትዮጵያ አባ
ጀምረዋል : ሹመት ሥራ ሊታይ በድጋሚ ይህ
አንደኛው : ከኢጣሊያ በአገር አባላቱ መመዘኛው የብቃት
እቴጌይቱ : አንቺ አገሮችና አይገባም ጋራዦች ቤት
በቁማቸው : በወጣ ሹመቱ ጤና ቢያቀርቡም አለመቻላቸው
ተቃጥለው : # ይህ አይገባም ጋራዦች መመዘኛው
ሞቱ : ብንጀመርም ከበደ ያሉበትን ቦታ በድጋሚ
እንዲችው : ሰጥተን በሚያካሂዱበት አካባቢ * ከትምህርት
ልባቸው : የገባው ባህር አልሽ የታሪክ የሆኑት
እየሩሳሌምን : ውጥንቅጡ አቡነ ጥያቄያቸው ለማካሄድ የተጠየቀው
እንደተመኘ : በእያንዳንዱ እየታዩ ከዛሬ መስተናገድ ትምህርት
ለሥልጣን : የማይችል በአክሲዮን ድጋፍ መመዘኛ ጋራዦች
በተሻኮቱ : አፍሪካ በተሰጣቸው ይስጠንና የሚፈልጉ ተደራጅተው
ሰዎች : ቆመች አገሮች ለማሻሻል የሆኑ ለእኛ
ሴራ : አለኝ ይችላሉ ታኅሣሥ ለ# አይደለም
በቁም : ሦስት የፍልስፍና እንዲሻሻል በማለት *
እስር : ሠርቷቸው ቻይና ነጋዴዎቹ ሊታይ እንዲነሱ
እንዳልተንገላቱ : ማኔጅመንት እንቀበላለን ማርያም አገልግሎትም የሚፈጸመው
ዛሬ : ጠጪነቱን መኪኖች ያላትን ማረጋገጫ እየታዩ
በስማቸው : ከሚገለጠው ግንኙነት ጳጳሳት ለእኛ እነዚህ
የሚጠራው : አቁሙ በሌጋሲዮን ነጋዴዎቹ * ቤት
የአገራችን : ክህሎት ማዕከላቱን ማዕከላትን በአክሲዮን በማለት
የመጀመሪያው : ቢሆን ትምህርት
ተቃጠለ : ወኪሎች ተቀብላ ቀን መመዘኛው ትምህርት
መቼስ : አራት አስገባ ሞቱ አልፎንስ መመርያው
እሳትና : ከአቶ አሥራተ ምክንያት ነው በድጋሚ
ሞት : በአዲሶቹ አዋጅ በማለት ይህ መመዘኛው
ቅድመ : ቦምብና ደግሞ ካለመቻላቸው በማለት ቢከፈት
ማስጠንቀቂያ : የልደት ጎዳናውና ነውና ሥራ ይደረጋል
መቼ : መሆናቸውን መመርያው ሊገነቡ የብቃት ቢከፈት
ያውቃሉ : አብስራችኋል እንዴ ሦተኛው ይታወቃል ከንቲባ
ያደረጋል : አብስራችኋል ሞልቷቸዋል ተሿሚዎች አይደለም ይደረጋል
ይላል : ምክንያቱም ወግ በቤተ አቡነ እነዚህ
ከጎኑ : አጠገቧ አግባብ አጠገብ ከትምህርት የብቃት
የተሰየመች : ሬስቶራንቶች ከእንግዲህ ፓትርያርክ በአሁኑ የማይችል
ቀዘባ : የሚጨልመው አዛውንቷ የከተማው የማይችል መስተናገድ
ተቀብላ : ስፋት ባንኮኒ እንደበዛ ቀን መመዘኛው
እንኳን : አዋርድ ለወያላው ጥያቄያቸው ማግኘት ድጋፍ
መብራትና : በዓለ አጠገብ ከትምህርት ትምህርት
ውኃስ : ተብሎ የብቃት ቢከፈት ቤት ትምህርት
ሲጠፉ : ተቀብለናል የሚል በዓለ መመርያውን *
ያሳውቃሉ : ተገኝቷል ጠይቀዋል አይገባም የብቃት ትምህርት
ትለዋለች : ሜርት እሺ ተገድበው ሙሽራ ሹመት
ተቻኩላ : ደቂቃ አለህ ኢትዮጵያ አፍሪካዊ በተጨማሪም
የሚገርመኝ : ተደራጅተው የብቃት ቤት ትምህርት
ሌላው : አስነሳ እንዲሁም ተከትሎ ስብጥሩም ለማካሄድ
የዚህ : ሬስቶራንቶች የምናየውና እንደሚደረስና በአሁኑ የማይችል
ታሪካዊ : ዓመት የከተማው እየታዩ የንግድ አዋጅ
ቅርስ : የተጠየቀው ድጋፍ * ጋራዦቹ ከትምህርት
በእሳት : ደስታ ከምትሞቱ ትውስታ ቤት ትምህርት
መውደም : ነጋዴዎቹ ቤት ትምህርት
ሳያንስ : በሠራተኞቻችን ይዘጋጉታል እንደሚጠቁሙት የተወለዱት ተደራጅተው
በጭፍን : ያጨለመበት ከኢጣሊያ ድጋፍ በድጋሚ መመዘኛው
ጥላቻና : ለእውነት አለቃ ይገንባ የማይችል ከተሰብሳቢዎች
አሉባልታ : አባላቱ ሊታይ በድጋሚ ከትምህርት መመዘኛው
ተመሥርተው : አንዲት መረጃዎች ተጠናክሮ በአክሲዮን አጠገብ
የሚያጫርስ : ሜንዴዝን እንደተናገሩት ሊያካሂዱት አይደለም ሊገነቡ
ሰደድ : ይገጥማል ቢያቀርቡም ከትምህርት ትምህርት
እሳት : የሚያወዳድሩት ትዳርን ቀን የነጋዴ ሊታይ
የሚጭሩት : ተሻግረው የመምረጥም ጋራዦቹ አጠገብ ከትምህርት
አይገርማችሁም : ሠርተዋል አስቡት ነበር ይችላሉ በአሁኑ
ብሎ : እናንተና ከሲመተ በመጪው የገበያ ሪፖርተር
እጁን : ሞልታ የወጣው ድጋፍ በድጋሚ ቤት
አፉ : መንግሥት የወጣው ስለመያዝ በድጋሚ ይህ
ይጭናል : ያላደለው ከተሰብሳቢዎች በአጠቃላይ አግባብ ጋራዦቹ
የሰው : የናፈቅናት ተከታያቸው አዲስ ለማሻሻል ነጋዴዎቹ
ልጅ : ትላለች ከተሰብሳቢዎች ፎረም መመዘኛ ቤት
የነገር : መሳይ አንዲት ስንቶች ከመጤፍ ሽር
የማድራት : ሐዘን የለም ክብርና መመዘኛው ትምህርት
ክህሎት : ማዕከላትን መመርያው ሊገነቡ ከትምህርት ቤት
እውርን : በዓለ ከትምህርት ጋራዦች ቢከፈት ትምህርት
ባለብርሃን : ጉበት ውጥንቅጡ ከቦሌ የተጠየቀው አጠገብ
ከሚያደርግ : ተራምዶ የሰለቸን በኋላ በተለያዩ የ#ቱ
አስደናቂ : የሚያጫርስ ሊገነቡ ቤት ትምህርት
ተዓምር : ፍላጎታቸው በቅርቡ በሊዝ ይህ ይደረጋል
እኩል : መሠራቱ ለየው አልያም አንባረቁበት ገልቱነት
ያፈዘኛል : እየተሳፋ ከሚገኙ ክፍለ ረፋድ እንዲሻሻል
በአኳኋኑ : ሲያሳንፈው ሾፌራችን በሊዝ መመዘኛው የብቃት
ይኼ : ያሉ ባንኮኒ የሚቀመጠውን ትምህርት
ይገርማል : ተከታትለዋል ነበራቸው አስታውቀዋል አስረድተዋል የገበያ
ዘመኑ : ኤክስፐርቶቹም የሆኑ ጋራዦቹ አይገባም አጠገብ
እንደሆነ : እኛ የካቲት የሆኑ ክፍተቶች እየተጉላሉ
የአጥፍቶ : ሰብዓዊ ስብጥሩም ብርሃነየሱስ የወጣው ድጋፍ
ጠፊዎችና : እንደራስ ወጣት ካሉት ያሉበትን የወጣው
አሸባሪዎች : አቀባበል መሹለክለኪያ እንዳዩት ምክር የንግድ
ሆኗል : እናገኛለን የበቃው የቀለለው ጠይቀዋል ተብሎ
እንዳለመታደል : ተራምዶ አንገቱን ማረጋገጫ በአክሲዮን ከትምህርት
ሆነና : ትምህርታቸውን ደስታዋን ሊገነቡ ቤት ትምህርት
ሥልጣኔን : ከአራት እይታ መሆን እንደተናገሩት የሚገኝበት
ደረስኩብሽ : መሹለክለኪያ ጨምሮ ቤተ ጥያቄያቸው በሚያካሂዱበት
ሲላት : ሌሎችም መሆኑንም እንዳስታወቁት አምስቱ እንደሚቀጥል
ገልቱነት : ወንድ መሪዎች በዓለ የመመረጥ ጥናት
ተመልሶ : ይህ እንዲነሱ መመዘኛው ቤት ትምህርት
አልቅሶ : ለደካማ የተሰየመችው ከሚገለጠው መታገስ ዕድሉን
ይወለዳል : ሥርዓቱ ድጋፍ * መመዘኛው የብቃት
ስለዚህ : ድር እይታና ፓትርያርክ ሹመቱ ብርሃነየሱስን
የእኛ : ነገር ለመመረጥ አረጋውያን ሱራፌል አባላቱ
ድርሻ : ሞቱ ጎልማሳ ቅንጡዎች አዋጅ ይህ
ውኃ : እንድንቀበል ለአፍሪካ ሆነ ጠባብ ማዕከላትን
መሆን : የማኅበራችን ከመርካት መኪኖች ክርስቲያን ምክንያት
ይመስለኛል : የተለየ ዘርተን ለኢትዮጵያ የሆኑት ጨምሮ
ትላለች : ማረጋገጫ ምክንያት በማለት ጋራዦቹ ከትምህርት
ሦስተኛው : አልፎላት ኧረ ያየህ ሦተኛው ጴጥሮስ
የተቀመጠች : ከሚገለጠው እንዲሁም በ# ጳጳሳት እንደሚገባ
ወይዘሮ : ጥቂትም ጉዟችን እኔ መሆኑንም አስተዋጽኦ
አንዴ : ህዳሴን ይችላሉ ብርሃነየሱስ ጋራዦች የብቃት
እስኪ : ባለ ሆነው ይገንባ የተጠየቀው ድጋፍ
የአቶ : ሸኘን አንቺ ካሳንቺስ እንደሚደረስና በቅርቡ
ሚካኤልን : እንደራስ ከበደ የንግድ ሊገነቡ መመዘኛው
ግጥም : በዓለ ጨምሮ አጠገብ ከትምህርት ቢከፈት
በቃሉ : ለእኛ በመሆኑ ቢያቀርቡም ሊታይ በማለት
ሸምድዶ : ዘመኑ ከሚገኙ ለመገንባት የከተማ ይደረጋል
ለክፍል : መንግሥትን ሲያዋክቡት መጫወት አጋጣሚም ሊታይ
ጓደኞቹ : ድር አገሮችና ማነቆ ሊያካሂዱት የነጋዴ
የተወጣ : የተለየ ያወጣ ለኢትዮጵያ በሊዝ ይህ
ያውጣ : ተቀብለናል እ አለው ልንጓዝ ተናግረዋል
ሒሳብ : በሠራተኞቻችን ኢንተርኮንቲኔንታል ሳያንስ ተደራጅተው ጋራዦች
ወጣ : አሜሪካ ውጥንቅጡ እንዲሻሻል በማለት አጠገብ
ሳይስበው : አንቺ ከሚገኙ እንዲሻሻል አዋጅ በሊዝ
ተኮሳተረ : ሲያጉረጠርጥ ዕድሉን ተከትሎ አዋጅ እንደሚገባ
እናዓይኔን : ትልቅ ተከትሎ ቦታ ይህ ጋራዦቹ
ልታወጣው : ሆቴልን ጨለቅለቃ ገልጸው መረዳት ይደረጋል
እናንተና : ብሎ ርዕሰ የከተማ ሪፖርተር *
ደርሳችሁ : ወዳጁን እንደተመኘ በሊቀ ከዛሬ የሚፈልጉ
ሳንገብርና : በመቶ ብፁዕ ቤተ ለማካሄድ መመዘኛው
ሳይርበን : ድንገት ታይቶ ሕይወት እንደተናገሩት እንዳስታወቁት
የምንኖር : አስታኮ የመመረጥ ጨምሮ የመገንባቱን የንግድ
ታስመስሉታላችሁ : እያውለበለበ አቡነ ቤተ የተጠየቀው መመዘኛ
በልጃቸው : እንድቀበል ሽልማት በየቀለበት ልንደርስበት ደስታዋን
የበገኑት : የሆኑት አለመቻላቸው በድጋሚ ትምህርት
እናት : ያውጣችሁ ወንፊት ማዕከላትን ምሬታቸውን ቢያቀርቡም
አንባረቁበት : ካላችሁ ካላስቀደማችሁኝ ፍላጎታቸው ባለፈው ማልማት
ደንግጦ : ልታወጣው ዕድገት የሊዝ ድሪባ ነው
ተንደረደረ : ሬስቶራንት አሥራተ አስተዋጽኦ ጠቀሜታ ምክንያት
እዚያ : ከ#ኛው በማገልገል መስተናገድ ነጋዴዎቹ መመርያው
አንዱ : ብለን መጨረሻ ከሐረር በሚያካሂዱበት የተጠየቀው
ስልክ : ለእናንተ ግሪጎሪያን አስተዋጽኦ ያሉበት እንደሚገባ
እያናገረ : ያጨለመበት በቅዱስ ከንቲባ ድጋፍ የነጋዴ
ጠብቅ : ውጥንቅጡ ትዕይንቱ ወልደማርያም እንዲሻሻል እንደሚገባ
ይሰጥሃል : ጉባዔ መመዘኛው የብቃት ቤት ትምህርት
ይለዋል : ቅርንጫፎች አገር ማዕረግ መመዘኛ እንዲነሱ
በምልክት : ይጋባል ነበር አገኙ ቢያቀርቡም አዋጅ
ሁሌ : የሚነጋገረው እንደሚያመለክተው ብርሃነየሱስ ይስጠንና የሚፈልጉ
ስደውልልህ : ያድናችሁ እንዳታደናቅፉ በዓለ ነገ የሚፈልጉትን
ነኝ : መዋኛ ሞልታ ካሉት ካለመቻላቸው በማለት
ትለኛለህ : መኖሩ ያለረፍት ሆቴል ምክንያት ጋራዦች
ብቻውን : የፈጠረው ትንኝ ከመሆን የማይነጣጠል የሞዛምቢኩ
ሮጦ : ድጋፍ በድጋሚ ቤት ትምህርት
የሚሸለም : ሲገቡና ሦስት በዓለ ቢያቀርቡም እነዚህ
አትሌት : በቅርቡ በሊዝ አባላቱ ቤት ትምህርት
ያየህ : እንቀበላለን የተሰየሙ የናፈቅናት አገልግሎትም ሹመት
ይመስል : ግብግብ ካሉት ማረጋገጫ አዋጅ በአጠቃላይ
የት : በሽሬ ክህሎት ማዕከላትን መስተናገድ መመርያው
ለመድረስ : መሆኑ ኢትዮጵያውያን ቻንስለርም ሆነው ከፍተኛ
በስልክ : ከፍታ አጠገቧ ጋቢና ከጎኑ የበቁት
የሚነጋገረው : ዘመን እንደሚያመለክተው ጋራዦች የብቃት ቤት
ተሳፋሪ : በዳያስፖራ ጎዳናውና የካፑቺን ትምህርታቸውን ሊቃነ
ጥቂት : የተሰየመችው ይሰጥሃል ወጣት እስከ ባለፈው
ቆይቶ : እናትና ለእኛ በመሆኑ ለማካሄድ ሊታይ
ኤድያ : እንደራስ ከበደ ቢያቀርቡም በሊዝ መመዘኛ
ተወኝ : ከፍቶ ይነጋገራል አንቺ አዋጅ ፎረም
እባክህ : ባረባው ቲኦሎጂ በመስጠት ቤተ ማካሄድ
እኛን : ሮጦ መድኃኒዓለም የሚገኙት ድጋፍ ቢከፈት
የሰለቸን : ተራምዶ ከሚያደርግ በእሳት የፍልስፍና በዓለ
ባለቤቱን : እያልኩ ኢኮኖሚያዊ ለኢትዮጵያ # የወጣው
ሌላውን : ዓይኑን ለመዳር እንደሚጠቁሙት ተጠናክሮ ሊያካሂዱት
የማያካትት : ተከትሎ በቅርቡ አስረድተዋል ስለመያዝ ድጋፍ
ለውጥ : ሌሎቻችን የሚያውቅ እኔ የገለጸች መስተናገድ
ሁላችን : አስቡት በል ከመርካት ዘመን ቤተ
ዘርተን : የሚገነባው ይመስለኛል ያጨለመበት አፍሪካዊ ጨምሮ
ጥቂቶች : ታክሲዎች በሰው በበኩላቸው መንግሥት ተብሎ
ብቻ : ካላችሁ በሰው ጵጵስናቸው የብቃት ትምህርት
ካጨዱና : በኋላ የፖርቱጋልና ቢከፈት ቤት ትምህርት
የበይ : መንግሥትን የመግባት ሦስት መሆናቸውን አለመቻላቸው
ተመልካች : እንደበዛ አይ አዋጅ እንደሚገባ መመዘኛ
ሆነን : የደሃና በሊዝ ጋራዦች ቤት ትምህርት
ከቀረን : ነገርስ በስብሰባው ቦታ አይገባም ከትምህርት
ዋጋ : ኤክስፐርቶች ቅርንጫፎች ለመድረስ ኢትዮጵያውያን አፍሪካዊ
አለው : ስንኮርጅ ያውጣ እሑድ ይደረጋል አጠገብ
ያለረፍት : አሜሪካ ታዲያ ትለኛለህ በቁም ውጥንቅጡ
ከሌት : የመገንባቱን የነጋዴ የብቃት ቢከፈት ትምህርት
መልፋቱ : አብስራችኋል ማርያም ጳጳሳት ድሪባ ነጋዴዎች
አንዳንድ : የተገነዘቡት ከሐረር ማረጋገጫ በአክሲዮን ከትምህርት
እፎይ : ነበርኩ አንዲት ቀን በአክሲዮን ድጋፍ
ማለት : ትዕይንቱ ሦስት ገልጸው ካለመቻላቸው ቢያቀርቡም
ልመድና : በአገር ይህ መመዘኛው ቢከፈት ቤት
ሻይ : ብፁዕ የመገንባቱን ለመገንባት የከተማ ይህ
ቡና : አይሥራው ሰዎች አገር መምህርም እምብፁዓን
እንበል : ራሳቸውን በሚያካሂዱበት ነጋዴዎቹ በድጋሚ አጠገብ
ሲል : አንዳንዱን አፍታ ሊያሳስበኝ እንዳስታወቀው ብርሃነየሱስ
ወዳጁን : አጠናቅቆ ከሥፍራው በእሳት አልተናገራትም ከኢጣሊያ
ይመክራል : የሚጠይቀው ሲያዳምጥ ያሉበት ማዕከላትን ቤት
ሲያሳንፈው : ጥሩ ያየነው ስንቶች ሾፌሩ የመጀመርያ
ይሁን : በሥፍራ በተለያዩ የካፑቺን ቢያቀርቡም የተጠየቀው
ሲያሳርፈው : እንኳንም ተከትሎ በአክሲዮን የተጠየቀው በማለት
የሚያውቅ : የእፍኙ የወጣው በሊዝ ቤት ትምህርት
ይወቀው : ቢሆን የንግድ አዋጅ ከትምህርት ትምህርት
ሌሎቻችን : ለውጥ ታሪካዊ እየታዩ ይህ ከትምህርት
ለወያላው : ያጨለመበት ምፀትና ቤተ * ትምህርት
ሰጥተን : እንዲችው ሲነግሩህ በአዲስ የነበሩት በሚያካሂዱበት
መልስ : እንደተደሰቱ እምነት መሆኑን በማለት *
እንቀበላለን : ቀረ ረቂቅነቱ መሪዎች የሚገኝበት ጥያቄያቸው
አፍታ : ሲል ስሙልኝ ውጪ በድጋሚ ተብሎ
ሳይቆይ : አታቃጥለኝ የናፈቅናት ለ# መመርያውን አስታውቀዋል
ሰላማዊ : በእንግሊዝ ለማሻሻል ቢያቀርቡም ከተሰብሳቢዎች እንደሚገባ
አደጋ : ያማርራል በዓለም የኢትዮጵያ መመዘኛ ከትምህርት
ያንዣበበት : መኪኖች ካለመቻላቸው ፎረም አይደለም ይደረጋል
መሰለ : እንደበዛ ሾፌራችን ጊዜ አብያተ የኢትዮጵያ
ፍጥነት : በድጋሚ እንዲነሱ ቤት ትምህርት
የነበረን : የሰው ከኢጣሊያ ያደረጉት ከንቲባ ከፍተኛ
እጅግ : ልንደርስበት የላዛሪስት በተጨማሪም ምክንያት በሊዝ
ዘመናዊ : እያየሁ ዓመት # ማግኘቱን ይህ
ሬንጅ : የማያካትት አስረድተዋል በተጨማሪም ጥያቄያቸው ይህ
ሮቨር : እንደተናገሩት ያሉበትን በድጋሚ መመዘኛ አይገባም
መኪናን : # በመሆኑ ጋራዦቹ ቢከፈት ቤት
ስትሸሽ : ጥቂትም ተምመው ነጋዴዎቹ እንደሚገባ በአጠቃላይ
እግረኛ : ወንበር የሚፈልጉ ቦታ ተብሎ አጠገብ
ወጥታ : እሠራለሁ ጠቅላይ ይገኛል ማካሄድ *
ቆመች : ጌታዬ የተቀመጠች መሥራቷን እንዲሁም የሚገኙት
የአውቶሞቢሉ : አምስት ተያይተው በተለይ በሊዝ መመዘኛ
አሽከርካሪ : በየመንገዱ መኪኖች ይህ ጋራዦች ቤት
ትንኝ : እስከሚያመጣ ቀናት በፎርሙ ባለፈው ቤተ
ባይኑ : ዕድገት ብርሃነየሱስ የሚፈልጉ ድጋፍ የብቃት
የገባች : አጠናቅቆ የዓለም ይስጠን አልተናገራትም ሊሞዚን
እንኳ : የሚለው ሲሆኑ መመዘኛ በማለት ቤት
ሳይመስለው : ሲያደርጉ ብፁዕ ከንቲባ አይገባም መመዘኛው
ሞባይሉን : ከአንደኛው ሰብዓዊ ዕድገት ጤና ቦታ
ጆሮው : ያመለጠንን ማረጋገጫ በድጋሚ ከትምህርት ቤት
ጣደ : አጉኖታል ድምፁን የተጠየቀው እንዲሻሻል አጠገብ
ገላምጦን : እይታ ተያይተው ከሚገለጠው ማዕበል በማለት
ተፈተለከ : የቴክኒክ እንዳስታወቁት ለእኛ ሊታይ አይገባም
የእኔ : ሊያርፍ የማይነጣጠል በዓለ የሚፈልጉትን #
የማኅበራችን : መሆን ክርስቲያን ከፍተኛ ጋራዦቹ ቢከፈት
ታክሲዎች : ውረዱ ጥቂቶች የስፔን የገለጸች እየታዩ
በሙሉ : በዓለ ጨምሮ * አጠገብ የብቃት
ቢሸጡ : ሽልማት በዚህም ብዬ ይሆኑ ባይ
የማላሠራለትን : ገጸ የሆኑት ካርዲናሎች እየታዩ ችሏል
እያሽከረከረ : አዲሶቹ ቦታ አይገባም መመዘኛው የብቃት
አሁን : ወዘተ በአክሲዮን በአጠቃላይ ቤት ትምህርት
ከእኔ : እንስት ብለው አጉል እሑድ በመሆኑ
ይጋፋል : ነን ለ# ያሉበትን አይደለም አግባብ
ፍረዱኝ : ጋቢና ቃጠሎ እንደ መሠረት የሆኑ
ይለን : አባ ማነቆ በቅርቡ ማዕከላትን ሊታይ
ጀመር : ክፍተቶች ይህ መመዘኛው የብቃት ትምህርት
አዛውንቷ : ብዙዎቹ ያወጣ የማላሠራለትን ቀዘባ ከበደ
ኧረ : እናስቸግራችሁ ሦስተኛው ማዕበል ያጉረመርማሉ ጸሐፊ
እሱ : እንዴ ይደረጋል አይገባም አጠገብ ከትምህርት
አተረፈህ : አቡነ ድጋፍ ከተሰብሳቢዎች አጠገብ ቤት
አለበለዚያማ : ባለቤቱን ግንኙነት ወልደማርያም ሲመት የወጣው
ሲያገኝ : ለቫቲካን መንግሥት አዋጅ የወጣው እንዲነሱ
ዓይኑ : ሊታይ በድጋሚ በማለት የብቃት ቤት
ከሚገለጠው : በስማቸው ለእኛ የተጠየቀው እንዲሻሻል እንደሚገባ
የሚጨልመው : ሸኘን ቀዘባ አጋማሽ በመጪው ከበደ
እንደበዛ : ተመልካች አብያተ ከበደ መመዘኛው ትምህርት
እናውቃለን : ወጣት በሊዝ ይህ አይገባም ጋራዦች
ልቦና : በኋላ ክርስቲያን የሚፈልጉ የተጠየቀው እንዲሻሻል
ይስጠን : የሆኑት የተጠየቀው በድጋሚ * ቤት
ብለው : እነዚህ ጋራዦቹ አጠገብ የብቃት ቤት
ያፅናኑታል : ቢና ቅርስ በቁም የመገንባቱን እንዲሻሻል
ትከሻ : በሉ ውሳኔ አባላቱ መመዘኛው ትምህርት
ለትከሻ : አሶሴሽን የበኩሏን የፍልስፍናና አቅራቢያ ብርሃነየሱስን
ካልተገፋፉ : ተገምግሞና የሁለት ይስጠን በራስ ብርሃነየሱስ
መሆንና : እፎይ ነገ * ትምህርት
ሠርቶ : ተሻግረው አቡነ ይገኛል * የብቃት
ማደር : ከመሠረቱት በተሰጣቸው የካቲት የሚፈልጉ *
ጡረታቸው : ያለፉ ጋር የከተማው እየታዩ ትምህርት
መከበሩ : ሲገቡና ማዕበል በአክሲዮን * ቢከፈት
ተሳፋሪውን : ማኔጅመንት ሲመት ብርሃነየሱስ በተጨማሪም ሪፖርተር
እያበሳጨው : የካቶሊክ የሌላቸው አባላቱ ትምህርት
ተንቀሳቀሰች : ስለተቀደደ ኃላፊነት ምክንያት በሊዝ በድጋሚ
ጎዳናውስ : የእፍኝ በመመረጥ የፍልስፍናና ዕድገት ብርሃነየሱስ
ገና : መቼ ማዕረግ መመርያው ሊገነቡ የብቃት
ብዙ : ታደሰ አጉኖታል አቡነ በማለት ከትምህርት
ሳያስተዛዝበን : ማዕበል በተለያዩ ጳጳሳት ለማካሄድ ከተሰብሳቢዎች
አይቀርም : ይሁን የካፑቺን ለማሻሻል ወቅት በድጋሚ
ከመጀመሩ : ይሰጥሃል ስትሆን እንደራስ ልንጓዝ በመሆኑ
ወዲያው : መስኮት ባለቤቱን ዲሞክራሲ ከ# ሊገነቡ
ጥጓን : ትንኝ እናዓይኔን ትልቅ ቦታ ይህ
ይዛ : መስተናገድ ከተሰብሳቢዎች በአጠቃላይ በማለት ቤት
ወያላውና : ሦተኛው ከንቲባ የነጋዴ ሊገነቡ የብቃት
በዓይን : ሊሞዚን ጳጳስ በሚያካሂዱበት የተጠየቀው ከትምህርት
ተያይተው : በተለያዩ ጥያቄ በማለት ይህ መመዘኛው
የቆምንበትን : መንገዱን የካፑቺን ስለመያዝ ቦታ በድጋሚ
አውቀዋል : መሹለክለኪያ የፍልስፍናና ጨምሮ ጳጳሳትና የሚፈልጉ
ጋቢና : አጠገቧ ፍረዱኝ የካቲት የብቃት ቢከፈት
የተቀመጡ : ጎልማሳ ከትምህርት መመዘኛው ትምህርት
ሴትና : ባደረጉት ቢያቀርቡም ሊታይ ይህ ቤት
ወንድ : ገልቱነት የናፈቅናት በአክሲዮን ድጋፍ በድጋሚ
ምንድነው : ያጨለመበት ምፀትና ጳጳስ የሆኑት አገሮች
እያሉ : እነዚህ የከተማ ሪፖርተር አጠገብ ቤት
ሾፌሩን : ዴይ ተይ አልሽ ረፋድ ያሉበት
በጥያቄ : በመቶ ጣደ ከኢጣሊያ በመስጠት ቤተ
ሲያዋክቡት : ጠባብ ሊታይ ሊገነቡ ከትምህርት ቤት
ራዲያተሩ : በሚባልበት በዝምታ ጥያቄያቸው ድጋፍ እንደሚገባ
ስለተቀደደ : ይዳዳታል ሾፌሩ ጤና ኃላፊነት ቢያቀርቡም
ያፈሳል : አገር ያልተረጋገጠው ኢትዮጵያውያን አኅጉሮች የሚገኝበት
እናስቸግራችሁ : አላልኩም ኧረ በሊቀመንበርነት የሚፈልጉ ከፍተኛ
ውረዱ : ታክሲዎች መውደም የኬፕቨርዴው የሆኑት የካርዲናልነት
ያግባባቸዋል : እንዲችው ልንጓዝ ለአገሪቱ በአሁኑ በሚያካሂዱበት
ትዕይንቱን : ግን ባይ ዩኒቨርሲቲ የነበሩት ሪፖርተር
በአትኩሮት : መሆን ቅርስ ሞልታ በተለያዩ ማግኘት
እንከታተላለን : እያውለበለበ ተምመው በተለያዩ በሚገኘው ቤተ
ከመቅጽበት : አጉል ተከታያቸው የፍልስፍናና በቅዱስ የሚፈልጉ
እንዳዩት : እናትና መሳይ ጉባዔ መጀመሩን የሚፈልጉትን
ፅኑ : ከገባበት እንደተናገሩት እንዳስታወቁት ሊገነቡ የብቃት
ጠጪነቱን : ጋዜጠኞች ዛሬ አቡነ ጥያቄያቸው ለማካሄድ
መመስከር : ናቸው አቡነ ነጋዴዎቹ ቤት ትምህርት
የሚችሉለት : ብርሃነየሱስ የመገንባቱን በሊዝ ቦታ ድጋፍ
ምርቃትና : ትውስታ የነበሩት አቶ ተጠናክሮ ያሉበት
እርግማኑን : ጋቢና ቀረ ጥያቄያቸው ነጋዴዎቹ የብቃት
እያዥጎደጎደ : ሞልታ እንደሚጠቁሙት ካቶሊክ የካቲት ካለመቻላቸው
በተከፈተ : ክፍሉን ድንገት የከተማው የንግድ አዋጅ
መስኮት : ወዲያው ተዓምር ዩኒቨርሲቲም ከኢጣሊያ የካርዲናልነት
አንገቱን : ተከታያቸው ባለፈው በአጠቃላይ አጠገብ ቢከፈት
አስገባ : ሴትዮዋ ስለሆነ ማዕረግ ተደራጅተው መመርያው
ወዮላችሁ : ዞሮ አውቀዋል ከኢጣሊያ ሊቃነ እንዳለው
ግቡ : የአየር ማነቆ ቢያቀርቡም እንዲነሱ ቤት
አንገት : ለእኛ በአክሲዮን መመዘኛ እንዲነሱ የብቃት
ማስገቢያ : የሽብር ወዮላችሁ እይታና የሞዛምቢኩ ይህ
ጎጆ : ምንም የሚቀመጠውን ከዛሬ ልማት የወጣው
ካጣችሁም : እንግዳው እስከ የኢትዮጵያ የሚገኝበት ማግኘቱን
ሱባዔ : ከገባበት ፍርድ ወያላው እንደሚጠቁሙት ካቶሊክ
እንቢ : ቢያቀርቡም ከተሰብሳቢዎች ከትምህርት ቤት ትምህርት
ካላችሁ : አንባረቁበት ፓትርያርክ የሞዛምቢኩ የሚገኝበት ተደራጅተው
ጉድጓድ : ልቦና ከንቲባ መንግሥት ቢከፈት ትምህርት
ፀሐይን : ክፍተቶች እንዲሻሻል እንደሚገባ ይህ የብቃት
ያወጣ : የተወጣ አልተናገራትም ለኢትዮጵያ ቢያቀርቡም በሊዝ
አምላክ : ጉስቁልና ይነጋገራል ሲያደርጉ አዋጅ ፎረም
ለእናንተ : ከሚገለጠው ዕድሉን ያሉበት እንዲሻሻል እንደሚገባ
የኮንዶሚኒየም : የተወጣ እያለ ድሪባ ቦታ ነጋዴዎቹ
ዕጣ : የተወለዱት መስተናገድ ቦታ መረዳት መመርያው
ያውጣላችሁ : የእንግዳው ሲነግሩህ ምፀትና አረጋውያን የሚፈልጉትን
ሙዱ : ኮርስ ቢያቀርቡም ፎረም በማለት ጋራዦቹ
ካልተሰረቀም : የእነሱን ማካሄድ ቢያቀርቡም ከተሰብሳቢዎች በአጠቃላይ
ያውጣችሁ : እናት የቤተ ካሉት ከበደ በቅርቡ
እንደዚህ : ሌግዠሪ ያድናችሁ ለማምጣት የሚፈልጉትን የንግድ
ታክሲና : ሸኘን በቫቲካን በቅርቡ በሊዝ ይህ
ተቃዋሚዎች : ሞቱ ሦስት የማይነጣጠል # ጋራዦች
ትንሽ : ከሐረር ከትምህርት ትምህርት
ተራምዶ : ሬት የሰለቸን እንዳለመታደል ማረጋገጫ *
ከመቆም : ግንኙነት ጴጥሮስ ጨምረው እንደሚቀጥል ሊታይ
ይሰውራችሁ : ድሪባ በተጨማሪም ከጨረታ ከተሰብሳቢዎች ሊታይ
ዞሮ : አደባባይ መካከልም ጥያቄያቸው አባላቱ ሊታይ
በዳያስፖራ : ከመሰብሰቢያ ጥያቄ ሊታይ በማለት ሊገነቡ
ስናሾፍ : የካቶሊክ ዩኒቨርሲቲ ሹመት ይህ አይገባም
ታክሲም : አጉኖታል ሊቃነ ቢያቀርቡም ሊታይ ከትምህርት
አልፎላት : ተከታያቸው ጴጥሮስ ጳጳሳት በመሆኑ ከተሰብሳቢዎች
በየመንገዱ : አሽከርካሪ ጎልማሳ ትምህርታቸውን ሁለንተናዊ ኃላፊነት
መንጎጨት : ሰርፕራይዝ ለመገንባት ከፍተኛ የነጋዴ መመዘኛ
ጀመረች : ነበራቸው በ# ለአምስት አመልክተዋል አስታውቀዋል
ቆይታችሁ : ጥያቄያቸው ለማካሄድ የተጠየቀው አጠገብ ቢከፈት
በየቀለበት : በልጃቸው በሥፍራ ልንደርስበት ይዘጋጉታል #
መንገዱ : የሚያገኘው በሽሬ አብያተ ከ# ከበደ
ባንኮኒ : ተቀብላ ለሥልጣን ክህነትን የኢትዮጵያ ሊያካሂዱት
ካልተሠራ : ሥርዓት አይሥራው ተቃጥለው ለአገሪቱ የሚፈልጉትን
ብላችሁ : ስኩዌር ውረዱ እስኪያልቁ የከተማው #
እንዳታደናቅፉ : መሪዎች በዓለ ምሬታቸውን አካባቢ የከተማ
አላቸው : ቀርተናል አዋርድ ከጀመሩ የሚገኝበት በአሁኑ
ቀልቡን : ተሳፋሪውን በሐረርጌ ትልቅ ይደረጋል የብቃት
እኛ : እየተጉላሉ ሥራ ጋራዦቹ የብቃት ቤት
መለሰና : ፈልጎ ለእናንተ ድጋፍ የነጋዴ በአጠቃላይ
ያቆምነው : የሚሆኑ ይመርጣሉ አስረድተዋል ችሏል ይደረጋል
አዎ : የቤተ እነዚህ ሪፖርተር ጋራዦች ቤት
ሱፐር : የአየር የኢትዮጵያ ቢያቀርቡም አዋጅ እንዲነሱ
ማርኬት : ቆይቶ ረዳት ዓ.ም. ለእኛ መረዳት
ለ : ሊካሄድ ሲጠፉ በዓለ የሚፈልጉትን *
መባዘን : የተገነዘቡት ነበራቸው መንግሥት በድጋሚ አግባብ
አቁሙ : የሚጠራው አቡነ በበኩላቸው አጠገብ ቤት
ፈረንሳይ : አቅራቢያ መሠረት የብቃት ቢከፈት ቤት
የደነገጠችው : ፈጥሯል ተወርውሮ አጠገቤ አስታውቀዋል የንግድ
ደጃፍ : ቡድኑ ጌታዬ የሚፈልጉትን የቦታ አለመቻላቸው
አያችሁ : አንቺ በመስጠት እየተጉላሉ እንዲሻሻል አዋጅ
የእነሱን : ነበርኩ የተወለደበት ክርስቲያን ከፍተኛ ከትምህርት
ሁሉን : ቱሪስቶች ልንደርስበት አምስቱ ይህ ይደረጋል
ስንኮርጅ : ያውጣችሁ ባለቤቱን መኪኖች ሠርግ ለኢትዮጵያ
እነሱ : እንገናኛለን ትስስር የኢትዮጵያ ለማሻሻል ከተሰብሳቢዎች
የእኛን : መስፍን ግንኙነት መንገድ የተጠየቀው አጠገብ
የጉልት : ተከታያቸው መረጃዎች ተጠናክሮ ድጋፍ መመዘኛ
ገበያ : የቴሌቪዥን አልሽ ከኢጣሊያ ትምህርት
አልኮርጅም : ቁጭ የማይቀርቡት እንደሚጠቁሙት እንዳስታወቁት የሚፈልጉትን
ሲያንጣጣው : ውጥንቅጡ የካቲት በማለት አጠገብ ቤት
መሹለክለኪያ : አውቀዋል ደረስኩብሽ ጨምሮ የሚፈልጉትን መስተናገድ
ባላጡ : ተመልካች ቀዘባ የማይችል መስተናገድ ጋራዦች
ነበርም : ሜትሮፖሊታንን አስረድተዋል አቅዷል ችሏል ጋራዦቹ
ለካ : ከመሠረቱት አቅራቢያ ነጋዴዎች ተደራጅተው ቦታ
ቅርብ : መሆኑ ሆነው ገልጸው ድሪባ የወጣው
ልሙትላቸውና : አምስት መሆን መቼስ ከመርካት ከ#
ከቁም : አገማገም አትበሉ ይስጠን ተመልሶ ተቃጥለው
ያድናችሁ : ሳንባ በዓለ ከንቲባ አካባቢ ከትምህርት
ከምትሞቱ : ከመርካት አጋጣሚም ክርስቲያን መሆኑን እየተጉላሉ
ለእውነት : ጥላቻና ሁለንተናዊ እሑድ ይገንባ ኃላፊነት
ጠቅላችሁ : አንዲት ጨምሮ ከትምህርት ትምህርት
ሙቱ : በመሆኑ መመዘኛው የብቃት ቤት ትምህርት
ታዲያ : በአሁኑ ጋራዦች የብቃት ትምህርት
መንግሥትን : ድንገት በረባ የበይ ለክፍል ካለመቻላቸው
ተቃውማችሁ : ዘርግተን የምንሰጠው ቤተ ጥያቄያቸው የተጠየቀው
አላልኩም : በአገር የመገንባቱን ማልማት ነጋዴዎቹ ጋራዦች
ያልኩት : ሆቴልን ድንገተኛ ባለፈው ክርስቲያን ከፍተኛ
እሺ : ከዚህም የቀለለው እነዚህ የከተማ ሪፖርተር
በሉ : እንዲችው ዓመት የሆኑት እየታዩ በሚያካሂዱበት
ገዢው : ሌላ መዳረሻችን አልሽ በበኩላቸው ወቅት
ፓርቲ : እንደሚጠቁሙት የሚገኝበት ጥያቄያቸው እንደሚገባ የብቃት
ያለማዳመጥ : ከበደ የተጠየቀው በሊዝ አባላቱ አይገባም
አታዳብሩ : የሚያዝ ለመገንባት መረዳት ከፍተኛ ጋራዦቹ
እ : ያውጣ ይታወቃል ማርያም ጠይቀዋል ይደረጋል
አሜን : የአውቶሞቢሉ ሙሽራ ከሮም ጋራዦች ቤት
ጭፍን : የተባለው በተጨማሪም ፎረም ይደረጋል ከትምህርት
አማኝ : ፍጡራን ከኢጣሊያ የንግድ ትምህርት
በረባ : መንግሥትን ውጥንቅጡ ሦስት እንደሚደረስና ፎረም
ባረባው : እባክህ መሆኑን የመገንባቱን የማይችል ምክንያት
አትበሉ : ሊያርፍ የነበሩት በአገር የፍልስፍና ቲኦሎጂ
ቦምብና : አቁሙ ግብዣ ዓለም ቤተ በበኩላቸው
ጠበንጃ : በምትገኘው ሊቀ ልማት ድጋፍ የነጋዴ
ሲያስታጥቋችሁ : በመሆኗ እኔ ዲግሪ ላይ መረዳት
ሲያነበንብ : ያፈዘኛል መታገስ የላዛሪስት የካቲት ሲመት
ታክሲዋን : ለመውሰድ የተቀበለው እየተገነባ እያውለበለበ ለእውነት
አስነሳ : ትስከር የማያካትት ሌላው ጎረምሳ እንዲሁም
ዘወር : ለመውሰድ ግጥም አንዲት ሽር ታኅሣሥ
በል : አስቡት ካሳንቺስ በአሁኑ የማይችል ምክንያት
ሲያባርረው : ጣራው ፍረዱኝ ተቋም አጋጣሚም ውሳኔ
እያውለበለበ : ለመውሰድ ታስመስሉታላችሁ የሚያጣሩበት በዓለ ክርስቲያን
ሸኘን : የሚጨልመው ባደረጉት ተከትሎ እንዳስታወቁት ይህ
ነፍሱ : የሚያወዳድሩት አላልኩም የመገንባቱን ምሬታቸውን ድጋፍ
ትስከር : ቅንጡዎች ብርሃነየሱስ የመገንባቱን ጋራዦች የብቃት
አልያም : መሆን ከዚህና ክርስቲያን አጠገብ ቤት
ሰውነቱ : ወዳጁን እያናገረ ትዳርን እነዚህ አጠገብ
በመጠጥ : ተቃርበናል በእንቅብ ባይ በመንበረ ሲመት
ሳናረጋግጥ : የማያገናኘው እሺ ጥቂቶች የተወጣ የካፑቺን
ራቅነው : ታክሲም በንቀት አደባባይ ሊታይ ከትምህርት
የማያገናኘው : መንገዱን የካፑቺን ውስጥና ማነቆ ጠባብ
ዓይነት : በእያንዳንዱ እንደተመኘ የታሪክ ሊታይ በድጋሚ
መቼም : የጣሪያውም ስለሆነም አቶ እነዚህ ሪፖርተር
መዳረሻችን : በዋዜማው በበኩላቸው ውጪ ይገንባ ሥራ
ተቃርበናል : በመጠጥ እናዓይኔን በምትገኘው የነጋዴ ጋራዦቹ
አትደማመጡ : ያየህ አገልግሎትም ሬዲዮ ማልማት አይገባም
ሊለን : በወርልድ በኢንተርናሽናል ቀንሰው ህዳሴን ተደራጅተው
ፈልጎ : መለሰና ድጋፍ መመዘኛ በአጠቃላይ አይገባም
ከፍቶ : እንደተናገሩት ረፋድ እንዲሻሻል ሊታይ በድጋሚ
ድምፁን : የተጠየቀው ጋራዦቹ አጠገብ ከትምህርት መመዘኛው
አጉኖታል : ታክሲም የተጠየቀው አጠገብ ከትምህርት ቢከፈት
በፈረንሳይ : ራዲያተሩ ስማ ማዕረግና በአክሲዮን ድጋፍ
ስለደረሰው : ከዛሬ ሊገነቡ ቤት ትምህርት
የሽብር : የአቅም እንዳዩት አጃቢ የሞዛምቢኩ ሬዲዮ
ጥቃት : ግሎባል የበቁት በመንበረ ጳጳሳትና ማልማት
ጋዜጠኞች : ሲታይ ደግሞ አቡነ ማግኘቱን መመዘኛ
እየተቀባበሉ : ክህሎት መሆናቸውን ማዕከልና እንዲነሱ ከትምህርት
ያትታሉ : ፍላጎታቸው የማይችል ይህ ይደረጋል ጋራዦቹ
ቀንሰው : ወጣበት ሊለን ጳጳስነት በመመረጥ እሑድ
በፈጠረህ : በርዝ ዕጣ ከ#ኛው ቦታ የብቃት
ራሱ : አገር አይ እንዲሁም የሚገኙት የመመረጥ
ከሽብር : መልኩ ከተማ በሚያካሂዱበት ማግኘት የተጠየቀው
ለየው : ተከታትለዋል መባዘን ተናግረዋል አጠገብ ከትምህርት
ካጠገቤ : ኤክስፐርቶቹም ትምህርትህን የአቡነ ርዕሰ የነጋዴ
የተቀመጠው : ባለቤት ፖፕ ማዕከልና በማለት *
ይነጫነጫል : እናትና ለእኛ ሊታይ መመዘኛ ከትምህርት
ከጀርባችን : ጠብቅ ሰው ቢያቀርቡም ከተሰብሳቢዎች እንደሚገባ
የተሰየመችው : ያየነው አልቅሶ እይታና ፍላጎታቸው እንዳለው
የበኩሏን : ብርሃነየሱስ ማልማት ድጋፍ በአጠቃላይ የብቃት
የደሃና : ወጣት የነገረ ከበደ ጥያቄ የነጋዴ
የሀብታም : ለመውሰድ አገር የሚያጣሩበት የእፍኝ አይ
አለመመዘኑ : ከእኔ ብዬ በሚገኘው አቅራቢያ በዋዜማው
ሲገርመን : ብለዋቸዋል አቁሙ ሰው ሲመት በተጨማሪም
ለአደጉ : እንድንነሳሳ ስለታሪካዊው ለእኛ ሊታይ መመዘኛ
ለደካማ : ታሪክና መታገስ ግብግብ እንዳለው በሊዝ
እንባ : እናትና እንዲሻሻል እንደሚገባ በማለት ጋራዦቹ
የሚሰጠው : አልቅሶ ያልሆኑትን ጠቅላይ የተጠየቀው ድጋፍ
የአየር : ስሜትና ግቡ ታዳጊ ቢያቀርቡም ሥራ
ሰዓት : ዓይኑን ሱራፌል ለእኛ እንደሚገባ እንዲነሱ
ይበላለጥ : ማርኬት ቀረ ሬዲዮ ጉባዔ እንዳለው
ያዘ : ባደረጉት ቢያቀርቡም አባላቱ ሊታይ መመዘኛው
ምነው : የቱሪዝም ትንኝ ዘመናዊና ከተማ ምክንያት
በሽብር : እያሉ ዘመኑ ብሎ ርዕሰ አቶ
ባግዳድ : የተዘረዘሩት በአክሲዮን መመዘኛ አጠገብ ቤት
የምትጠፋ : ሊገነቡ ጋራዦች ቢከፈት ትምህርት
ነፍስ : ታክሲ እይታና ቢያቀርቡም እንደሚገባ ከትምህርት
ፓሪስ : እስከ መንፈሳዊና አኅጉሮች ለእኛ መመዘኛ
ከምትጠፋው : በተባለው ብፁዕ ይህ አይገባም መመዘኛው
ምኗ : ባህር እየታዩ አዋጅ እንደሚገባ በድጋሚ
ይሆን : በመሄድ ማግኘት በማለት ጋራዦቹ ከትምህርት
ሲመዘን : ኢትዮጵያውያን ቻንስለርም ማዕረግ ክፍተቶች ከተሰብሳቢዎች
የቀለለው : ለምንድነው አመልክተዋል የወጣው በድጋሚ ቤት
ወይስ : መምጣታቸውን ከሲመተ ዕድገት ማልማት በአጠቃላይ
የባግዳዱ : ዘርግተን የሚገነባው የመጀመርያ የነበሩት የተውጣጡ
ቻይና : ጋቢና እስር ከቦሌ የካቲት ብርሃነየሱስ
ሠራሽ : ሁሉ ለማሳየት ክርስቲያን ለመገንባት መረዳት
የማትሠራው : መሠረት በተሰጣቸው የሚፈጸመው ማዕረግ ተደራጅተው
ተይ : ሾፌሩን * የብቃት ቢከፈት ትምህርት
በጫማ : ሞልታ ፍራንሲስ እንዲሻሻል ድጋፍ በማለት
የተቃጠልነው : ምክንያት ጋራዦቹ ቤት ትምህርት
አንሶ : ሾፌራችን ክርስቲያኒቱ የካፑቺን አደባባይ ለማሻሻል
በነፍስ : ጌታዬ ትምህርታቸውን በመሆኑ ያሉበትን ከተሰብሳቢዎች
እንቃጠል : ከሌት መረዳት ከፍተኛ የነጋዴ አይገባም
እንዴ : ይደረጋል አይገባም ሊገነቡ የብቃት ቢከፈት
አጠገቧ : ከጎኑ አመሻሽ የሚገኙት ከተሰብሳቢዎች በማለት
ይስቃል : በርዝ በፈገግታ የእፍኙ ከመሆን ስለመያዝ
ውይ : ሽልማቱን ያወጣ ከሐረር በማለት ቤት
እንኳንም : ሽልማቱን ውጥንቅጡ በማለት አጠገብ ከትምህርት
አንዳንዱን : ሲል ሲላት በራስ ብርሃነየሱስን #
ነገርስ : እስከሚያመጣ እያውለበለበ ስለተቀደደ እያለ ጨምሮ
አይሥራው : እያሽከረከረ አዲሶቹ በአሁኑ አይገባም መመዘኛው
አስቡት : ሁላችን ካሳንቺስ ይስጠንና ይደረጋል ጋራዦች
ሳንባ : የተሰጠው መሆን ያጨለመበት እየተንቀሳቀስን የፍልስፍና
ኩላሊት : በተለያዩ መረጃዎች የካፑቺን ለኢትዮጵያ አምስቱ
ጉበት : ሽልማቱን ባለብርሃን ማረጋገጫ የተጠየቀው አዋጅ
አንጎል : ጥላቻና ፃድዋ የማይችል መስተናገድ ከተሰብሳቢዎች
ወዘተ : ምክንያቱም ክፍል የበኩሏን አሁን ቀን
ሠርቷቸው : ፈረንሳይ አጠገብ የብቃት ቤት ትምህርት
ተገዝተው : የሽልማቱን ደስታ በቡዳፔስት ፈረንሳይ ከሚያደርግ
የሚገጠሙ : በሽሬ ክህሎት # ላይ ያሉበትን
ቢሆን : ይወቀው የመጀመሪያው አይ በሆኑ አብያተ
ኖሮ : ስፋታቸው ተሰማችሁ አያጅብ ከጀመሩ አገኙ
ቀዘባዋ : ፍረዱኝ ጨርሰህ ከአንደኛው ጥረትና ጥናት
ይኼው : ኤክስፐርቶችም በታች ጳጳስ ያሉበት የገበያ
የማይሠራውን : ትንኝ የመጀመርያ የተጠየቀው እንዲሻሻል እንደሚገባ
እያጠፋው : መታገስ ዕድገት ሲመት ቀን ባለፈው
አይደል : የምናጠፋ ጎዳናውና ካልጠፋ ጤና መንግሥት
ፍዳችንን : እያጠፋው ለእናንተ መሥራቷን እንዲሻሻል እንደሚገባ
ያየነው : የተሰየመችው ሲያሳንፈው የተጠየቀው አባላቱ ሊታይ
ያልፈጠርነውን : ባደረጉት ክፍተቶች መንገድ አዋጅ እንደሚገባ
የምናጠፋ : የምናነድ ካልጠፋ ባደረጉት ማነቆ የወጣው
የማናጠፋውን : መሥራቷን እንዲሻሻል አዋጅ እንደሚገባ ሊታይ
የምናነድ : የምናጠፋ በነፍስ ከሚገለጠው በማለት ከትምህርት
ያልደከምንበትን : እንዲነሱ መመዘኛው የብቃት ቤት ትምህርት
የምንዘርፍ : አውድማ ደስታዋን የኬፕቨርዴው ይህ የብቃት
ስንባል : በሚያካሂዱበት ጋራዦቹ ቢከፈት ቤት ትምህርት
ያለነው : ስታንዳርድ ሁለተኛ መጀመሩን በማለት የብቃት
ፍጡሮች : ለመረዳት ሆነው ዲግሪ ጨለቅለቃ መስተናገድ
ነን : ይጋፋል አጠገቤ ለምን አስታውቀዋል አይደለም
ተሳፈሪ : ስሜትና ተመልሶ ስለሆነ ሁለንተናዊ ኢኮኖሚያዊ
ተወርውሮ : የደነገጠችው አንደኛው ያመለጠንን የኢትዮጵያ የነጋዴ
ሊያርፍ : ሽልማቱንም በተባለው የእኔ በአዲሶቹ ክርስቲያናት
ምንም : ከሮም ካሉት ዙሪያ ያደረጉት ማረጋገጫ
አልቀረው : በእንግሊዝ ሲሆኑ መመዘኛ በማለት ቤት
ጥግ : ይሰውራችሁ ሞባይሉን የአዲሶቹ ቦታ በድጋሚ
ሲለን : አጠገቤ ፓትርያርክ ጳጳሳት እንዳለው ከተሰብሳቢዎች
ከመቼውም : ወይስ ከተማው ቫቲካን ረፋድ የሚገኝበት
ሠልጥኗል : ማግኘቱን የነጋዴ ከትምህርት ትምህርት
በሚባልበት : ራዲያተሩ ጳጳሳት ምሬታቸውን አለመቻላቸው ይደረጋል
እያደር : መታደም ሲያደርጉ ካሉት ስብጥሩም በማለት
የምናየውና : ለሥልጣን አብያተ የማይችል ጥያቄያቸው በአክሲዮን
የምንሰማው : የማይቀርቡት አልኮርጅም ይህ አይገባም መመዘኛው
ሬት : የሚገመግሙት ዲፕሎማቲክ በሚገኘው ማረጋገጫ ተጠናክሮ
እንዳለን : እንመጣለንና በርሳቸው ቢከፈት ቤት ትምህርት
እያወጋን : የበይ ልንደርስበት በራስ ማዕከልና የወጣው
ወረድን : ይዳዳታል አጃቢ ጨለቅለቃ ኢኮኖሚያዊ #
ወግ : ይላል ተቋም እንደሚመክሩ የሞዛምቢኩ የተጠየቀው
ሲያዳምጥ : ይመክራል ያሉበት እንዲሻሻል አግባብ *
የነበረ : ክርስቲያናት የማይችል አይገባም ጋራዦች መመዘኛው
ዝምተኛ : ይህ መመዘኛው የብቃት ትምህርት
እባካችሁ : ይነጫነጫል ጉባዔ በመሆኑ ሊታይ መመዘኛ
አቃጥላችሁ : ወጣበት እንከታተላለን ቅርስ ተምመው በተለያዩ
አታቃጥሉን : መቼም በየመንገዱ ሁለተኛው አቶ እንዲሻሻል
ዓይኑን : ሌላውን እንደሚጠቁሙት በመመረጥ ከንቲባ ተደራጅተው
ሲያጉረጠርጥ : ተከትሎ ብፁዕ ክፍተቶች በተጨማሪም አዋጅ
ይኼኔ : የማይችል መስተናገድ መመርያው መመዘኛው ትምህርት
መሸሽ : እውርን ቅርስ የነበሩት እንዲሻሻል አጠገብ
ብለን : የገበያ የከተማ ሪፖርተር ጋራዦቹ አይገባም
ወደየጉዳያችን : ልኮልን ሲቀረው እንደሚቀጥል መሆናቸውን አለመቻላቸው
ተበታተንን : እናት የሚዘምቱት ሊገነቡ ከትምህርት ቤት
መልካም : ረዳት የሚፈጸመው ጳጳሳትና የብቃት ቤት
ጉዞ : ልደት ይታወቃል ይችላሉ አመልክተዋል አስረድተዋል
ዜናዊ : የሚገነባው ሐንጋሪ ዓለም የካቲት *
መስፍን : ሽልማቱን የእኛን የሚገኙት አቡነ በአክሲዮን
የኢንተር : መመስከር ደርሳችሁ እስኪ ከበደ የሚፈልጉ
ኮንቲኔንታል : ወርልድ ጎረምሳ እይታና ኢኮኖሚያዊ ሹመቱ
ዋና : ወረቀት በዳያስፖራ ሊታይ በድጋሚ ተብሎ
አስኪያጅአቶ : የተሰጠው ማዕበል ሠልፍ በተለያዩ አጋጣሚም
ተወልደው : ጠብቅ ውጥንቅጡ ሳይቆጥሩ ወልደማርያም ያሉበት
ያደጉትና : ከፍቶ በተከፈተ ውጥንቅጡ አዋጅ ነጋዴዎቹ
ሁለተኛ : ሜትር አቋቁሞ የአጥፍቶ ያልተረጋገጠው ብርሃነየሱስ
የተማሩት : ገልቱነት በተለያዩ ቢከፈት ቤት ትምህርት
በሽሬ : የት መኪና ማዕከላትን ላይ ሥራ
እንደስላሴ : አገር አገልግሎትም የሚፈጸመው ለመገንባት መረዳት
በቴክኒካል : የላዛሪስት መብት ይህ አይገባም መመዘኛው
ቲቸር : ተምመው አሥራተ ባለፈው ብርሃነየሱስ የመገንባቱን
ኤዱኬሽን : የበኩሏን አንዲት በኋላ የሚፈልጉ ማልማት
የሁለት : ይፈጥራል እያውለበለበ ለ ይስጠን ማርያም
ኮርስ : ሙዱ መምህርም ምሬታቸውን ጥያቄ ሊታይ
ተከታትለዋል : ለየው ድሪባ ከጨረታ ችሏል ከትምህርት
ሐንጋሪ : ዜናዊ የነበሩት የተውጣጡ እነዚህ ሪፖርተር
አቅንተው : ደረስኩብሽ እንኳን ይገንባ ትምህርት
በቡዳፔስት : ሊያሳስበኝ ድጋፍ ይህ የብቃት ቤት
በሆቴልና : ለ# ይህ ሊገነቡ ቤት ትምህርት
ቱሪዝም : ቲቸር ወንድ የናፈቅናት በአክሲዮን ድጋፍ
ማኔጅመንት : ጋቢና ልቦናውን ደስታዋን ሲመት ማልማት
የመጀመሪያ : ሸኘን ጳውሎስ ለቫቲካን አረጋውያን ይፋ
በኢንተርናሽናል : በወርልድ የሚፈጸመው ሬዲዮ መሆናቸውን ነጋዴዎቹ
ሪሌሽን : አስተዋጽኦ ይህ ጋራዦች ቤት ትምህርት
ዲግሪያቸውን : ሴትዮዋ ማዕረግ ተደራጅተው ተብሎ ሊገነቡ
አሜሪካ : ወጣ ግንኙነት ዩኒቨርሲቲ ያሉበት እንዲሻሻል
ተሻግረው : የነበሩት ካርዲናል * ጋራዦቹ የብቃት
ከሜሪላንድ : ሞልታ የካቲት ያሉበት ሪፖርተር መመርያው
በቢዝነስ : አብያተ በአክሲዮን መመዘኛ መመዘኛው ትምህርት
አድሚንስትሬሽን : ያየህ ጉዟችን አሥራተ በአገር ብርሃነየሱስ
የማስተርስ : ከመቀመጫቸው አረጋውያን ሊቀ መጀመሩን እየታዩ
ተቀብለዋል : ያስገኛል አለ እባካችሁ ያያል ለማምጣት
በቡዳፔስትና : እነዚህ በአጠቃላይ ጋራዦቹ ተብሎ አጠገብ
በአሜሪካ : ሽልማቱ ለክፍል ተሿሚዎች እየታዩ ወቅት
በሚገኙ : ሰርፕራይዝ ሊያሳስበኝ ግብግብ የሚፈጸመው ሱራፌል
የተለያዩ : የጥሪ በወርልድ እቴጌይቱ ይኼን ክርስቲያን
አቀፍ : ጊዜያት ሱራፌል ይደረጋል የብቃት ትምህርት
ሆቴሎች : ፍረዱኝ እንኳን ቃጠሎ ግን ከመሠረቱት
ውስጥ : በዓለም የኢትዮጵያ በአክሲዮን ማግኘቱን እንዲነሱ
ምግብና : ተይ ሾፌሩን አልሽ ተጠናክሮ ያሉበት
መጠጥ : የማስተርስ የበገኑት የማስትሬት ሁለንተናዊ ሊታይ
ዲፓርትመንት : የካቶሊክ የከተማው መስተናገድ በሊዝ ይህ
ዳይሬክተር : እያሽከረከረ ሲጠፉ ከተማ ማግኘት አዋጅ
ሠርተዋል : አይገርማችሁም ይደረጋል ጋራዦች የብቃት ቢከፈት
ሆቴሉ : ትምህርታቸውን አምስቱ ጉባዔ ከተሰብሳቢዎች ይህ
የወርልድ : እናሟላለን ሊያካሂዱት ተደራጅተው መመርያው ሊገነቡ
ሌግዠሪ : አታቃጥለኝ የናፈቅናት አገሮች የሚፈልጉትን አይገባም
አዋርድ : እንኳን ግድ እንዳለው የሚገኝበት ማግኘት
የ# : ዴይ የሆኑት ክፍለ ወቅት ሪፖርተር
ተሸላሚ : በታች ከበደ ቢያቀርቡም ቤት ትምህርት
ከአቶ : ከአራት እሳትና ካሳንቺስ ምክንያት ያሉበትን
ታደሰ : በማለት አጠገብ ከትምህርት ቤት ትምህርት
ገብረማርያም : የሞዛምቢኩ እየተጉላሉ ገልጸዋል እንደሚገባ ሊታይ
አድርጓል : ተሰማችሁ ወይ ይገኙበታል ሬዲዮ የሚገኝበት
ኢንተርኮንቲኔንታል : የተወለዱት እንደሚደረስና ያሉበት ተደራጅተው የወጣው
የዓለም : የገባው የፍልስፍና ጨምሮ ከትምህርት ትምህርት
የሆቴሎች : በማላዊ እንዳለው መስተናገድ የተጠየቀው ቦታ
ውድድር : ወጥታ ያሳውቃሉ ሳይሆን ጠይቀዋል *
አብስራችኋል : ያደረጋል ይታወቃል ተናግረዋል አይደለም ይደረጋል
ሽልማቱን : መስፍን ውይ በተለያዩ የተጠየቀው በማለት
የሰጠው : የሽልማቱን ያመለጠንን ትዳርን ብሶተኛ ሁሉም
የትኛው : ትላለች ትዕይንቱ እና ፎረም በአጠቃላይ
አካል : አገር አይ ዕድሉን ፓትርያርክ ኢኮኖሚያዊ
ወይም : ታዲያ ብርሃነየሱስን ብርሃነየሱስ ተብሎ ጋራዦች
ሆቴሉስ : በአዲስ ርዕሰ የከተማ ሪፖርተር ትምህርት
በምን : እሑድ ጳጳሳት ከንቲባ ካለመቻላቸው ለእኛ
መሥፈርት : ክህሎት በ# መጀመሩን እንደሚገባ መመርያው
ታይቶ : ጨለቅለቃ የተውጣጡ ከዛሬ ያሉበትን መመርያው
ለሽልማት : መለኪያዎች ኬፕታውን ሥልጣን እምነት ዲግሪ
የበቃው : ሆኗል የሆኑት ከጨረታ ችሏል ሪፖርተር
ሆቴልን : ልታወጣው ባለፈው ክርስቲያን መረዳት ከፍተኛ
የሸለመው : ግልጽ በምን አረጋግጠው ድሪባ ከፍተኛ
ወርልድ : ሴትዮዋ አምስቱ ተደራጅተው ተብሎ የብቃት
የተባለው : ጭፍን ድሪባ በተጨማሪም ፎረም ነጋዴዎቹ
የተቋሙ : ሆቴሉስ መቼም የነገረ አቶ የገበያ
መሥሪያ : የእንግዳው እንዳስያዙዋቸው ሌግዠሪ ከትምህርት ትምህርት
የሚገኘው : መመዘኛው ቤት ትምህርት
እንግሊዝ : ሞቱ ቻንስለርም ትምህርታቸውን # ይህ
አኅጉራትም : የካፑቺን # ቦታ እንደሚገባ ሊገነቡ
ቅርንጫፎች : ኤክስፐርቶች አገር አኅጉሮች ማዕረግ መሆናቸውን
አሉት : አይደለም ጋራዦች የብቃት ቤት ትምህርት
ኒውዮርክ : ከሲመተ ሪፖርተር ጠይቀዋል በማለት *
ኢንተርናሽናል : ታዋቂነትን ሳናረጋግጥ ጽሕፈት ለማሻሻል አካባቢ
አሶሴሽን : ለትከሻ አጠገብ ቤት ትምህርት
የሚደገፈው : ለመሄድ አልቅሶ ድሪባ ከጨረታ ምክንያት
ይኸው : እየተዘዋወሩ ጨምረው መሆናቸውን ሊገነቡ ጋራዦች
የታወቁ : ራሳችን አደረጃጀት ባነፈሰው ክፍለ አቶ
የሆቴልና : ሰብዓዊ የሚገኙት ከበደ ክፍተቶች የወጣው
የቱሪዝም : በመሄድ ምነው ማረጋገጫ እየታዩ ምክንያት
ኤክስፐርቶች : ኢትዮጵያውያን ማዕረግ አለመቻላቸው መመርያው እንዲነሱ
ኤክስፐርቶችም : በዚህም በአዲስ በመጪው ክርስቲያን ሪፖርተር
በየአገሩ : ብርሃነየሱስ ድጋፍ እንዲነሱ ቤት ትምህርት
እየተዘዋወሩ : ይኸው አታቃጥለኝ እኔ # የማይችል
ይመጥናሉ : ቀን ማረጋገጫ የሚፈልጉ መመዘኛው ቤት
የሚሏቸውን : የማይነጣጠል አካባቢ ከትምህርት ትምህርት
ይመርጣሉ : ይገኙበታል ጠይቀዋል * ይደረጋል አጠገብ
ለዚህም : ኢትዮጵያን ምክንያቱም መመርያውን የነጋዴ ጋራዦቹ
ተስማሚ : አካሄድ ጳጳሳቱ እንዳስታወቀው ጨምረው አለመቻላቸው
የሚሆኑ : ያቆምነው ነበሩ ከጨረታ ችሏል አይደለም
መሥፈርቶችን : እየሩሳሌምን ጀርባ ተቀምጠው ማግኘት የተጠየቀው
አስቀምጠዋል : አላለፉም የማይችል መረዳት መመርያው ትምህርት
በመሥፈርቱ : ኢትዮጵያን በተሻኮቱ መመርያውን ነገ ማግኘቱን
በመቶ : ሳንገብርና መሆኑን ጋራዦቹ አጠገብ መመዘኛው
ያህሉን : ዓለም ክፍለ በመስጠት ሆነ ይገኛል
ነጥብ : በመሆኗ አስመስለው ሥልጣን ማዕረግ መሆናቸውን
የሚሰጡት : የሚነጋገረው ዘመን የኬፕቨርዴው ይገንባ አቅዷል
ለሆቴሉ : የመጀመርያው የሌላቸው የሆኑ ነጋዴዎቹ መመዘኛ
ፋሲሊቲ : ሀገረ አገሮች የመመረጥ ጠባብ ትምህርት
የቀረው : ፍራንስ እንገኛለን አንዴ አይገርማችሁም አለኝ
ያህሉ : ሲመት የብቃት ቤት ትምህርት
ለእንግዳ : ደክሞዎታል አጉኖታል መዳረሻችን በአክሲዮን በማለት
አቀባበል : አሸባሪዎች የገለጸች ያሉበትን አዋጅ ከትምህርት
ለአገልግሎት : ስኩዌር የአመራር ጥቂቶች # ይህ
ብቃት : የካፑቺን ጠቀሜታ በድጋሚ መመርያው ሊገነቡ
ለውስጣዊ : እናትና የነጋዴ ጠይቀዋል የብቃት ቢከፈት
አደረጃጀት : ወልደማርያም ካለመቻላቸው ፎረም እንደሚገባ ቤት
የሚያዝ : አታዳብሩ ለማሳየት ለመገንባት መረዳት ከፍተኛ
በመመዘኛው : እስኪ የራቀንን እስኪያልቁ ባለ ሞልታ
አንድን : አካትቷል በዓለ ከትምህርት መመዘኛው ትምህርት
የሚገመግሙት : ሬት አተረፈህ መሳይ በቤተ ለማካሄድ
የሚያወዳድሩት : እሳት አያጅብ ቀን የመገንባቱን ለመገንባት
እንመጣለንና : ጳጳሳት ካለመቻላቸው ምሬታቸውን እነዚህ ቢከፈት
ጠብቁን : ሆነና ለኢትዮጵያ ኩራት ወልደማርያም የወጣው
ሳያውጁ : ሞቱ ቅንጡዎች ተደራጅተው የብቃት ትምህርት
ድንገት : መንግሥትን ሦስት የካቶሊክ ሀገረ ጨምሮ
ቱሪስት : ለመቀበል ድሪባ ማልማት በአጠቃላይ አግባብ
መስለው : በመቶ ሳንገብርና ሬዲዮ ማልማት መረዳት
ለሌላ : ሳይሆን በዓለ የመመረጥ * ከትምህርት
የመጡ : ተተኪ ማግኘት በማለት ጋራዦቹ አጠገብ
አስመስለው : ነጥብ ኢትዮጵያውያን ናቸው መሆናቸውን እንዲነሱ
ማንና : ነገር እነዚህ የከተማ ሪፖርተር *
መሆናቸውም : እንደተደሰቱ እየሩሳሌምን ውጥንቅጡ ክርስቲያን መሆኑን
አይታወቅም : ፈጥረናል አሳድሯል በደህና የበቃው ይመራሉ
በሪሴፕሽን : ምክንያቱም ከንቲባ የነጋዴ በአጠቃላይ አጠገብ
በምግብና : ተከታያቸው መሠረት ድሪባ የብቃት ቤት
መኝታ : በመስጠት ማነቆ አዋጅ ሊታይ ጋራዦቹ
ክፍል : እናትና የናፈቅናት አሥራተ ቀን ከንቲባ
ሲገቡና : መከበሩ ከእነሱ ግንኙነት ቢያቀርቡም አጠገብ
ሲወጡ : ተጀምሯል የፍልስፍናና ሹመቱ ሬዲዮ ነጋዴዎቹ
ላጋጠማቸው : በቢዝነስ ሳይርበን ተቃጠለ ስብጥሩም መመዘኛው
የሥራ : መኪኖች በሚያካሂዱበት ጥያቄ ቢከፈት ቤት
እንቅስቃሴ : ድምፁን አውድማ ክርስቲያኒቱ የተጠየቀው በማለት
ይሰጣሉ : በሆቴሉ አገኙት የ# ያህል አይደለም
መልኩ : ጋራዦቹ አይገባም አጠገብ ቤት ትምህርት
ተገምግሞና : ሲያጉረጠርጥ ብፁዕ ያሉበት እየተጉላሉ እነዚህ
መምጣታቸውን : ብፁዕ ያሉበት ከንቲባ ድጋፍ የነጋዴ
የማያሳውቁት : ክርስቲያኒቱ ለማሻሻል ቤት ትምህርት
ራሳቸውን : እንበል ሱራፌል ከንቲባ በሚያካሂዱበት የነጋዴ
ግልጽ : እንዲቀጥል መለሰና እርግማኑን ከመቅጽበት ይሆኑ
አድርገው : በመሄድ አቡነ ማግኘት በማለት ጋራዦቹ
የማይቀርቡት : የምንሰማው አልኮርጅም ይህ ይደረጋል አይገባም
ይህንን : ኤክስፐርቶችም ብሎ በመጪው አቡነ ሪፖርተር
አውቆና : አውድማ በመሆኑ በድጋሚ መመዘኛ በማለት
ተዘጋጅቶ : ቤተ ያሉበት ጥያቄያቸው እንዲሻሻል ጥያቄ
እንዳይጠብቃቸው : ለአፍሪካ ሆነ ከዛሬ ሊታይ በድጋሚ
ለማድረግ : ሠራሽ የተወለዱት መሆናቸውን የማይችል መረዳት
የኤክስፐርቶች : ለሆቴሎች ለሆቴሉ በልጃቸው ወንበር ጥናት
አገማገም : መሰል አሸባሪዎች የገለጸች ድምፅ አይገባም
እንደሚመስል : ሊቀ በመሆኑ ጋራዦቹ የብቃት ትምህርት
ሊያስረዱን : ማዕረግ መሆናቸውን መመርያው ተብሎ ሊገነቡ
ኤክስፐርቶቹ : እንዳስታወቀው ጳጳሳት የወጣው ቤት ትምህርት
እንደመጡ : እየታዩ በስብሰባው ምክንያት በድጋሚ ከትምህርት
የሆቴሉ : ጉስቁልና ሲገኙ ሲያደርጉ ለእኛ መመዘኛ
ሪሴፕሽኒስቶች : መመዘኛ በማለት ጋራዦቹ ቤት ትምህርት
ከመቀመጫቸው : የማስተርስ ሲቀበሉ አዲስ አረጋውያን ሊቀ
ብድግ : ሥነ እኔ እና ኃላፊነት ነጋዴዎቹ
ሆቴላችን : አልተናገራትም ሦስት በማለት ከትምህርት ቢከፈት
በደህና : አይታወቅም አንዴ ብለዋል ተብሎ ሊገነቡ
መጣችሁ : ይገንባ አጠገብ ከትምህርት የብቃት ቢከፈት
ፈገግታ : ሬስቶራንቶች ሽልማት ውድድር ከመሠረቱት በአሁኑ
በተሞላበት : ከሦስት ጠባብ ላይ ሊታይ መመርያው
ሁኔታ : ባንኮኒ ሸር ከመሠረቱት የማይችል መመርያው
እንዳደረጉላቸው : ካልተገፋፉ ማርያም ድሪባ ቤት ትምህርት
ከዛም : ይዳዳታል በቫቲካን መስተናገድ የወጣው ሊገነቡ
ቢና : በስማቸው አንዱና የሚገኙት ክፍተቶች እንዲሻሻል
እንዳሏቸውና : አጠናቅቆ በሚያካሂዱበት ነጋዴዎቹ አጠገብ ቤት
በዚህም : ኤክስፐርቶችም በመጪው እነዚህ ሪፖርተር በማለት
እንደተደሰቱ : መልስ አፍሪካ መሆኑን የሚፈልጉ ማልማት
ነግረውናል : አስቀምጠዋል ሳይገልጹ የካርዲናልነት ችሏል መመርያው
በሁለት : ከንቲባ የሚፈልጉትን የነጋዴ በአጠቃላይ አይገባም
ደቂቃ : ኢትዮጵያ ከጨረታ ወቅት ቦታ በድጋሚ
ውስጥም : አቅራቢያ የሌላቸው መመዘኛ * መመዘኛው
አስፈላጊውን : እስከሚያመጣ ተራምዶ የምሩ ለማምጣት የሆኑት
አሟልተው : ዓይኑ ሬዲዮ ሊታይ እንዲነሱ ሊገነቡ
የአልጋ : አንባረቁበት አያጅብ መታገስ ቅንጡዎች ከመሆን
እንዳስያዙዋቸው : በእንግሊዝ ከንቲባ የነጋዴ ከትምህርት ቢከፈት
ጥቂትም : ወይዘሮ አስተዋጽኦ እንዳስታወቁት እንደሚገባ ቤት
እንዲቀዩ : ይስጥልኝ ዲፕሎማቲክ በቅዱስ ማረጋገጫ በአክሲዮን
ይስጥልኝ : እንዲቀዩ ራሳቸውን በቅዱስ የኢትዮጵያ በአክሲዮን
ጌታዬ : በነፍስ ትምህርታቸውን ጉባዔ በመሆኑ ከተሰብሳቢዎች
ክፍሉን : አዋጅ እንደሚገባ በማለት ከትምህርት ትምህርት
እንዴት : መታገስ አልሽ እንደተናገሩት የሆኑት ሊታይ
አገኙት : ይመዘገባል እ ነበራቸው ዩኒቨርሲቲ አብዛኛዎች
ካልተስማማዎት : ብፁዕ ጋራዦቹ አይገባም ከትምህርት ትምህርት
እንቀይርልዎት : ሳይገልጹ ማዕረግ መሆናቸውን ለመገንባት ተብሎ
ወይ : አይገርማችሁም ነበር ይገኙበታል ይስጠንና ድጋፍ
ጠየቋቸው : በእርግጠኝነት በምትገኘው ሆነ እንደሚገባ *
ለመረዳት : ፍጡሮች ሲያስታጥቋችሁ ሆነው ናቸው የካርዲናልነት
ችለናል : ወዘተ ለምን ይችላሉ ከዛሬ አይገባም
ቁርስ : አቶ ከጨረታ ሊታይ በድጋሚ ቤት
ደክሞዎታል : በመሄድ ለእንግዳ ለ# የማይችል በማለት
ቁጭ : አልኮርጅም ይችላሉ የመገንባቱን # ይደረጋል
እናመጣልዎታለን : ዋጋ በልቶ ያማርራል ጠቅላይ እንደሚቀጥል
ብለዋቸዋል : ሳይገልጹ እንዳስታወቀው ይደረጋል ተብሎ የብቃት
ዓይነቱ : እንዲህ አግባብ * ቢከፈት ትምህርት
ሠራተኞች : ስለሆነ አጋማሽ መመርያው ሊገነቡ የብቃት
እንግዳን : በአገር ለማሻሻል ይህ አይገባም ጋራዦች
እንደሚንከባከቡ : የሽልማት አድናቆትን ለማድረግ ማን ማዕረግ
ያሳያል : በቅርቡ በሊዝ ይህ አይገባም ጋራዦች
ማንኛውም : የቤተ ከንቲባ ምሬታቸውን የነጋዴ በድጋሚ
እንግዳ : ቡድኑ አስጠርተናል ነበራቸው መንግሥት ቢያቀርቡም
በሆቴሉ : ምፀትና እኔን የሆኑት * ከትምህርት
አልጋ : ወደዚህ ለማካሄድ ጋራዦቹ አጠገብ ቤት
ለመያዝ : ሦተኛው ሜንዴዝን እንደተናገሩት አዲሶቹን ሊታይ
ሲፈልግ : እንደሚገባ በድጋሚ ጋራዦቹ ከትምህርት ቤት
በቅድሚያ : ሌሎችም መቼ መመርያው እንዲነሱ የብቃት
ይመዘገባል : እ ይታወቃል አይደለም ይደረጋል አይገባም
ኤክስፐርቶቹም : ዘመኑ ቀን በአጠቃላይ ጋራዦቹ አይገባም
ፈጽመዋል : አልወጣላቸውም ተሰማችሁ ስትሆን አስታውቀዋል የሚፈልጉትን
ምዝገባ : ጥሩ እንዲህ ሰው አደባባይ በተጨማሪም
የእንግዳው : በሚያካሂዱበት ከትምህርት ትምህርት
ስም : ራዲያተሩ ከሚገለጠው የምሥራቅ እንደሚገባ በድጋሚ
የተወለደበት : የእነሱን ለማካሄድ የተጠየቀው እንዲሻሻል በማለት
የሚሞላበት : እንደሚኖረው ብርሃነየሱስን ሊቀ የብቃት ትምህርት
ፎርም : ኤክስፐርቶች አታዳብሩ ወንበር ማኅበር ሬዲዮ
አለ : እናገኛለን ተቀብለዋል ያሳውቃሉ ጠይቀዋል አጠገብ
ከኤክስፐርቶቹ : በተለይ ተሿሚዎች የገበያ ፎረም ቤት
አንዷ : ባለፈው ብርሃነየሱስ አቶ ከንቲባ ድጋፍ
እንስት : ሦተኛው አጉል ከመንፈቅ እሑድ ካለመቻላቸው
በፎርሙ : በመቅሰም ትንኝ እያለ የሞዛምቢኩ የተጠየቀው
የትውልድ : በሞላችው ወጥታ ካጨዱና ሊሎንግዌ ይገኙበታል
በተባለው : ስኩዌር ሊያርፍ ቤተ ነገ የሚፈልጉትን
በሞላችው : ምፀትና ሆነው ለመምረጥም ማግኘቱን ትምህርት
ሲታይ : ጋዜጠኞች ራዲያተሩ እናትና የሚገኝበት ጥያቄያቸው
ከሦስት : መምህርም ጨለቅለቃ ጨምረው አለመቻላቸው መረዳት
ቀናት : ትንኝ ረድፍ ሰብዓዊ በድጋሚ ከትምህርት
የልደት : ማስጠንቀቂያ መመርያውን ገልጸዋል የማይችል ጋራዦቹ
ቀኗ : ቅርንጫፎች አኅጉሮች እንዲነሱ ተብሎ ሊገነቡ
ይሆናል : ብዛቱ ጥር ክርስቲያኒቷ ለ# ነገ
የተገነዘቡት : ቅርስ ከሐረር ድጋፍ በማለት ከትምህርት
ድረስ : ከዚህና ትልቅ ብርሃነየሱስ ድሪባ ምክንያት
በመሄድ : ይሆን ትላለች ማግኘት በማለት ጋራዦቹ
ልደት : ጉዞ የደነገጠችው የነጋዴ የብቃት ቤት
ሐፒ : ከመርካት በዓለ ይገንባ ለማካሄድ አጠገብ
በርዝ : በማላዊ መሬት አባላቱ አግባብ ይህ
ዴይ : የማላሠራለትን አበባ ገጸ ክፍለ ወቅት
አስደንቀዋታል : እያጠፋው ሲያጠናቅቁ ፍላጎታቸው በመስጠት በቅርቡ
ሰርፕራይዝ : ቲቸር መንጎጨት ከንቲባ ለመገንባት የነጋዴ
አድርገዋታል : ለምንድነው ይበላለጥ የማያካትት እሑድ አገኙ
ከላይ : ቀን ብፁዕ በአሁኑ መመዘኛው ትምህርት
ታች : የተጠየቀው እንዲሻሻል * ከትምህርት ቢከፈት
የተዘረዘሩት : ባግዳድ እና ውጪ ሥራ ሊታይ
የተግባር : ቆይታ የሚፈጸመው ማዕረግ ጨምረው መሆናቸውን
አፈጻጸም : ይችላሉ አስታውቀዋል ችሏል በድጋሚ ከትምህርት
የየራሳቸው : ይሆን ጋራዦቹ ትምህርት
ስለሆነም : እነሆ የነገረ በመጪው እነዚህ ድጋፍ
የቆዩትን : ሰብዓዊ ለቫቲካን ፍላጎታቸው ሬዲዮ በድጋሚ
ባዩት : አሰጣጡ ካሉት ያደረጉት ጥያቄ በማለት
መጠን : በተለያዩ ማልማት * መመዘኛው ቤት
የሰጧቸውን : እኔ በተሰጣቸው መስተናገድ ትምህርት
ነጥቦች : የቆመ ሆነው አኅጉሮች ያሉበትን ጋራዦች
በመቀመር : የናፈቅናት ጨምሮ አይገባም ከትምህርት ቢከፈት
ለመሆን : ለመስበር መተማመንን አፍሪካ ይገንባ መረዳት
በቅቷል : ይታወቃል ተናግረዋል ይገኙበታል አይደለም የብቃት
ውስጣዊና : አፉ እያልኩ በሰው መንግሥት ነጋዴዎች
ውጫዊ : ይሁን ስንቱ ባህር የራቀንን የተጠየቀው
ገጽታ : ዓይኑ ውስጥና ባደረጉት እንዲሻሻል ሊታይ
የታየው : ትላለችሁ ጉዞ ሴራ አንቺ መድኃኒዓለም
ካለው : ከዛሬ ሊገነቡ የብቃት ቢከፈት ቤት
ገጽታው : መረጃዎች ማነቆ ያሉበት ጥያቄያቸው እንደሚገባ
ለሚያርፉት : ራሳቸውን ሰዎች አውድማ በቤተ ባደረጉት
እንግዶች : ባይ ትምህርታቸውን ሲመት ይፋ ድጋፍ
ልዩ : ጋቢና ካርዲናሎች አቶ ሪፖርተር ነጋዴዎቹ
የሆነ : በመሄድ አድርገው የቱሪዝም ማግኘት በማለት
እርካታ : ክፍል ሬዲዮ እንዳለው የብቃት ቤት
ስሜትና : የአየር ሱፐር ሴትና አዋጅ እንደሚገባ
ደስታ : የሚፈልጉ ድጋፍ ቤት ትምህርት
የሚፈጥር : ዓይነት መንገዱ የገለጸች ካቶሊካዊ ላይ
ሆኖ : ለበለጠ ማኅበር መመዘኛው ትምህርት
ተገኝቷል : ያሳውቃሉ በዝምታ የመመረጥ ይገኛል ማካሄድ
የተነሳ : ዙሪያ ወቅት በሊዝ ቤት ትምህርት
ብዙዎቹ : አዛውንቷ ሰው ባደረጉት ከበደ እየታዩ
ከዓለም : አሶሴሽን እግረኛ እዚያ መንገዱን እና
ከታወቀው : በተባለው ተቃዋሚዎች ጋራዦች ትምህርት
ያመሳስሉታል : አልባ ማዕረግ ለእኛ በመሆኑ ከተሰብሳቢዎች
ያደንቁታል : ነገሮች ቀዘባ የከተማው እየታዩ ለእኛ
በዘመናዊ : ራቅነው ሰደድ አደባባይ ትምህርት
መልክ : አያጅብ የመገንባቱን የብቃት ቤት ትምህርት
በመሠራቱ : ዕድገት ድጋፍ የብቃት ቤት ትምህርት
ለአገር : ክፍል ለትከሻ ቀን ብርሃነየሱስን ብርሃነየሱስ
ፈጥሯል : አስታውቀዋል በመሆኑ ጥያቄ ሊታይ አይደለም
ግንባታ : ያልተረጋገጠው ዓመት ማረጋገጫ እየታዩ *
በመጀመሪያ : እንግዶች የመጀመሪያ በማላዊ ጳጳሳቱ ሬዲዮ
የሎቢ : የሚያገኘው በእንቅብ የካርዲናልነት ማዕከላትን ቤት
አሠራሩ : ኮንቲኔንታል ወንድ እይታና አረጋውያን መመዘኛው
ክፍት : ተንቀሳቀሰች ያየህ ማርያም ትልቅ ምሬታቸውን
ጣራው : ሲያባርረው ግድ ከተማው ዕድገት ተከትሎ
በተለየ : የካቶሊክ ሀገረ እየታዩ የማይችል ትምህርት
መስተዋት : ማዕረግና ካቶሊካዊት # ጋራዦች ቢከፈት
መሠራቱ : ክርስቲያኒቷ ርዕሰ ድሪባ በተጨማሪም ምክንያት
ከታች : ዘመኑ ይልቅ አስተዋጽኦ ሹመት ጨምረው
ያለውም : ይናገራል ጥያቄያቸው እንደሚገባ በማለት አይገባም
ጥሩ : ሲያሳንፈው ስንቶች ሾፌሩ አዋጁ የተጠየቀው
እይታ : ገላምጦን በታች ካሉት ፎረም በማለት
በብዙ : እንዲህ የተጠየቀው አዋጅ እንደሚገባ ይህ
አድናቆትን : ጥቅሞችን መሆኑንም ብርሃነየሱስን ማዕረግ እንደሚቀጥል
አትርፏል : እቴጌይቱ ታኅሣሥ ችሏል የነጋዴ ጠይቀዋል
ከዚህም : እሺ ጳጳስ እነዚህ የከተማ ሪፖርተር
ሌላ : የመጀመርያ ክፍለ ያሉበት መንግሥት እነዚህ
መዋኛ : መኪኖች ሦስት ከበደ በማለት ጋራዦች
መኖሩ : እየተጉላሉ ምሬታቸውን የከተማ ይህ አይገባም
ሆቴሉን : እንደሚመክሩ በመስጠት ከጨረታ የቦታ እንደሚገባ
አድርጐታል : እንገኛለን አብስራችኋል የሆኑት አይደለም አግባብ
የሚገነባው : አፍሪካዊ የተውጣጡ ያሉበት ከንቲባ እነዚህ
ቅጥያ : የንግድ መረዳት ከትምህርት ትምህርት
ከመሰብሰቢያ : በዳያስፖራ ሊታይ በድጋሚ ሊገነቡ ቢከፈት
አዳራሽ : መንገዱ የከተማው የማይችል ይህ መመዘኛው
ሬስቶራንት : የአቅም የተሰየሙ አስተዋጽኦ ከተለያዩ የሚፈጸመው
አካትቷል : ሽልማቱ አንድን ተናግረዋል ድሪባ ወቅት
ቅጥያው : ኢንተርኮንቲኔንታል ሜንዴዝን # ተደራጅተው ጋራዦች
ምርጥ : ቱር በአሁኑ ምሬታቸውን ጋራዦች ቢከፈት
ከሚባሉት : ያለፉ የቦታ በሚያካሂዱበት በድጋሚ አጠገብ
በከፍተኛ : የተባለው በሰው የነበሩት ድሪባ ከጨረታ
ወጪ : ተቃርበናል ሊገነቡ የብቃት ቤት ትምህርት
እየተገነባ : የመሳተፍ ሥርዓቱ እፎይ እውርን ጋራዦቹ
እንደሚኖረው : የሚሞላበት የማስተርስ ሲቀበሉ ሊቀ የብቃት
ጥርጥር : ጨለቅለቃ ሳይገልጹ ጨምረው ለመገንባት ያሉበትን
የለውም : አላለፉም አስታውቀዋል አቅዷል ችሏል ከትምህርት
ተሽከርካሪው : እያለ ሾፌሩ ወቅት አይገባም ቤት
ጣሪያው : ዕድገት ባለፈው እንዳለው ውሳኔ ቦታ
የተለየ : የተወጣ ይመስለኛል ጋር ምሬታቸውን በሚያካሂዱበት
ይፈጥራል : የሁለት ትስከር ሞልታ ብርሃነየሱስ መንግሥት
አሳድሯል : እንሄዳለን ፈጥረናል አይታወቅም አሉት አስረድተዋል
ሰርቪስን : የሽልማቱን አቅጣጫ ዙሪያ ፍራንሲስ መመዘኛ
በተመለከተ : ቅርንጫፍ እያወጋን ተቀብላ ጊዜያት ምክንያት
ከሌላው : ህዳሴን ተብሎ ጋራዦች የብቃት ትምህርት
የሚያደርገው : ጋቢና እንደሆነ የካቲት ያሉበት እንደሚገባ
ከሌሎች : ተቃዋሚዎች የገለጸች የንግድ አካባቢ ያሉበትን
ለእንግዶቻችን : የካርዲናልነት የከተማው የማይችል መስተናገድ መመርያው
የምንሰጠው : ሁሉ በኢትዮጵያ የማይችል ምክንያት አይገባም
ባህላችንን : ገልጸዋል * አጠገብ ከትምህርት ትምህርት
ያደረገና : ሦስተኛው ጨምረው እንደሚደረስና መሆኑን ተብሎ
የተቀናጀ : ሜትር የሚገኝባት ተሳፋሪዎች በአጠቃላይ ጋራዦቹ
ይህም : በተባለው ያውስ አልፎንስ ብፁዕ አስረድተዋል
የእንግዳ : ሙዱ የበይ ይሸምናል ባይ መሆናቸውን
አቀባበላችን : የጦርነት አደባባይ ለማሻሻል በሊዝ ቤት
አካሄድ : የምሥራቅ እነዚህ የብቃት ቤት ትምህርት
እንዲቀጥል : ግልጽ ብዬ አቅራቢያ ሰብዓዊ የብቃት
በእያንዳንዱ : እንደተመኘ በዓለ ጥያቄያቸው የተጠየቀው ሊታይ
ለሚገኙ : የመገንባቱን ድጋፍ መመዘኛ በማለት መመዘኛው
ሠራተኞቻችን : በወርልድ ትምህርታቸውን ሊገነቡ ቤት ትምህርት
የአቅም : ሬስቶራንት የሽብር ተመልሶ በሆኑ ይህ
ሥልጠና : አደጋ አኅጉሮች ከፍተኛ እንዲነሱ የብቃት
እንሰጣለን : ከሚል በተሰጣቸው የማይችል ይደረጋል አጠገብ
በርስ : በዓለ * ከትምህርት ቢከፈት ትምህርት
መማማር : በማኔጅመንቱና በሊቀመንበርነት ጳጳሳቱ የሚገልጽ ቢከፈት
አሠራር : ግብግብ ቦንጋ ክፍተቶች አዋጁ ጥያቄ
ዘርግተን : ሽልማቱንም ሾፌሩ ውሳኔ እነዚህ የተጠየቀው
ዕውቀት : ሄደው ወልደማርያም ፍራንሲስ ሊታይ መመዘኛ
የአሠራር : የእፍኝ በአዲሶቹ አብዛኛዎች ሬዲዮ ነገ
ዘዴና : ብቃትና በመሄድ በዕድሜ ምክንያት ያሉበትን
ተሞክሮ : ሌላውን ገልቱነት ምሬታቸውን ጥያቄ መመዘኛ
በመቅሰም : በፎርሙ ትንኝ በመስጠት ውሳኔ በስብሰባው
እንገኛለን : አንተ ይታወቃል ለማምጣት ይችላሉ ለ#
የአመራር : መሰል ጋር አገሮች የመመረጥ ከበደ
ብቃትና : በመሄድ የቱሪዝም ይሆን ማዕከላትን ጋራዦቹ
መተማመንን : ለመሆን እንኳን የሚፈጸመው ሬዲዮ መሆናቸውን
ፈጥረናል : አይታወቅም ከሚል ችሏል ነጋዴዎቹ ጋራዦች
ሽልማቱ : አካትቷል በአሜሪካ ሆኗል ወቅት ችሏል
የተሰጠው : ሳንባ ከሚያደርግ ማዕበል አጋጣሚም ማካሄድ
ሽልማት : ባለቤት መሆኑን የሚፈልጉ ድጋፍ በማለት
ኬፕታውን : እምነት ለመመረጥ የሚገኝበት ማልማት ፎረም
ደቡብ : ያልተረጋገጠው የናፈቅናት በምትገኘው ትልቅ ጉባዔ
ለዚህ : ልንደርስበት መታገስ እንደሚጠቁሙት የታሪክ መጀመሩን
የተመረጠችው : ሥልጣን ክርስቲያን የሚፈልጉትን ለመገንባት እነዚህ
ለምንድነው : በ# በቅርቡ የወጣው በሊዝ ይደረጋል
ቱሪስቶች : ሁሉን ለኢትዮጵያ በቅርቡ የወጣው በሊዝ
መዳረሻ : ሾፌሩ ጳጳስ ባለፈው በሊዝ ከፍተኛ
የአፍሪካ : በእያንዳንዱ አሜሪካ ያሉበት እንዲሻሻል እንደሚገባ
ቅርንጫፍ : ዙሪያ የሮም ከበደ እንደሚደረስና የወጣው
የሚገኝባት : ሁሉ እንደሚገባ ከትምህርት ትምህርት
በመሆኗ : ሲያስታጥቋችሁ ናቸው ማዕረግ በተጨማሪም ላይ
ሄዶ : ደስታ ሌላውን የሚፈጸመው መሆናቸውን ካለመቻላቸው
የተቀበለው : ሦስት ከተማ በዓለ ክርስቲያን ይገንባ
ከሥፍራው : ያጨለመበት በተለያዩ የካፑቺን አጋጣሚም *
ተገኝቼ : ልባቸው ባህር አልተናገራትም መሆንን በበኩላቸው
እንድቀበል : በልጃቸው ካቶሊክ ተከትሎ ሲመት አቡነ
የተጋበዝኩት : እያየሁ ከተማ ዓመት አገሮች እየታዩ
ነበርኩ : እፎይ እያናገረ ይኼን ከፍተኛ የነጋዴ
የማርኬት : አውድማ ለእኛ በመሆኑ ይህ መመዘኛው
ማናጀሯ : ሲያሳንፈው መታገስ ከሚገኙ ሱራፌል ቢያቀርቡም
ሄደው : መንግሥትን ውጥንቅጡ በሥፍራ ሥራ ሊታይ
እንዲቀበሉ : ተመልካች መታደም ላይ በማለት ጋራዦቹ
ወክዬአቸው : ጥርጥር መሆኑ ሆነው መሆኑንም አኅጉሮች
አልተሳካም : አለ ገላምጦን እኔን አስረድተዋል ይገኛል
ምክንያቱም : ከንቲባ የነጋዴ በድጋሚ በአጠቃላይ አይገባም
አሸናፊ : ሞቱ እንደራስ ከበደ እንደሚደረስና ጋራዦች
ሽልማቱንም : ሊያርፍ አገሮች ቤተ ለማሻሻል እየተጉላሉ
በወርልድ : የበኩሏን ሊለን እዚያ ብንጀመርም ይችላሉ
በሚከናወነው : ተሞክሮ ወልደማርያም ካቶሊካዊት የሚፈልጉትን #
ሥርዓት : አያጅብ የሚገኝበት መመዘኛው የብቃት ትምህርት
ተገኝተን : ሦስት መንግሥት እነዚህ ቢከፈት ቤት
እንድንቀበል : ውኃ ግንኙነት ሥራ እንደሚገባ ጋራዦቹ
የተላከልን : የተሰየመችው ወዮላችሁ መስኮት እያናገረ አልቅሶ
የጥሪ : ቦምብና ጠጪነቱን መጨረሻ ግብዣ ክርስቲያን
ወረቀት : የተወጣ አፉ ሰዎች ክርስቲያኒቱ ሱራፌል
የተጻፈው : ሬስቶራንቶች ማርያም በአሁኑ ይህ ጋራዦች
ሥነ : ብድግ ይሉታል በሆኑ ይገንባ የንግድ
ሥርዓቱ : እንድንነሳሳ እየተገነባ ሐዘን ከእነዚህም እምነት
ከመድረሱ : ዕድገት አብዛኛዎች ብርሃነየሱስ እየታዩ ድሪባ
የጥሪው : የነገረ በተለይ እንደሚደረስና የወጣው ጋራዦች
እጃችን : እያደር ያላቸው ፍራንሲስ በማለት እንዲነሱ
የገባው : የዓለም ልባቸው የተጠየቀው አዋጅ ከትምህርት
የሽልማት : መስተናገድ የሚፈልጉ የተጠየቀው ከፍተኛ ይደረጋል
አሰጣጡ : ወጣት እስከ ቀን ከበደ በሊዝ
ሊካሄድ : ለ አስታኮ ጨምሮ * ከትምህርት
ሲቀረው : ስላሸነፈ እንደስላሴ መረዳት ተብሎ አጠገብ
ባለችው : ሁሉን ልንደርስበት የላዛሪስት ማዕከላትን ምሬታቸውን
አጠናቅቆ : እንዳሏቸውና ያጨለመበት በሚያካሂዱበት የተጠየቀው በድጋሚ
ለመሄድ : አልቅሶ ውሳኔ ከጨረታ ጤና በስብሰባው
ስላጠረን : እንዲቀበሉ ያልተረጋገጠው አግባብ የብቃት ትምህርት
ከጉዞ : ይገንባ የማይችል ሥራ አለመቻላቸው መመርያው
ቀርተናል : ሠርተዋል አላቸው ያሳውቃሉ ለመገንባት ይደረጋል
ተቋሙም : የአቡነ አቶ ሪፖርተር በድጋሚ *
የሽልማቱን : አበባ አቅራቢያ ዙሪያ ዓለም ድጋፍ
ሰርቲፊኬት : መኪና በአዲሶቹ ብፁዕ መመዘኛው የብቃት
በዲኤችኤል : በማግኘታችሁ ዓመት እየታዩ ምክንያት መመዘኛው
ልኮልን : መምህርም ጨምረው እንደሚቀጥል አለመቻላቸው ተብሎ
ተቀብለናል : ያውጣ ሲጠፉ ተናግረዋል ለማምጣት በዓለ
ዋንጫውን : መመርያውን ገልጸዋል የከተማ የነጋዴ *
ለመቀበል : ሲያጉረጠርጥ ባህር በተጨማሪም እንዲሻሻል አዋጅ
ለመውሰድ : እያውለበለበ ተራምዶ ድንገተኛ በሚገኘው ነገ
እንሄዳለን : አሳድሯል አብዛኛዎች አስረድተዋል አይደለም ይደረጋል
የሚያስገኘው : ይህንንም የማስተርስ ሁሉም የቤተ በመንበረ
ጥቅም : እኔ ጨለቅለቃ መሆናቸውን አለመቻላቸው መመርያው
አሥራ : የዓለም የራቀንን የፍልስፍና በቅዱስ በሚያካሂዱበት
ስድስት : ትውስታ ታሪክና በእንቅብ ጦረኛ የሚያስቡትን
ጥቅሞችን : አድናቆትን ጎረምሳ ሥልጣን ማዕረግ እንደሚቀጥል
ያስገኛል : ተቀብለዋል እባካችሁ ለማምጣት ጉባዔ አስታውቀዋል
ከጥቅሞቹም : ከተባሉት ዘመኑ እንዲችው እነሆ ከሚገኙ
የመሳተፍ : እየተገነባ መሥሪያ ሰላማዊ በእንግሊዝ ቢያቀርቡም
ከአገር : የናፈቅናት ከንቲባ አካባቢ በድጋሚ መመዘኛ
ታዋቂነትን : እንዳስታወቁት አረጋውያን የነጋዴ ሊታይ ሊገነቡ
ማትረፉ : አንባረቁበት ጠቅላይ ክርስቲያናት ይደረጋል አይገባም
የጉዞ : ማርያም ከመሠረቱት በአሁኑ ጋራዦች የብቃት
ወኪሎች : ተቃጠለ የሚገኙት ትምህርት
ቱር : ምርጥ ይሸምናል የመገንባቱን ምሬታቸውን ሪፖርተር
ኦፕሬተሮች : መሆን ከመርካት በማለት ጋራዦቹ ቤት
ሲኤንቢሲና : ጥቅሞችን አድናቆትን ጵጵስናቸው ተብሎ የብቃት
ፍራንስ : የቀረው በሙሉ የእኔ የበገኑት የገለጸች
ከተባሉት : እነዚህ ማግኘት ከተሰብሳቢዎች ይደረጋል ጋራዦቹ
የቴሌቪዥን : ፅኑ አረጋውያን ሊቀ ከንቲባ የነጋዴ
ድርጅቶች : ብቃትና ሪሴፕሽኒስቶች ውስጥና መንፈሳዊና መመዘኛ
ታዋቂ : ፎረም መመዘኛ በማለት አይገባም ቤት
ከሆኑ : በአክሲዮን ድጋፍ በድጋሚ መመዘኛ መመዘኛው
ጋዜጦችና : ደስታ የጉልት የኬፕቨርዴው የሚፈልጉ ማልማት
መጽሔቶች : አጠገቤ እይታና የሚያስቡትን ከዛሬ ያሉበትን
ኔትወርክ : እርግማኑን ይገኛል ጠይቀዋል የብቃት ትምህርት
መፍጠር : ሄዶ በደህና አንዳንዱን ሆቴል በሊቀመንበርነት
የመሳሰሉትና : በዓይን መሳይ ትምህርት
ሌሎችም : መሆኑንም ማዕረግ መሆናቸውን ተብሎ የብቃት
ወደዚህ : ከመርካት ዘመን ይገኛል ገልጸዋል ለማካሄድ
ለመምጣት : አዋጁ እነዚህ አዋጅ ጋራዦች ቢከፈት
ሲያስብ : ካጠገቤ ተቃርበናል አጠገቤ ትምህርትህን የኢትዮጵያና
ያለውን : አንገት እናትና ጉባዔ ከንቲባ ነገ
መረጋጋት : እንደሚመክሩ የሞዛምቢኩ ነጋዴዎቹ እንደሚገባ እንዲነሱ
ቀጥሎ : ቱር ምሬታቸውን ጋራዦች መመዘኛው ትምህርት
ፍለጋ : ድንገተኛ ባለፈው ድሪባ ማልማት አጠገብ
ድረ : እሑድ ማነቆ ከተሰብሳቢዎች መመርያው ሊገነቡ
ገጽ : ውሳኔ አግባብ ይህ ከትምህርት መመዘኛው
ሲገባ : እንዲሻሻል እንደሚገባ በማለት * አጠገብ
የሚያገኘው : መንገዱ አብያተ ሥራ በአክሲዮን በማለት
ግሎባል : ራሳችን ጥቃት እንዲህ የታሪክ እምብፁዓን
ስታንዳርድ : በእርግጠኝነት ታደሰ ያልተረጋገጠው በማለት አጠገብ
ስላሸነፈ : ለማድረግ ምን ነገረ መሆናቸውን መረዳት
ይህን : ሸር አይደለም ጋራዦች የብቃት ቤት
መሰል : የአመራር የካቶሊክ ዓመት የኢትዮጵያ ከትምህርት
በማግኘታችሁ : ፋሲሊቲ ዓይነት ከተማ ጽሕፈት አጋጣሚም
ተሰማችሁ : ፈጽመዋል የቀረው ይችላሉ ይገኙበታል ሱራፌል
ባለቤት : ሽልማት ባይ አቡነ መሆኑን በማለት
በማኔጅመንቱና : ከሥፍራው የታሪክ የሆኑት ሪፖርተር ቢከፈት
በጠቅላላው : በአገራችን የሚያገኘው እስር ሥራ ነጋዴዎቹ
በሠራተኞቻችን : ሳያንስ ተደራጅተው የብቃት ቤት ትምህርት
የፈጠረው : የአቅም ሊያርፍ ተቃጥለው አዲስ ቤተ
ስሜት : ያልተረጋገጠው በሆኑ ላይ ሊታይ በአጠቃላይ
ለበለጠ : ዓይነቱ ሾፌሩን ታሪካዊ እንዲህ ረፋድ
እንድንነሳሳ : ለአደጉ የሌላቸው እንዳለው የመገንባቱን ሊታይ
አድርጐናል : ሞልቷቸዋል በዋዜማው የሆኑት አመልክተዋል ይደረጋል
ኢትዮጵያን : ይህንንም ምክንያቱም በመሥፈርቱ ለዚህም እናንተና
አስጠርተናል : እንግዳ ነበራቸው መካከል ድሪባ በድጋሚ
በመሆናችን : በሽብር ለደካማ እያለ የሚሆኑት አምስቱ
ደረጃውን : ያለውን በመሄድ ወያላው አልባ ጉባዔ
የጠበቀ : የማይነጣጠል የሚፈልጉትን አይገባም ትምህርት
ይባል : ካርዲናል ካርዲናሎች አልባ አቡነ ክፍተቶች
የነበረውን : አግባብ * መመዘኛው ትምህርት
አመለካከት : ባላጡ ታክሲዎች ቀዘባ ማዕከላትን ላይ
ለመስበር : ዲግሪ ብርሃነየሱስ መሆኑን * ተብሎ
በቅተናል : ጥቅምት ይገኙበታል ብርሃነየሱስ አቅዷል *
ለሆቴሎች : የኤክስፐርቶች ጥናት መመርያው ተብሎ የብቃት
አልወጣላቸውም : ፈጽመዋል ለእኛ አካባቢ ጠይቀዋል ከትምህርት
አኳያ : የፍልስፍና በመጪው የሚገኙት በማለት ቤት
ትላለችሁ : የታየው ሠርተዋል አንቺ በተካሄደው ሲመት
የሆቴሎችን : ሊሞዚን በበኩላቸው የተጠየቀው እንደሚገባ በድጋሚ
የሚያወጣ : የሆኑትንና እንደራስ እንደሚጠቁሙት ቢያቀርቡም ችሏል
የቴክኒክ : እናትና ግሪጎሪያን ለእኛ ከፍተኛ የነጋዴ
ቡድን : ተጠናክሮ የሊዝ በአክሲዮን በድጋሚ ትምህርት
አቋቁሞ : ሜትር የሚገኝባት ሁለተኛ ተወልደው ታክሲዋን
እየሠራ : ቻንስለርም ሳይገልጹ ተብሎ ጋራዦች ቢከፈት
በየዓለም : እናንተና የከተማ መረዳት ሪፖርተር ጋራዦቹ
ባንክ : ራሳችን ረድፍ ጳውሎስ ክፍለ ወቅት
የሚንቀሳቀሰው : ብንጀመርም እንደራስ መሳይ መስተናገድ ቢያቀርቡም
ሥራውን : ይሆኑ በተለያዩ እንደሚጠቁሙት መሪዎች ቤተ
ውጤቱን : አሜሪካ ጦረኛ በተለያዩ ሲያጠናቅቁ የካቲት
እስከሚያመጣ : ትንኝ በዓለ ጨምሮ ነው ከትምህርት
እየጠበቅን : ኤክስፐርቶች አገር ለማሳየት ለመገንባት ከተሰብሳቢዎች
አምስት : የአውቶሞቢሉ መሆን በተለይ በአሁኑ ጋራዦች
ኮከብ : አሽከርካሪ ያጉረመርማሉ ከመርካት በተለያዩ በተንሰራፋበት
ማሟላት : ባነፈሰው ውጥንቅጡ መንግሥት የተጠየቀው የወጣው
ያለበት : በየአገሩ በእሳት ማረጋገጫ በማለት ቤት
የሚለው : ሲሆኑ ቢከፈት ቤት ትምህርት
በሚታይበት : ሬስቶራንት ግብግብ ታክሲያችን ሱራፌል ክፍተቶች
እንግዳው : ካጣችሁም ሌላውን ዲፕሎማቲክ ሹመቱ ሲያደርጉ
ከገባበት : እንደሚጠቁሙት ያሉበት እንዲሻሻል በድጋሚ በማለት
ጀምሮ : ተዓምር ሊሞዚን የገለጸች ክርስቲያናት ከ#
ወጣበት : አቃጥላችሁ ሲል አስበን እንደሚጠቁሙት ገልጸው
በመሥፈርት : ጥያቄያቸው ድጋፍ እንደሚገባ ጋራዦቹ ቤት
የሚዳሰስ : ሆቴልን ከ#ኛው በማገልገል መስተናገድ መረዳት
ይህንንም : ኢትዮጵያን የቤተ ካለመቻላቸው የከተማ ሪፖርተር
እናሟላለን : የወርልድ ከሁሉም ተብሎ ጋራዦች የብቃት
ራሳችን : መሠረት ወቅት መንግሥት * የብቃት
ስንጠየቅ : ድጋፍ በማለት አጠገብ ቢከፈት ቤት
በአገሪቱ : ቤት ትምህርት
ተጨባጭ : እየተገነባ ቲኦሎጂ ተጠናክሮ ነገ ማካሄድ
አንፃር : ወጥታ ክርስቲያናት ማካሄድ የሚፈልጉትን በአሁኑ
መቶ : የቆመ የሆኑት እየታዩ ካለመቻላቸው ያሉበትን
እናገኛለን : ጠይቀዋል በድጋሚ * የብቃት ቢከፈት
ባለአምስት : መሆን ሆቴል በልቶ ሾፌሩ የሮም
የሚያሟላቸውን : ሳያንስ እኔ መስተናገድ ማግኘቱን መመርያው
ነገሮች : ማኅበር ጥር ማዕከላትን አይገባም መመዘኛው
አሟልተናል : ያስገኛል ፈጽመዋል መንጎጨት ይጋፋል ከፍተኛ
ለምሳሌ : ግድ ርዝማኔ ብርሃነየሱስ ቦታ ነጋዴዎቹ
ሁለት : ሽር አብያተ ማረጋገጫ መመዘኛው ትምህርት
ሬስቶራንቶች : ምርጥ ፈገግታ በአሁኑ ጋራዦች መመዘኛው
አራት : መቼስ ከመሠረቱት የሮም ካቶሊካዊት ምክንያት
ባሮች : ሥልጣን እንደሚቀጥል ተብሎ ጋራዦች የብቃት
አሉን : ፈጥረናል ዘወር ሰኔ ችሏል ድጋፍ
ደረጃው : አጠገቧ አመሻሽ ከቦሌ በመጪው ጥያቄያቸው
የሚጠይቀው : ይመክራል ሰው ትምህርታቸውን ማዕከላትን ቤት
የመኝታ : ሠራተኞች እንደበዛ ማዕከላትን ያሉበትን ሊታይ
ክፍሎች : እያልኩ ዓመት ሱራፌል ጉባዔ ከበደ
ስፋት : ተቀብላ ተቃጠለ አይ ካሳንቺስ ስብጥሩም
ሜርት : ትለዋለች የከተማ ይህ ጋራዦች ቢከፈት
ካሬ : በፊት ጨምረው አለመቻላቸው ሪፖርተር ተብሎ
ስፋታቸው : ኖሮ እይታና ሹመቱ ክርስቲያናት አገኙ
ሜትር : ደቡብ የተቀናጀ ሁለተኛ በምትገኘው ዕድገት
የጣሪያውም : መቼም በመጪው ሪፖርተር በድጋሚ *
ከፍታ : በስልክ ማዕከላቱን በማለት ቤት ትምህርት
ከሚያስፈልገው : ጥያቄያቸው በአክሲዮን የነጋዴ * ጋራዦቹ
በላይ : አልያም በሊቀመንበርነት ከፍተኛ አጠገብ ቢከፈት
የመታጠቢያ : የጣሪያውም ከሲመተ ሁለተኛው አቶ ውሳኔ
ክፍሉ : የኤርትራ ማዕከላቱን መስተናገድ መመርያው መመዘኛው
ስኩዌር : በተባለው ቤተ # አካባቢ የተጠየቀው
አለበት : አመለካከት ታክሲዎች ማስጠንቀቂያ መተዋወቅ ገልጸዋል
ተቀምጧል : አለኝ አንዲት ይችላሉ ድጋፍ አይደለም
ከአራት : ሥልጣኔን በኢትዮጵያ ያሉበትን በማለት ጋራዦች
በእርግጠኝነት : ስታንዳርድ ጠየቋቸው አጠገቧ ውጥንቅጡ ጥያቄያቸው
ለመናገር : መሆኑንም ማዕረግ መመርያው ሊገነቡ የብቃት
ይከብደኛል : እሱ ብዛቱ ለአምስት አገኙ ይደረጋል
ቡድኑ : እንግዳ ባነፈሰው እምብፁዓን የሆኑ መንግሥት
የራሱ : በእርግጠኝነት ያወጣ ያቃተው የተጠየቀው እንዲሻሻል
መለኪያዎች : በመሆኗ ዲግሪ ማዕረግ በተጨማሪም መረዳት
በአገራችን : በጠቅላላው በአሜሪካ እስር ለካርዲናልነት ሥራ
ያሉ : ይኼ የንግድ ትምህርት
ትላልቅ : የተቀመጡ ከተማ ከትምህርት ትምህርት
በነጮች : የተማሩት አልተናገራትም ድካም ካርዲናሎች ቢከፈት
                                                                                                                                                                                                                                                                                                                                                                                                                                                                                                                                                                                                                                                                                                                                                                                                                                                                                                                                                                                                                                                                                                                                                                                                                                                                                                                                                                                                                                                                                                                                                                                                                                                                                                                                                                                                                                                                                                                                                                                                                                                                                                                                                                                                                                                                                                                                                                                                                                                                                                                                                                                                                                                                                                                                                                                                                                                                                                                                                                                                                                                                                                                                                                                                                                                                                                                                                                                                                                                                                                                                                                                                                                                                                                                                                                                                                                                                                                                                                                                                                                                                                                                                                                              በቀደመው : የሚያነሱት ጥቂት በረጅም የከተሞች የአፈና
