ቀርተዋል : እንችላለን ለመሸሽ ይታያል ያብራራል ሰጧት
አስተሳሰብ : ስለእግዚአብሔር አንጣው በአሥር ወጣት አካባቢ
ነው : ችሏል ይሆናል የሠራተኛና በኢንተርናሽናል እላለሁ
ሆቴሎች : እንደጀመረች ኃላፊነትና የማኅበራዊ ኮሚቴውን ደግሞ
ታላላቅ : አክስቷ ማስፋፊያ የአካል ደግሞ የተመራው
ብዙ : ማጣትና ዓላማ የተመራው ከተመራ ታላላቅ
እላለሁ : ይጠይቃሉ ይሠራል ትለማመዳለች ታምናለች ተሸፍነዋል
የሚገኘው : የተላለፈው ባይገፋም እያከራየች ወላጆቻቸውን መውጫ
መመራት : የክለብ የሚያደርግ ብዙኃን ኢትዮጵያ ከሚገኙት
የሚያሳዝንና : ከብትንትኑ ደስታ ኢንስፔክተሩ ተሞክሯቸውን ልማት
* : በፕላዝማ እንዲያመጧቸው ጥቂቱ ማሳያ ኢትዮጵያውያን
የተሳሳተ : የይግባኝ ከበደ የሚተላለፉ ከተማ ትልቅ
ኢንተርናሽናል : አንዳንድ መመለሴ መካከል እንዲሆን ታላላቅ
መዘንጋት : ሊታሰብበት እንደሚመርጥ አያይዞ የምትመለከታቸውን ሸማቾችን
ከተመራ : ጠበቃ ጀምሮ ጉዳት የሚተላለፉበትን እያዩ
አመለካከት : ሰባት ድሬ የሰነድ አስፍቶታል ስልኳን
ይህ : ነውና በነፃ ሌላም የመረጠ አዲስ
እንዲሆን : አለመሆናቸውም መቀለጃ ሊባሉ ከክለብ የመዝናኛ
መካከል : ውስጥና ማስቲካና የቃል ምሳሌ በኪነ
አዲስ : በቁጥጥር አቀራረብ መቀረፍ አመለካከት ከተመራ
ምክንያቱም : ሀብታም አንዳንዶች ብለው ነገር ብዙ
ላይ : ያደገው ስነጋገር ብሮች በአገሪቱ የሚያስችል
በበቂ : ይዟት በሙያው ሲሠሩ ተወካዮችን በነጮች
እንዳሉ : ታደሰ አጠገቧ አቅም ተግባር ውጤት
አዋርድ : ካስተዋወቀችው እንዳይታይባቸው የመዝናኛ ከመሆን ስለምንም
አለባቸው : ይመርጣል እየሆኑ ተለያዩ ተናግረዋል አላቸው
ነጥብ : እስከሚያልፍ ትሥል ዕለት ፍላጎት ዘንድ
የሚል : ገደለ ኖረዋል ኢትዮጵያ መመራት እላለሁ
ያሉትን : ተናግሮ የተወችላት እንደሌለበት በወርልድ ይህ
ነገር : ከአየር በሬዲዮ ቤቷን የጎዳና ምክንያቱም
ባለው : ልብ ምሥራቅ ምኞትም ከተማዋ ግብዓት
አበባ : የተከሳሹ እጁን ዝግጅቶቹ ዜናዊ መካከል
የተረሱና : አመጣሽ በተጨማሪ እንዳትሥል ዜናዊ አበባ
የሚችሉ : የአፈጻጸም በመሆኑ አካላት ይመራ ማምጣት
ወንድሞቻችን : መዝዞ ለጉባዔው ተደማጭ ተዳዳሪዎች አንድ
ሆቴል : አምባሳደር ብዛት ከሚያዘወትሩ ጎልማሳ ግርግር
መምራትና : የእኛ የሕዝብን ወንድ ዴረሳ የሚል
አለበት : ተራምዶ የልጅ ሸራና ኪሎ ምንድነው
ብቃትና : መሰለ ዲጄዎችን አልነበረኝም የሥራ መካከል
ደረጃ : የተላከልን ቅዳጅ ክፍል ድንጋዩ በኋላ
የለበትም : ነበራቸው ተረጋገጠለት ይታያል በዛ አትመስልም
የወጣው : የሚመጡ የሚዲያና ጉዳተኞች ላይ መመራት
በነጮች : ሴራ ጳጳስነት ለብቻው መሆን ሲሠሩ
ትርፋማ : ዕውቀትና የተሻረውን ሴት ማስፋፊያ የሚዲያና
ዕድሉን : ወያላው ባማተሩ ሰዓት አስተያየት ሌግዠሪ
በወርልድ : መርሆዎች እንደጨርስኩ እንደሚኖረው አዘውትረው ባለሥልጣን
አላቸው : ትባላለች አይደሉም አለባቸው አስተሳሰብ ቀርተዋል
አቶ : በመልካም አሳሳቢ በበጀት ከነዚህ ከዚህ
ዜናዊ : ስለነበረው በቀለ የተረሱና አበባ ሆቴሎች
ሆኖ : ዓይነቱ አበባ ላይ መካከል መዘንጋት
አለ : ያስደነግጣሉ ትጀምራለች ተቀጥራ ጥር አለባቸው
ማምጣት : ለማቆየት ሥር የሚመሩት ተደራሽነት በኢትዮጵያውያን
ያለዎት : ባይባልም ካሉት በማለት ዓይነቱ የሚችሉ
የሚያሳፍርም : ኢትዮጵያውያን * የሚገኘው ብዙ ታላላቅ
ምንድነው : አንድን ያስደስታታል ተወግዶ አለበት በበቂ
የማድረግ : የሚንቀሳቀሰው የማይቀይራቸው ተደራሽ ተደራሽነት ማምጣት
ከሚገኙት : አዕምሮ ልጅ የተሳሳተ መመራት ብዙ
ኢትዮጵያውያን : አገልግሎትም የሚያሳፍርም * መመራት የሚገኘው
ግን : ገልጾ ከእንቅልፏ አስተኝታ በተለይ የማኅበራዊ
ዓይነቱ : ከተፈጸመ ሆኖ አበባ ላይ የተሳሳተ
አብዛኞቹ : ቀለም በተለይ የሚዲያ ግን ሆቴሎች
በኢንተርናሽናል : በማስታወቁ እንደሚኖረው ብቻ ውስጥ እንዲሆን
አሸናፊ : አመንቴና እነዚህም የተሳሳተ * መመራት
ሁኔታ : ሲከውኑት ያላደረሰና አዘጋጅ ዩኒቨርሲቲ ብሮድካስቲንግ
ችሎታ : ያስተላልፉ የመጣ ትሠራ በውስጣችን ሳያገኙ
የተነሳ : ከእያንዳንዱ እየሸጠች ወቅት ፈለቀ ያህል
ውጤት : ሽፋኖች የተመለከትኩትና ለማበረታታት ፍቅረኛዋ በጥምረት
ሳያገኙ : ኤክስፐርቶች የምትቆጠር መቀረፍ ችሎታ ኢትዮጵያውያን
መመራታቸው : መኮንን አስቀምጣ ባለሥልጣን ይመራ ትርፋማ
ውስጥ : ሬዲዮና አዘውትረው ዜናዎች ለማበረታታት ባሕሪው
ወይም : ይሠራ ሚስተር የተመሠረተበት በተከሳሽ የለቀቀ
በዚህ : በቤተሰብ የጎዳናዋ ማንኛውም የሚዲያ እነዚህም
መቀረፍ : ማሳዘኑ ሳያገኙ አዲስ አመለካከት የተሳሳተ
በውስጣችን : እንደስላሴ አነጋጋሪ ችሎታ ኢትዮጵያውያን የሚገኘው
እነዚህም : በሲንጋፖር ስፖንሰሮችን የሚዲያ አሸናፊ አቶ
የተመራው : በልቶ ለአማተሮች እያዩ ቅባ ጎልማሳ
ከፍተኛ : ለማሳየት የመጣ እየሆኑ በአገር ችሎታ
ሌግዠሪ : ቻይና የሕይወት አቋም ጋዜጠኞችና ትላለች
አስተያየት : ሊሆኑ ስለዚህ መዘንጋት ብዙ ታላላቅ
በኢትዮጵያውያን : የኮብል ግራፊክስ መውጫ ዓላማ ድጋፍና
የሥራ : የእንግዳ የሚሠሩ የሚገዙ ብቃትና ሆቴሎች
ማሳያ : የሚያሳፍርም * መመራት የሚገኘው ብዙ
የሚዲያ : አዲሶቹ ለእውነትና በሲንጋፖር እነዚህም አብዛኞቹ
ተደራሽነት : የኖረበትን ተደራሽ አካላት ማምጣት የሚችሉ
ጉዳተኞችን : አበራ አጋሮቹ ተጠያቂነት አቅም ጉዳተኞች
ደግሞ : በአስተሳሰባዊ ማስፋፊያ ኮሚቴውን በኢትዮጵያውያን ታላላቅ
አስፈጻሚ : አማርኛ በጎ የሚደርስ እንደሰጠ ሕጎች
ሰብረናል : አብዛኛዎች ሥላ አልቻለችም ተናግረዋል ቤቱ
ማኔጀር : ሸቀጣ የሠራተኛ ዳይሬክቶሬት ወንድሞቻችን አመለካከት
ዓ.ም. : የሚቀሩ እያዩ ታመራና ቀን የተመራው
ከዚህ : ጣራው በንጉሡ የሐሳብ ጀንበር ደብዳቤያቸውና
አካል : በዕውቀትና በሠርግ እጥፍ ሊሆኑ ማኅበራዊ
ማንኛውም : ከልማታዊ እውን ከነዚህ ሕይወቷ እነዚህም
ይመራ : ሊጋጭ ግርማዊ የሚችሉ ታላላቅ ነው
አንድ : ለጉባዔው ወንድሞቻችን ብዙ ቀርተዋል
ሚኒስቴር : ለስለላ የሚተላለፈው ይሆናሉ ሽልማቱ በውስጣችን
የሠራተኛና : ሆነ ተቀምጨ ገብነት ተግባር አስፈጻሚ
ጉዳተኞች : አስቀምጣ ተቋማቱ ጉዳተኞችን መመራታቸው የወጣው
በጥምረት : እንዲፈታና ልምዱን ከተዋወቀችው ታነሳና ውጤት
የሚያስችል : ብሎና እንዲደረግለት ጎልቶ ቢታይም በመጠኑ
ጥር : ተጣልተዋል አላብሰውታል ትባላለች አላቸው አለባቸው
# : ውድድር ከጎናቸው አገሪቱ የአሥር የማይፈቅዱ
በአገር : አሳፍሮ አለሳልሶ ከፍተኛ የሚገኘው እላለሁ
ችግር : ተወካዮችን ተቋም አስተሳሰብ ቀርተዋል
ተቋም : በማስከበር ወደ ወንድ ችግር የሚዲያ
ተጠቃሚነትና : መልዕክቶች ከአፄ ሸማቾችን ተዳዳሪዎች እንዳለባቸው
ባለድርሻ : እንደሚያሳየው እጅግ ለአድማጭ ጥሪ አመለካከት
መተካት : የተጠቀሱትን መዓዛ ዘዬ ቅር በኢትዮጵያ
የተቋቋመው : አልፎታል አቁማ የአንድ ሲሆን *
ለመፍታት : ካይሮ እንዳይሆን ባሕሪው አካላት የሚያስችል
ይኸው : ከጤፍ ስሜት ታወሳለች ሥዕሎች የማድረግ
እንዲሁም : ሌላው ለሚያቀርቡ ኪንን ገድቦኝ ጥሩ
ከሚመለከታቸው : ሊያደርስ ሸቀጣ ዓይነቱ ሆኖ እንዳሉ
በምትኩ : ቢከብድ እንዲህ ሚኒስቴርና የሚችሉ የተረሱና
በቶሎ : አድናቆትን ሳትጠቅስ ከሌት በወቅቱ ጥቂት
እንደሚኖርበት : ኧረ ክለቦች በመሥራት አይለኝም እንዳጋጠማት
ተቋቋመ : እንዲሁ አይመለከትም የታሸገ አየር ዲጄ
ኮሚቴውን : ሥፍራ የኮፒራይት ለመጋበዝ ኃላፊነትና ደግሞ
ባሳተፈ : የፖለቲካ አፍንጫ የመሣልና ትርጉም ጥግ
የኢትዮጵያ : ሁለቱን ቁሳቁሶች መሀል ረገድ ወንድሞቻችን
ማኅበራዊ : በመመርመር የተራቀቀ መንገደኛው ለማቃለል አካል
ጉዳዩ : ከዓለም የሚጠበቅባቸውን ማቅረብ በአጭር እርግዝናዋ
የአካል : ለመዳር ማንቆለጳጰሳችን የሚሠራ ድጋፍ ታላላቅ
ናቸው : የለብለብና ዓመታትን የአገራችን መሆናቸውን ዜናዎች
ማኅበራት : ይንጨረጨራል እንዳለባቸውና ግለሰቦች ተቋማት ብሮድካስቲንግ
የሚዲያና : ዕፅ ምስኪን የሚወረወረው ተሳፋሪዎች የሚመጡ
ሳይሆን : አል የሚቃረኑ በተጨማሪ ሆኜ የተረሱና
ሽልማቱ : ወዳጅዋ ሲባል አንዳንዴም ሚኒስቴር ምንድነው
አካላት : የአፈጻጸም መፍትሔ በሕገ የሚችሉ መመራት
ፎረም : አንድነት ሠዓሊት የሚመላለሱ ውስጥ ነጥብ
ተወግዶ : የማጋለጥ በዛሬው ከፍርድ ምንድነው በነጮች
ባለሙያዎች : እየጠበቅን ገረባ ለማድረግ ሳያገኙ የሚያሳፍርም
ተወካዮችን : ሳንቲሞች ችግር በበቂ የሚያሳዝንና አስተሳሰብ
ኢንተርኮንቲኔንታል : ጥረት ገድቦኝ ጉዳተኞችን ዓይነቱ ላይ
ቤቱ : ተማፀነች የተወለደችው በኋላ የመንግሥት ሰብረናል
መሥሪያ : ተነስታ ከወረቀቱ መልኩ የመረጠ በአገር
ቀን : የውጭ የሚቀሩ ይደበድባት በኢትዮጵያውያን የተመራው
ጉዳይ : ሆነና ይበጅ ምክንያቱን ፍላጎት የኢኮኖሚ
የሚለው : በጎራዴ ሥራዎቿን ዓይነት ተረፈ ውጤት
ሚኒስቴርና : የቴሌቪዥንና በምትኩ የሚችሉ መዘንጋት ነው
የሚለውን : ወገን ቁሳቁሶች የአካል የኢትዮጵያ ተጠቃሚነትና
አኳያ : የሚቃረኑ የፍርድ ዮሴፍ ተቀምጠው ይኖሩበት
የመረጠ : መቅደላን በቀረበው በደረሰው ይህ እላለሁ
ብሮድካስቲንግ : አገላለጹ አቤቱታቸውን ሊቀርብ ትከታተል ሁሉ
ሲሆን : በሕይወቷ ዕረፍት የሚቃኙ አሉ የተቋቋመው
ኮሚቴ : በኢትዮጵያ ስለዚህ ዓላማ መተካት ይህ
ባለሥልጣን : የአኗኗር ባልዘመኑ ሠራተኞች በወርልድ የሚችሉ
የሚመሩት : የወንጀል ለማበረታታት ሥር ተደራሽነት ማምጣት
መልኩ : ነባራዊ እንደሚገባና ቀን መሥሪያ ሳይሆን
ኢትዮጵያ : ሌሎቹም ከተፈቀደለት መሠረት የሚል መመራት
ተደራሽ : ለመፈጸም ተደራሽነት የማድረግ ማምጣት የሚችሉ
ገልጸው : ኑሮ ቀን በኢትዮጵያውያን ወንድሞቻችን የተሳሳተ
ችግሩን : ያላትን በማንኛውም በረዳት መፀዳጃ ባጠቃላይ
ተግባር : ሲያዋክቡት ለመጠቀም አስከባሪዎች እህል የተመለከትኩትና
ተጠቃሚ : ሴትዮዋ ሄዶ ከተፈቀደለት ልክ እንዲወስድ
ተፈጻሚነት : ነገ የሆቴል ማጽዳት ለመውሰድ የመንግሥት
ድጋፍና : ከምትደረድራቸው በኢትዮጵያውያን ወንድሞቻችን ብዙ ታላላቅ
በማቅረብ : በሚያዘጋጃቸው እያሉት ተጠቃሚነታቸውን የሚመሩት ማምጣት
ይሆናል : ችሏል ነው አስተሳሰብ ቀርተዋል
እንዲያካትቱ : ሥፍራዎችዋ ቢሊዮን በኮፒ ተደራሽ ተጠቃሚነትና
ተጠቃሚነታቸውን : በማቅረብ ተደራሽነት ውስጥ ውጤት እንዲሆን
ያህል : የአሁኑ ሸራና የተነሳ አለበት ሆቴሎች
ዓላማ : እንዲላክላቸው ማጣትና መስመር ብዙ ታላላቅ
ክትትል : መቼ ሲኮበልሉ ባደረገበት በመጥለፍ ኤም
ስለዚህ : መሸፋፈን አስደርጎ ሚዲያ አስተያየት ይህ
ዘንድ : ዝንባሌ ነጋሽ ምን ነጥብ ይህ
አስተዋጽኦ : ግንኙነት ከተለያዩ ሲደገፍ ዓላማ የተመራው
ዳይሬክቶሬት : ተጨማሪ ሥልጠና ምቹ በብዛት የፖስተሪቲ
የማኅበራዊ : የሚያወያዩ የተለያየ የሚያስቸግራቸው ሲመለከቱና ትሠራ
መረጃ : የሚመለከት ያወቁት የምክር ብታገኘም የተመራው
ተቋማት : ይንጨረጨራል ስለተባለ ዳር ማኅበራት የተመራው
ማስፋፊያ : አክስቷ ደግሞ ታላላቅ ሆቴሎች አስተሳሰብ
ዴረሳ : ወራት አልነበረኝም ፈለቀ መምራትና ኢንተርናሽናል
የሚያረጋግጥ : ለመናገር ሊኖረው የሚሰጧትም እጥፍ ዳይሬክቶሬት
አቀናጅቶ : ጥያቄ ድርጊት እስከተቻለ በመከታተል በክለብ
በመንግሥትና : ልምዱን በድጋሚ ማዕከል የአእምሮ የሚለውንና
የመሥራት : ዜጋ ከባድ ሠራተኞችን በሕፃናት ተዳዳሪዎች
ደህንነት : ከ# ብትመረቅም ኢንተርናሽናል ታላላቅ አስተሳሰብ
እንዳለባቸው : አቀባበላችን መላክ ተዳዳሪዎች ወንድሞቻችን ብዙ
ረገድ : እንድትማር ቸርቻሪዎችና ለመፍታት በኢትዮጵያውያን የሚችሉ
የበኩሉን : ሒደትንና የነሱን ሚኒስቴርና የሚችሉ እንዲሆን
ኃላፊነትና : የኮፒራይት ኮሚቴውን ሆቴሎች አስተሳሰብ ቀርተዋል
የማስተባበር : ሁላችን ክልክል መንግሥት ጊዜያዊ ዕፅና
ብዙኃን : ዓይነ በሌሎችም ጥሪ መመራት ብዙ
ለማቃለል : የታወከ ማኅበራዊ መካከል የሚያሳዝንና ቀርተዋል
ለአካል : እያንጎራጎሩ ተሳፋሪዎቹንና እንደጀመረች እንደሄደ ሥዕል
እንዲሆኑ : የተወጣ ራስን ድክመት እንድትሆን እንደቆየ
የመረጃ : የተወጣ የሚጠልፈው ራስን በወሬ መርምሮ
በኢትዮጵያ : ኮሚቴ መተካት በኢትዮጵያውያን የተመራው ሳያገኙ
የመገናኛ : ባለሁበት በመጠቀምም ቅባ በ# ምክንያት
ፈለቀ : በጨርቃ ወቅት የተነሳ ዜናዊ አበባ
ጥሪ : በአትኩሮት ተቃዋሚ ባለድርሻ መቀረፍ የተሳሳተ
ተረፈ : በመጀመሪያ እንደሚጠቁሙት የእሳቸው የተመለከትኩትና እውቅና
ዳይሬክተር : ክፍለ የሚያስረዳ የሱ የመሰሉ ተማሪ
ሲሠሩ : ገልቱነት መደበኛ በበቂ አስተሳሰብ ቀርተዋል
ምን : አለመሆኑንም ከሦስት ዝንባሌ ነጋሽ ዘንድ
ተቋማቱ : በነፃነትና የባለአደራ ጉዳተኞች መመራታቸው በወርልድ
ትልቅ : የመግባት የሚገቡ የሚያጣላቸው ያሉት የተሳሳተ
ግንባታ : ቦታው መረበሽ ልጅ ቢጤዎች አካላት
በግል : እባክህ የሚመልስ የሚሰብክና አደንዛዥ ባለድርሻ
ሚዲያ : ትክክለኛ የሚደረገውን ገፀ ስለዚህ መዘንጋት
የሚያደርግ : የሐሰት አስተዋፅኦ የምታገኝበት እንዲወስድ መመራት
ለቆሙለት : እያከናወኑዋቸው ሬዲዮ አለ ብቃትና መካከል
ልማት : የሚፈልጉ አልቻሉም አብርታ የሚያሳዝንና ታላላቅ
የማኅበራዊና : አደጋ ማኅበር ሁሉንም ባሕሪው ዳይሬክቶሬት
ጀምበር : ሞልቶ አስሮ የምትለዋ ኤም በእርጅና
የኢኮኖሚ : ከመቆም በስተጀርባ የምናቤን ግርግር መሬት
የሚለውንና : ባነፈሰው እግዚአብሔርና ባለአደራ በመንግሥትና ኮሚቴውን
ሁሉም : ማቅረባቸውን ተጨማሪ እየተጣሉ በመንገዱ በመሆኑ
ተጥሎባቸዋል : ሳይከዳው ስላልተጨናነቀ አላለፈችም እንዳለው እንዲሆኑ
አቅም : አጋሮቹ በድጋሚ ጉዳተኞችን እንዳሉ ላይ
አቅርበዋል : ታወቀ ይካሄዳል አፈጻጸም አይደሉም አላቸው
በስፖንሰር : ድረ አባ ላያቸው አበሻ ሌሊት
የሚኖሩ : ስልክ አቅጣጫውን መተላለፊያ ጠብቀው ወንድሞቻችን
ከሚዲያው : እንዳይጠብቃቸው ቅሬታቸው ቀጣይነት የሚሸጥ ትከታተል
ኤሌክትሪክ : ተቋሞች ብርና እንደነበር የአምስት የነሱን
መንግሥቱና : የማይነጣጠል መፀዳጃ ይዘው ሚዲያ ጥር
ለፊት : ትሰጣቸዋለች በምትማርበት የተሣለውን ሬዲዮ ሕንፃ
ፕሮግራም : የምድር በበረራ ገልፃ ብርና ገንዘብ
ገልጸዋል : ይገኛል ሲለምን ለፍርድ በመከታተል የብዙኃኑን
ተስፋ : ሊሰጠን ሲነፃፀር ተደራሽነት ሌግዠሪ አስተሳሰብ
የብሩህ : ነፍስ አርት ጠይቁኝ መልዕክቶችን ጎዳና
የሠራተኛ : ካፍ እንቆቅልሽ እየጨመረ ማኔጀር ወንድሞቻችን
በተለይ : ቀጥሎ ለእውነትና በፓርቲዎች ማለትም ቀለም
ጥግ : በስተጀርባ አቀርቅሮ በመጠቀምም ዲጄ መስመር
የሚመላለሱ : ስማ ፎረም የተረሱና መመራት ብዙ
የሚነግዱ : ሊፈታ እንዲኖረው አገልጋዮች ታደሰ ውጤት
ሸቀጣ : ድር ማኔጀር ተደራሽነት ሌግዠሪ ወንድሞቻችን
ሰዎች : ጎሽ ፍቅር አኳያ አሸናፊ ከሚገኙት
ለማድረግ : ስላሸነፈ ምክንያትም ባለሙያዎች የሚያሳፍርም ወንድሞቻችን
ቁጥር : ሸራ ሰፊ የሚታየው ሲአርኤስ ያላቸውን
እንደቆየ : የመንፈስ እንደደረስን በማጋለጥና እንዲሆኑ በወርልድ
የተመረኮዘ : የሚገመተውን የዛሬን ሙያዊ የመሪነት ከሚሞት
የመንገደኞች : ልማታዊነት የሥር እንዳልቻለ በሕፃናት በኢንተርናሽናል
ይዘው : ያላትን መፀዳጃ አንፃርና ሕልሟ አብረው
ቢኖሩም : ያጨለመበት በመምራት ለመንግሥት የሚጫወቱበት ገዝተው
ጠብቀው : እንደሚመስል ለመዳር ግልጽ ሲመጡ ጀርባ
ሊሆኑ : ያለማመን ዳኝነት ድሬዳዋ ለልመና በሠርግ
መተላለፊያ : የአንዳንድ ዜማዎችን ሊስትሮዎች የሚኖሩ ድጋፍና
ሕጎች : ቆይታችሁ ግልጽ እፈልጋለሁ ማስፋፊያ አስፈጻሚ
ሕንፃ : ገዥው የገዥው ተደማጭነታቸውን ከ# ደህንነት
ኃይል : እያለ የኅትመትና ኢንሹራንስ የሚችል እሙን
ቢጤዎች : ሞላ ታዳጊዎች ውጤት በወርልድ ሆቴል
በሳምንት : እንደጨርስኩ ፍሬያማ እሱ ሴት የሚዲያና
ብቻ : የሚያስቃኝ በማስታወቁ ለማስገባትም የፒያሳ በኢንተርናሽናል
ቸርቻሪዎችና : ረገድ አካላት የሚችሉ የሚገኘው ታላላቅ
በጎዳናው : ባስተላለፉት ልጄ የሌላት ዕድሉን መዘንጋት
የነሱን : ድረ ያላደለው አደባባይ ከመጠን መንካት
ሬዲዮ : ገለልተኛና ቤቢ የሕይወቷ ለቆሙለት በቶሎ
በሕገ : ጎጆ አካላት በወርልድ ብዙ ታላላቅ
ኃላፊነት : ድሬዎች በማያሟላ በአንድ ቅባ ከተማ
እንዳለው : እንዲመለከቱት ምዕራፍ ስንቸኩል ብሎና የሚመሩት
በሌሎችም : ካጡ ታነሳና ብዙኃን በጥምረት በኢትዮጵያውያን
ክፍተት : አገር ባሕሪያት ባለሙያዎች የሚያሳፍርም ወንድሞቻችን
ሲደገፍ : ቅጣት ከተለያዩ ሳይቀር ወደተባለ አስተዋጽኦ
ሆኖም : እንድታስተናግድ ሕልሟ አስተያየት ሳያገኙ ዕድሉን
መውጫ : በኢትዮጵያውያን የሚገኘው አስተሳሰብ ቀርተዋል
ተዳዳሪዎች : አቀባበላችን እንደሚሆን ወንድሞቻችን ብዙ ቀርተዋል
እንደሚገባና : ሕፃን መልኩ አቶ የሚል የሚገኘው
ፒያሳ : የሚችል የሠርግ መሥራት ኃይል ረገድ
የተወሰኑ : የሚያንፀባርቁ ጎልማሳ ሊሞላት መተካት መቀረፍ
የመንግሥት : ይታረም ማጽዳት ቢቀርቡም ከስድስት ተማፀነች
ጊዜ : ሥዕል የመገናኛ ረገድ የሚገኘው አስተሳሰብ
የግል : ማድረግና ግቡ መረጃዎችን ስለሆነ መሀል
የሚተላለፈውም : የተንሸዋረረ ቦርድ ዲጄነትን በነበረው እንዲሆን
ተጠያቂነት : የሥርዓቱ ጉዳተኞችን ወንድሞቻችን አዋርድ ምክንያቱም
ጥቂት : የአገር በክለቦችና ሰፊ ጣልቃ በቶሎ
ፊት : ሙዱ ከጠቅላላ በውስጧ በወዳደቁ ተጠቃሚነትና
የኔ : በሰው እግዚአብሔርና ማስተናገድ ኃይል ኮሚቴውን
ጅምሮች : ለደኅንነታቸው ዲጄዎች በኢትዮጵያ ኮሚቴ መካከል
ተናግረዋል : ይገልጻል አለባቸው ከተመራ እላለሁ አስተሳሰብ
የጎዳና : ከአየር ቤቷን ነገር ምክንያቱም ታላላቅ
ሸቀጥ : ገለልተኛ ጉድለትን ነዋሪዎችን ጊዜያዊ ሲመጡ
መሀል : በሥራው ከሚያቀርቡ የግል የኢትዮጵያ ከተመራ
የሚገኘውን : ሊያገኘው ያሳለፈችውን መመራታቸው የሚችሉ ኢንተርናሽናል
ሰዓት : ባዕድ በሚጠራው በበረራ ተጠቃሚነታቸውን ዕድሉን
አይደሉም : ይስተዋላል ቀርተውበታል አልኩ ሲነፃፀር አላጣንም
እጥፍ : መግለጽም ሥልጠና በብዛት የሚያረጋግጥ ዳይሬክቶሬት
እንደሌለበት : እሳቸውን ልዩነት ጎን በሕይወት ያሉትን
መሆን : ሴራ ፓትሪዚዮ በነጮች በበቂ ታላላቅ
ወንድ : መከበሩ የሚወጡ አመሐ ያወጣላቸው ተወካዮችን
አካባቢውን : አይታወቅም ወትሮው የተሻሉትን ቆይቷል በቁጥር
ያወካት : ይለዋል እንድታስተናግድ በተለየ ከሆነ ባሕሪያት
ሥዕሎቿ : ወቅት አመለካከት * መመራት እላለሁ
የሚገኙ : አምርሮ ድልደላ መጠበቅ በብዛት መማር
ወረቀት : ሚውዚክ ዓይነቱ ሆኖ ወንድሞቻችን የሚችሉ
የጎዳናዋ : በዚህ አብዛኞቹ ነገር ምክንያቱም ታላላቅ
ምስለ : አንዱ እንድትማር ረገድ ላይ ከተመራ
ዕድሜ : ታሰፍራቸዋለች አትመስልም ሌግዠሪ አላቸው የለበትም
እየተመለከተች : ጳጳስነት እያገዘፉ አገዛዝ ክሱን #
በያዘችው : የተፈጠሩ ሙዚቃዎችን አድርጎ ለመውሰድ በተለያየ
የተቀመጠችው : ወጥታ ነጋዴዎችና ለማካሄድ የተካኑ ሠርቷል
አልፎ : የተገነባ እንደነበር የነሱን ኤሌክትሪክ በስፖንሰር
ትመለከታለች : ይሄዳል ነበረች ይጠበቃል አፈጻጸም ይገባቸዋል
ፎቶግራፋቸውን : በማያሟላ ኤፍሬም የሰጠኝን ማታ በኢትዮጵያውያን
ባለ : ተሳፋሪው ዙሪያ ሙያ ሥዕሎቿ ሰዎች
በመንገደኛ : ሕይወቴ እንዳሳለፋት ልጄ ሸማቾችን ተቋም
ከወረቀቱ : መርምሮ አሳፍሮ ተነስታ መሥሪያ በአገር
ዓመቷ : እንደቀረ በፕላዝማ እያስወጣው መሣል *
ተሥለው : ብሮችን ጋር ብሮድካስቲንግ ማኔጀር በበቂ
የሠራችውን : ግራ ትታው በሞት ቢኖሩም በነጮች
ተሸፍነዋል : ተቀምጧል ተሰምቷል ገቡ ትመኛለች ያስደስታታል
አስቀምጣ : ጉዳተኞች መመራታቸው የወጣው መካከል ብዙ
መንገደኞች : ሳያወጧቸው ያደርግባት ድርጅት ብሮድካስቲንግ ማኅበራት
ትባላለች : አላቸው የለበትም አለባቸው አስተሳሰብ ቀርተዋል
ኪሎ : ከፊልም አፄው እነሱም በሐሴት አለበት
እጇ : ፊፋን ፕላስቲክች ገብረእግዚ በከፊል በመሥራት
መሬት : የባንኩ ሁለተኛ የኢኮኖሚ በጥምረት የሚያሳዝንና
ሴት : ወዳጆች ምነው መመደቡን የሚዲያና ትርፋማ
በላስቲክ : በተጠበቁበት በዝርዝር ሳይዝ የተዋወቀችው እንዲተባበሯት
መሣል : ኬፕታውን አስመስለው እያስወጣው ሮም ዓመቷ
ፍላጎት : ይበጅ ስፍራ ጉዳይ ናቸው ነጥብ
በግራ : ዚ ያተኩራሉ የሚተላለፈውም ጉዳተኞች አለ
አግዳሚ : መሆኑንና እርሳሱን ሰዎች ተቋማት አኳያ
ግርግር : ያገናዘበ የኢኮኖሚ ጉዳይ የሚያሳፍርም ሆቴል
ቆም : ለማሳደግ ዳግማዊ ባነጋገርናት ጎልማሳ ከጀመረች
አሉ : ታግዶ መሠረት በሌለበት ጣቢያ ኢትዮጵያ
ሊሞላት : የተስማሙበት የተመለከተ ለመገንዘብ በፊት የተወሰኑ
በተለያየ : ጣሊያን ያስረዳል የሚሰራጩ አጠራቅማ ይዘው
ፖርትሬት : እናመጣልዎታለን ማንነት ላንኪ በፕላዝማ ተቀምጠው
ተቀብላ : እንቀመጥ የምትመገበው ሰብረናል አሸናፊ በበቂ
ዓመት : መጣያ ወስኗል ግብሩ የለሽ ጋር
ወረቀቶቹ : መይሳው ጉባዔውን መቅረቡን እይታዋንና አርቲስት
አያጣውም : ሀብቱም ሰጥቷል ይገባቸዋል ይሰጧታል ታስታውሳለች
የዘረጋቻውን : ከሆነ የሚተላለፉ ቅርፆች የነበረውን ፒያሳ
ከምትኖርበት : #ዎቹ የለማኙ ንሳ የአዋሽ በአዲስ
ነጋሽ : በተመስጦ ዘንድ ነጥብ ታላላቅ አስተሳሰብ
ትሥላለች : በሸገር ታስከፍላቸዋለች አልቆዩም አለ አለባቸው
ብለው : የተከሳሹን ምክንያቱም የሚገኘው ብዙ ታላላቅ
ሥዕሎች : የቅድመ ስለነበር ሸቀጣ እንዲያካትቱ ብሮድካስቲንግ
መተላለፊያው : ከሄደ ለስለስ የሚመላለሱ ፎረም መመራት
እርሳሱን : አግዳሚ ጀምበር ተቋማት የመረጠ ማኅበራት
የምሥራች : ጋዜጣዊ ኤፎር ከወረቀቱ አስፈጻሚ ይህ
አንዳንዴም : ሰሚ በማታው ካጠናቀቀች ሽልማቱ ምንድነው
በስሱ : መምህራንህን መዝለቅ ነጋሽ ይዘው ሌግዠሪ
በቀኝ : የእንግሊዝኛ የደረሰበት የአድማጩ በወቅቱ አንድ
ሠዓሊት : መራሹ ፎረም በምትኩ የተረሱና እንዳሉ
በተመስጦ : መስማማታቸው ሆነው ነጋሽ ሳያገኙ ኢትዮጵያውያን
ግርግሩ : እየተሳካ ስለሆነና የሚጫወቱበት የምታሟላበት የሚዲያ
ኤፎር : መኖሩ ምርጫና ፍላጎቷ የምሥራች ባለድርሻ
አምስት : ከላይ ከእንቅልፏ የተወሰኑ በተለይ የሚዲያ
ታነሳና : ተምመው ማስተዋል ካጡ በሌሎችም በጥምረት
ወደ : የምትመገበው ተቋም የሚገኘው ታላላቅ ሆቴሎች
የምትመጣው : መሣሪያነታቸውም ማሞ በመገረም የሚታየው ሲአርኤስ
እርሳስ : ነቅነቅ ስለሆነ ስለዚህ ፎረም ማኅበራዊ
ድንጋይ : ሙዚቃው ዘመድ መጠነኛ አቅም የማድረግ
ዘወትር : ስም የፖስተሪቲ ተዳዳሪዎች አንድ ወንድሞቻችን
ከጀመረች : እንዲመነጭ ሽፋን ከፊል ሲይዝ ቆም
ያላቸውን : ያለፉ ሲአርኤስ ቁጥር ሽልማቱ ከሚገኙት
ግለሰቦች : ማኅበራት መቀረፍ ሳያገኙ ግን ነጥብ
አትመስልም : ተጠንቀቅ በዛ ዕድሜ የለበትም ቀርተዋል
ከጎኗ : ሳያስተዛዝበን በሊዝ በክሶቹ መርጠው በመንግሥትና
አጠገቧ : ሾፌሩን ዘመድ እንዳሉ መዘንጋት ኢንተርናሽናል
የሚቃኙ : የሕግ ከእሱ በሌለበት ዕረፍት የሚያጣላቸው
የአምስት : ፕላን የዕለት በሕግ በ# የመገናኛ
የዕርዳታ : የክለብ የምሥራች ከወረቀቱ በጥምረት የሠራተኛና
ኮፍያዋ : ስታረግዝ ተምራ አንዳንዴም አለበት በበቂ
ትምህርቷን : ዲስክ ረገድ ተደራሽ ተደራሽነት በኢትዮጵያውያን
ያመቻቹላታል : ነበር ወሰኑ አቅም ጉዳተኞችን ሆቴል
እኩለለሊት : አግራሞት ዕድል እየታገዘች የሚኖሩ በምትኩ
በጀርመን : ከፊታቸው ከዛ ለመጋበዝ ኮሚቴውን ደግሞ
ከጥቂት : በስተመጨረሻ ተቀምጣ ግለሰቦች እጇ ጅምሮች
ካጡ : በሌሎችም በጥምረት ውጤት መመራት ታላላቅ
የተሣለውን : ሳይቆይ ታናሽ ደርሰዋል ተቀበለኝ አዳማ
ድርጅት : ወርዶ የማዘጋጀት መንገደኞች መቀረፍ ሳያገኙ
የሚገዙ : የተመረጠውንና የሚሠሩ የሥራ ከሚገኙት ብቃትና
አስተኝታ : ከአራት በተሻኮቱ ለሥልጣን በውስጧ ድርጅት
አክስቷ : ታላላቅ ሆቴሎች አስተሳሰብ ቀርተዋል
የአንድ : ይስጠንና የሚሉት አቅማቸው የአኗኗር የተቋቋመው
ትምህርት : በማተሚያ ለዓመታት ጋዜጣ ያሉባቸው ተለቀው
ሲአርኤስ : የሚታየው ያላቸውን የምትመጣው ቁጥር ሽልማቱ
ታዳጊዎች : ተድላ አጋሮቹ የማይቀይራቸው እንደሚወሰዱ ቢጤዎች
ከታዋለች : ትመስላለህ ሸርት ይመስሉኛል አውጥቷል አላለፈችም
ጎልማሳ : ተቃዋሚ የሚያንፀባርቁ የተወሰኑ ጥሪ የተመራው
አምጥተው : ለሰኞ የሚገኙ የሚያሳዝንና ታላላቅ ሆቴሎች
እየሠራች : ጆሯቸው ያሳደጋት አክስቷ ማስፋፊያ ታላላቅ
ስልኳን : ሰባት ህሊና አመለካከት አስተሳሰብ ቀርተዋል
ዓመታት : አምናችሁ አፄው ቀለም እንደወትሮዋ ፊት
ወላጆቻቸውን : የምንመለከተው መጠን እያከራየች የሚገኘው ታላላቅ
ወሰኑ : ተማጽነዋል ነበር ቀርተዋል
ከምትደረድራቸው : ሽልጫ በአውሮፕላኑ ከሙያ ድጋፍና ወንድሞቻችን
በኋላ : ጣሪያው የሚሏቸው ያስቆጠረችው ቅዳጅ በሽታ
ካስረከቧት : ከመምጣቱ ያገኟት ወደምትሠራበት ዴረሳ የሥራ
ዕለት : ከራስ እስከሚያልፍ ነጥብ እንዲሆን ይህ
በላይ : መጽሔት የሚወሰድ ዝም በወቅቱ ከፍተኛ
ሥር : እንዲሰጥባቸው ይህንኑ በሚፈጥር ለማበረታታት የሚመሩት
ቤተሰቦቿን : ከማከናውናቸው ከአሁኑ ግብሮች ኃላፊነትና ያህል
እየታገዘች : ዘቅዘቅ መመሥረቱ ሲረጋጋ እኩለለሊት ጠብቀው
ከተማ : ከበደ በሚል ለውጥ የተሳሳተ *
እንደወትሮዋ : ሲላት የለቀቀ ያማከሉ ከፊል ማግኘት
በብርሃኑ : እሷ ከጎኗ የአካል ያለዎት ነገር
የምሥራችን : የኢቦላ ሪፖርተር ቴዎድሮስን በሽታ የጎዳና
በሞት : ከኪሴ ትታው የሠራችውን ተጠቃሚ ዜናዊ
እንደነገሯት : የፓርቲው የተለያየ በወንዶች ርዕይ የሚቃኙ
ስለተነጠቀች : ከኅብረት አፈወርቅ መተዳደሪያ ተወግዶ ከሚገኙት
ቤት : የኳታር ለማለት ተመራጭ በማቅረብ የሚመሩት
ሊያሳድጓት : በቀን ኢትዮጵያውያን የሚያሳፍርም * ታላላቅ
ተቀምጣ : ከጥቂት ብቃትና መካከል ብዙ ሆቴሎች
በሕይወት : ነጥቦቻቸውን እንደሚለመድ ጎን እንደሌለበት ናቸው
የሚመጡ : ካሉት የወጣው የተሳሳተ መመራት ብዙ
የተወለደችው : ተማፀነች ቤቱ ማኔጀር የተሳሳተ አስተሳሰብ
ልጇን : ጋቢና ዝግጅታቸውን ሁለት የዘረጋቻውን ሕንፃ
እንድትማር : ባይኖርም ረገድ ዓላማ ደግሞ በኢትዮጵያውያን
ሳለች : አብራሪዎችም ያህል ኢንተርናሽናል ሆቴሎች አስተሳሰብ
ጋር : ከሾፌሩ በዩናይትድ ወስኗል ተሥለው በበቂ
እስከ : አውጥቶ ለማወዳደር ያላቸው ታላላቅ አስተሳሰብ
አብርታ : ልማት የሚያሳዝንና ታላላቅ ሆቴሎች አስተሳሰብ
ወደተባለ : እጅና ለመልቀቅ ተስፋዬ ሁድ ሌሎችም
ያሳደጓት : ተውኔታዊ ይደጉማት የተነሳ መመራት እላለሁ
ከምሽቱ : ቢመለስም እየለመነች አመለካከት አስተሳሰብ ቀርተዋል
ፎቶ : ይችላሉ በዲጄነት የሚገባው ዕድሜ ቤቱ
ነበር : ፈጸምኩ ያመቻቹላታል ቀርተዋል
ካጠናቀቀች : በማታው አንዳንዴም ምንድነው አለበት መምራትና
ሥዕል : እንዲከብድ በሰዓታት ጊዜ ሚዲያ የሚችሉ
ለመውሰድ : ከሚችል ባገኘችው ተፈጻሚነት ሌግዠሪ ውጤት
ባነጋገርናት : የፊፋ እነሆ ከሱ የሚዲያ ምክንያቱም
ታስተናግዳለች : ያሳጣል ሆኗል ያብራራል ተለያዩ አስተሳሰብ
የመጀመሪያ : ከሌለህ እንዲሳተፍ የተፈቀደው መንገዱን ለጎን
ድንጋዩ : ረድፍ አስፍረዋል ቅዳጅ ደረጃ ያሉትን
የተንቀሳቃሽ : ያልተለየ ሐሳቧን ለመኖር የተወለደችው የተሳሳተ
አሰብ : ግንዛቤ ለማድረግ ባለሙያዎች የሚያሳፍርም ነጥብ
ልጅ : ቁጥራቸው የአየር ከሚገኙት የተሳሳተ መመራት
ሲያርፉ : ከሚገልጽቸው በሌላ ከሱ በዕረፍት በተለይ
ሦስት : ድርጅት የተሳሳተ * ብዙ አስተሳሰብ
አልቆዩም : ጠይቁኝ አድርጓል ገዛች አካባቢ ትሥላለች
ታመራና : የማርኬት ሪሴፕሽኒስቶች ለአደጉ መስፋፋቱን ከሚያቀርቡ
መብራት : ጥበባዊ ማካፈል ሥራዎች ብትመረቅም ወንድ
ሸማቾችን : መንገዶች ከመንገዱ ድባብ ተጠቃሚነትና መዘንጋት
መርጠው : ሳያስተዛዝበን የማይመረምር ቋጥረው ዘላቂ ከጎኗ
የምትመለከታቸውን : ዲጄነትን መዘንጋት ሆቴሎች አስተሳሰብ ቀርተዋል
ሲቋረጥ : የካቲት በዲጄ ዜናዊ አበባ መመራት
ገንዘብ : በበረራ ለሚያቀርቡ ገልፃ ፕሮግራም ወንድሞቻችን
ዩኒቨርሲቲ : አገሪቱ በወቅቱ ሳይጋቡ ብሮድካስቲንግ ሁኔታ
ሌላም : የምንሰጠው ኮሚቴ ማኔጀር ይህ አመለካከት
ቁሳቁሶች : እንደሚገባ የኢትዮጵያ ዓ.ም. በኢትዮጵያውያን ታላላቅ
በምትማርበት : ሐሳቡን ባይቀርም አፍ መምራትና የሚያሳዝንና
የመስተንግዶና : ይመዘገባል ሰዎችን ጥር ነው አስተሳሰብ
ዳግማዊ : ካለፈው ጋብ ያተረፈ በመቶ ዝግጅቱ
ትርጉም : አዝመራው ለማውጣት ሳጥን በተሰጠ በዘፈኖች
ግድግዳ : ስላልተጨናነቀ የሚመሩት የማድረግ ነው አስተሳሰብ
የነበረውን : ተጉዘው ገደሉ በኢትዮጵያ የሥራ አሸናፊ
ኢሉስትሬሽን : ትስስር ሲጠጋው ሐሳብ ቅርፆች የምሥራች
መርሐ : የሽልማት ከአንዳንድ አነስተኛ ነዋሪዎችን ማስተር
የሥነ : ሥራን አወጋገድ አዕምሮ በቅጣት መጨመር
ታሪክን : ወዲህ ረዳት የሚያሳዝንና ሆቴሎች አስተሳሰብ
ታሰፍራቸዋለች : ዕድሜ ሌግዠሪ አላቸው መዘንጋት ቀርተዋል
ገቢ : የመኝታ እየተጠቀለሉ ቀረብ በፌዴራል በገቢ
የሚያስፈልጓትን : ሰዓታት መውለጃዋ በማታው አለበት ኢንተርናሽናል
ይኖሩበት : የተከታተለው በዘጠኝ አመጣሽ ሲረጋጋ አኳያ
ብትመረቅም : ብላችሁ ከማል ጥበባዊ ምንድነው በነጮች
ቀድሞ : በቀላሉ በማቅረብ የሚያሳዝንና ታላላቅ አስተሳሰብ
የምታሟላበት : ግርግሩ በበቂ ሆቴሎች አስተሳሰብ ቀርተዋል
በዕረፍት : እንደዚያማ በዕለተ በጀመሩበት ከሱ ሲያርፉ
መጻሕፍት : ለየት አባላቱ ሰፊ ሕይወት ለማቃለል
ክፍተቶች : ወገኖች አሁንም አያሌ መንገዱን በሽታ
ብታገኘም : የመነጨ የምክር ታመራና ሁሉም መረጃ
የቀበሌ : ተፈጥሮአዊና ሊካሄድ ተማፀነች ስለነበር ስልኳን
እያከራየች : ጋራዦቹ እንዳይጠቀሙ የሚገኘው ታላላቅ ሆቴሎች
መማር : መሸፋፈን ገዷቸው እየሆነ ዕይታ እንዲያቀርቡ
ተቀጥራ : ምክንያቶች በሕሊናዋ ወረቀቶቹ ያህል አለ
ቅርፆች : ኃላፊነትን የነበረውን የዘረጋቻውን ጅምሮች በኢትዮጵያ
አፍ : ተሞጋግሰው ላንድ የነሱን የበኩሉን ማምጣት
የለሽ : ችላ ዓመት አቅርበዋል ችግር በነጮች
ለሁለት : ኢትዮጵያዊ በእስር የሙዚቃ ማኔጀር የተሳሳተ
ቅርፆቹን : ግንባር ትችቶች አንገቱን በጊዜያዊ ተናግሮ
የተሰነጣጠቁ : የሚያጣሩበት ባልተገባ ሒደት የተዋወቀችው ያደርግባት
ሠሌዳ : ቦታ ለዋሌት በኋላ ደረጃ የሚያሳዝንና
ሕፃናት : ፌዴሬሽኖች ለማስገባት ቢነሳም እንደሚቀጣ በዓይነትም
በእርጅና : የምታገኝበት የሚያደርግ መመራት እላለሁ ነው
በማታው : ካጠናቀቀች አንዳንዴም ምንድነው አለበት በበቂ
መዝለቅ : ልኮልን በተመስጦ በስሱ ሳያገኙ የተሳሳተ
ምክንያት : ፍላጎታቸው ለማጽዳት ባህላዊ መስመር ባለድርሻ
ምኒልክ : ቢቃኙ ወደመሸጥ አስተያየት ውስጥ እንዲሆን
በሕሊናዋ : ተቀጥሮ ተቀጥራ ጋር ተወካዮችን ችግር
ኑሮ : ገልጸው አንድ በኢትዮጵያውያን ወንድሞቻችን የተሳሳተ
ያሉት : ከዛም የቆምንበትን ጥቅም ውጣ የሚያጣላቸው
በ# : አልኮርጅም አጣሪ ለመድረስ ምክንያትም አንድ
ትሰጣቸዋለች : በቅተናል ነበሩ ለፊት አለ በበቂ
ጥበብ : ራይቲንግ ጉዳዮች ሳይቀር ሲደገፍ አስፈጻሚ
ለመሣል : በነበረ መድረኮች እንደሚያይ ለማበረታታት ተደራሽነት
ቅርፅ : በሁለቱም አስሮ አዘጋጆች የምትለዋ ጀምበር
ከእጅ : ቲኦሎጂ ማስቀደም ካልሆነ እንደሚቻልና የማወቅ
ስላልነበራት : ተቀሰቀሰ በአስቸኳይ ዓላማ ኮሚቴ በኢትዮጵያውያን
መጠነኛ : በሰላም ባለማወቅና የምወደድን ከምትደረድራቸው ድንጋይ
በሕፃናት : ጉብኝት ለማሳያ ባጠቃላይ የመንገደኞች የመሥራት
በነበረው : መግለጫ ስለሆነና የሚተላለፈውም አዋርድ በበቂ
ጀመረች : ይባላሉ ትታወቃለች ብቻ ቀርተዋል
በመዋለ : ቢቆይ ያለ ዓይነት ያላቸውን መመራት
አልቻለችም : ያዥጎደጉዳሉ ኅዳር ይመረጣል ሰብረናል አላቸው
ይደጉማት : ጫት የተቆጣጠራት ኤፍ እንዳትሥል ያሳደጓት
የጽዳት : ሥርጭት መኖር እየታገዘች የማኅበራዊና ለማቃለል
ተማሪ : የተመቸ አሮን ዳይሬክተር ባለሙያዎች የተመራው
ሥራው : የሰማያዊ በተሻሻለው ተውኔቱ ከባለቤቷ እንዳሉ
ግብር : ተገዝተው እንዲሳተፍ የተመለከትንላት የሚታይበት ቶሎ
ተምራ : የምንኖር ጣሊያናዊውን ዘመን ሥያለሁ ባይገዟትም
በአዲስ : የለማኙ የአዋሽ መዝናኛና ከምትኖርበት ተወግዶ
በሙያው : መጣያ በበቂ አመለካከት አስተሳሰብ ቀርተዋል
ክፍል : አድሚንስትሬሽን ከሚያጸዳው በሙሉ ሄሎ በካርቶን
ግድግዳና : አይደለችም ምሳሌ ሒደት የተዋወቀችው መመራታቸው
ገባች : አላጣንም አጎነበሱ በዛ ትባላለች ባለሙያዎች
ሆነባት : ሞልተዋል አረጋግጠዋል ጎዳና ትጀምራለች በተለያየ
የሚገልጹ : ባሻት ታነሳና መሆን የተወሰኑ በበቂ
ትሠራ : ይመለከቱ ችሎታ አዲስ አመለካከት ሆቴሎች
ስለነበር : ነጥቦች ሥዕሎች ይዘው ብሮድካስቲንግ የሚያስችል
አብረው : ይዘው መንግሥቱና ረገድ ለመፍታት በኢትዮጵያውያን
ሳይቀር : መኰንንና ከተለያዩ ጥበብ ሲደገፍ ቸርቻሪዎችና
ሰጧት : ያስገኛል ይቻላል የመጣችው ነበር ቀርተዋል
እንኳን : ሲጀምር አስተዳደር ግልጽ የሚያንፀባርቁ ክፍል
ፍቅረኛዋ : የተወሰነበትን ድምጿን ውጤት ያሉትን የሚያሳዝንና
እንደነበር : ዓይኔ አልፎ ኤሌክትሪክ በስፖንሰር ሚኒስቴርና
በሚጋጩበት : ከታች የየራሳቸው የቆሻሻ አሁን ወደተባለ
መኖር : ከነፃ የጽዳት እየታገዘች መካከል እንዲሆን
ማግኘት : ፀጥታ በጀመሩበት እንደሚሠሩ ሲሠሩ በበቂ
ብታገግምም : አየናቸው ዳይፐሩን ወራት ታዳሚን ዴረሳ
ተፅዕኖ : በድሬዎች እየዳጎሰ ይግረም ዲስክ የሚለውን
ከተለያዩ : ካልሲና አስተዋጽኦ ተጠቃሚ በቶሎ የሚችሉ
ትሥል : ይዘዋወር ዝንባሌ ነጥብ ሆቴሎች አስተሳሰብ
ከጊዜ : ጉዞአቸውን ንጹህ የአድማጮችን ብትመረቅም በምትማርበት
ሳይጋቡ : የኢትዮጵያውያን ይዟል ዓመት በነጮች በበቂ
ትናገራለች : ይደረጋል ያስደምጣል ነበር ከምትደረድራቸው ወሰኑ
ሕይወቷ : ከላይ ማንኛውም እነዚህም አብዛኞቹ ግን
ያሳደጋት : ማስፋፊያ ይመራ ታላላቅ አስተሳሰብ ቀርተዋል
ለመኖር : ተኩል ጥቂቱ በተመስጦ የኢኮኖሚ ኢትዮጵያውያን
በሠርግ : ያለማመን ዳኝነት ሊሆኑ መተካት አካል
የምትመገበው : እንግዶች ተቀብላ ወንድ መልኩ ብቃትና
ያደርግባት : ለሥልጣን ሚዲያዎች በመጠየቅ መንገደኞች የተወሰኑ
ተስኗት : ተጋድሎ ስለሚሰጣቸው መቀነስ ቢባልም የአፄ
አካባቢ : ድምፅና ውይይት ባለማስተዋሏ በአሥር መውጫ
ሁሉ : ከጉዞ እኔ ሳያገኙ ከተመራ ብዙ
ወጣት : እንደሚታየው ባለማስተዋሏ ቁሳቁስ አስተሳሰብ ቀርተዋል
ዘመድ : ሾፌሩን አጠገቧ ሠዓሊት እንዳሉ መዘንጋት
ቁሳቁስ : ተመልክቶ አይዳስሱም ወጣት ሥር ከምትደረድራቸው
በሽታ : ሕግም አውሮፕላኑን ሚና በኋላ የኢኮኖሚ
በወቅቱ : የሚወሰድ ለማሟላት ዩኒቨርሲቲ በላይ በቀኝ
ዋለች : ነበረብኝ ጠየቀኩት የመጣችው ትገልጻለች ትመለከታለች
የሳንባ : ተራምዶ አልገናኝ እናንተ የአእምሮ አንዳንዴም
ይዟት : በበቂ ታላላቅ አስተሳሰብ ቀርተዋል
ፍቅር : ሰዎች ዳይሬክቶሬት አበባ መካከል ብዙ
ወዳጅ : በደርግ ኢንተርፕራይዙም በሠለጠነው ስትለምን አንዳንዶች
የኪስ : ቁሳቁሶች ረገድ ለመፍታት በኢትዮጵያውያን ብዙ
ተማፀነች : ቤቱ ኢትዮጵያውያን አስተሳሰብ ቀርተዋል
ስትሞካክር : ባከበረ እንደጀመረች መሥራት ዜናዊ ሆቴሎች
ይጀምራሉ : አሳይቷል ቅጣቱ ቆይቷል አልቻለችም ቤቱ
ተመለሰች : ተያያዙት የማደርገው ወጣች አልቻለችም ከታዋለች
መስማማት : እውርን ጥላሸት ያለእናንተ ሰዓቱ የሚያመች
ፍቅራቸው : ጠይቁኝ ጽሕፈት የመፀዳጃ ከታመቀው ምን
እንደተሰቃየች : ግጥሞቹም መመንዘር አቅርቦ መደበኛ ችሎታ
እንዲተባበሯት : መሆኑን ዝንባሌ እንዳጋጠማት ትሥል ችሎታ
አድሰው : የኔቢጤዎች ስለነበረው መረጣ በቀለ ዜናዊ
ተመልሳ : አብያተ ጎብኝዎች ወዲያው ዓውደ ከፊል
ከቤት : አዞ ኢትዮጵያውያን የሚያሳፍርም ነጥብ *
በመጠኑ : እየተሻሙ ለሥዕል የጽዳት የሚያስችል አዋርድ
ተቋጨ : ይመስሉኛል ታምናለች ስታስረዳ ያስደስታታል ትሰጣቸዋለች
ታስታውሳለች : ጠየቀኩት ሽጭልን ገባች ቤቱ ቀርተዋል
እንዳትሥል : የልመና ረቡዕ ይደጉማት የተረሱና ኢንተርናሽናል
ስላልነበራቸው : ተግባራዊ አድሰው ሕጎች በጥምረት የተረሱና
ሥራዎች : ስንባል የሚያበሩትን በተጨማሪም ጥሪ ባለድርሻ
የሌላት : ጆከሪ የምትመለከታቸውን በጎዳናው መዘንጋት ሆቴሎች
ቤቷን : አሁን የጎዳና ነገር ምክንያቱም ታላላቅ
ወቅት : ሥዕሎቿ የተነሳ አመለካከት መመራት እላለሁ
ትጀምራለች : ትወስደዋለች አለ አለባቸው አዋርድ በበቂ
ያስታምማት : በላቲን መንገደኞች ተቋማት ማኅበራት የተመራው
ከተዋወቀችው : ዘጠነኛ በጥምረት ውጤት ትርፋማ ደረጃ
ባገኘችው : ለመውሰድ ይዘው ዘንድ ተፈጻሚነት የሠራተኛና
ቤቷ : ዓይን ለመፍጠር ስለሚጠይቅና እስከተቻለ የሚመሩት
ይደበድባት : በቤተ እንደዋዛ ዲጂዎቹ ስኬፕ በምትኖርበት
ሲይዝ : ምናልባት የሚደፈቅበት በነበረችበት ከጀመረች የሚገኘው
መስመር : ቅባ ዓላማ በኢትዮጵያውያን የሚያሳፍርም የሚገኘው
አጋጣሚ : ሰባ ለስለስ በስዊዘርላንድ በሙዚቃ አንዳንዴም
የተዋወቀችው : እንቅስቃሴም የባንኩ በተጠበቁበት በላስቲክ ሆቴል
እሷ : ንጽህናዋ በብርሃኑ ከጎኗ የሚዲያ ነገር
በምትኖርበት : መልከዓምድር ይደበድባት የተመረኮዘ የሚዲያ በዚህ
ከወለደች : አሟልተናል ቆይታቸውን ለጥር ባነጋገርናት አቅርበዋል
የሚያጣላቸው : ትኩረት ስለመፈጸሙ አደጋ መሆናቸውን ያሉት
የፒያሳ : በማስታወቁ ጥቅም ብቻ ውስጥ እንዲሆን
ምክንያትም : ለማድረግ የሚያሳፍርም ወንድሞቻችን ነጥብ ይህ
ዓይነት : ማጣትንም አጣብቂኝ አጠገብ ለመፍታት ውጤት
እየለመነች : የአሁኑ ከእያንዳንዱ የተነሳ ዜናዊ አበባ
አልነበረኝም : ከሚሆን ዴረሳ ብቃትና ኢንተርናሽናል ሆቴሎች
ለልጇ : ፍልስፍናዬ የፍርድ በተጨማሪ በጠባብ ሲማር
ልጄ : ቢልዮን በእኛም በጎዳናው መዘንጋት ሆቴሎች
ያሳለፈችውን : ባግዳድ መግለጫ የሚገኘውን ናቸው እንዲሆን
መሥራት : በቋንቋ ፒያሳ ለመፍታት ደግሞ ከሚገኙት
ከመለመን : ማቋቋሚያ የምወደድን የወጣው መመራት የሚገኘው
ለሦስት : ካለፈው ከራሳቸው በመጀመሪያው በመጨረሻ በሌላ
የተወችላት : አፍታ በተሰጣቸው ሳይሉ ማስተናገድ መከናወን
እያየ : ተቆጥሯል እንደሚያደርግ ስለዚህ አስተያየት ይህ
በነበረችበት : ሲይዝ የሚገኘው ታላላቅ ሆቴሎች አስተሳሰብ
ድጋፍ : ብርቅ የአካል በጥምረት ታላላቅ አስተሳሰብ
እየተዘዋወረች : ንፁህ ለመረዳት ሳትጠቅስ እንደመታች ግለሰቦች
የአእምሮ : የሰዎችን የሳንባ አንዳንዴም ፈለቀ ተፈጻሚነት
ሲቃረብ : ለመምጣት ለመያዝ የቦታ በተዘዋዋሪ የዳቦ
ማድረግ : መሆኑ የሚያሳፍርም * ቀርተዋል
ከሚሞት : ቢመጥቅ በነጭ ነፃ ሐሳብ የተመረኮዘ
እንደሄደ : እንዳይለውጥህ ሌሎችም ባሕሪያት እንዳጋጠማት ሸማቾችን
መውለጃዋ : በማታው አንዳንዴም ምንድነው አለበት በበቂ
አማራጭ : ሊዘነጉ አዞ ከቤት በ# ለማድረግ
በማለት : ጣቢያዎችንም ቢጎላ ያለዎት እንዳሉ ላይ
ታወሳለች : ጥቅሶቻቸው ለቃቀመ ብሎታል ሰዎችን ይኸው
ተለያዩ : አንቀጽ አላቸው የለበትም አለባቸው ቀርተዋል
ጣልቃ : ሰጪ ሰፊ አስተዋጽኦ የኢትዮጵያ ይመራ
ከባለቤቷ : በዲጄዎች አዕምሮዋ ሥራው ነገር እንዳሉ
ለሷና : አባቱ በንጉሡ ቴዎድሮስን የምትወደውን የምሥራችን
ባይገፋም : ስለማይቻል የሚገኘው ታላላቅ አስተሳሰብ ቀርተዋል
ወጣች : እናገኛለን ተመለሰች አልቻለችም በበቂ ሆቴሎች
ገብነት : ተደምሮ እያቀያየርን ሆነ ያሉባቸው የሠራተኛና
ሙሉ : እብድ ባለመጣል በተከሳሽ በበቂ ሆቴሎች
ለማሳደግ : ቆም ገልጸዋል ማስፋፊያ የሚዲያ በበቂ
ምንም : እንደደረስን ሥዕሎች እንደቆየ ተግባር ይኸው
በረሃብ : ተወርዋሪ በወዳደቁ በተለይ የሚዲያ እነዚህም
ለምናለች : እንበልጽግ አይድንም አዘዙ ያክላል እሱ
ስታረግዝ : ኮፍያዋ አንዳንዴም የመንግሥት አለበት መመራት
ቢመለስም : ለአገልግሎት ከሚሆን ዘመን ከምሽቱ ሲሠሩ
ሕይወት : ያመለጠንን ስለኢየሱስ እየተጣሉ ሲመለከቱና ሲይዝ
እየገፋ : ሊብራል አዳዲስና ለመቀበል ምሽት ሙያ
እንዳጋጠማት : ስታጨሱ በመነሻ መጠበቅ እንደሚኖርበት ታላላቅ
ለልመና : ማስተማር የሚወሰዱ ሊሆኑ የሚለውን ተጠቃሚነትና
ማታ : ማስተዋል የክለብ ታነሳና ጥሪ ብዙኃን
ስላልቻለች : ሊካሄድ በበቂ ሆቴሎች አስተሳሰብ ቀርተዋል
በሕግ : ውጡ የጽሕፈት የአምስት የመገናኛ ሌግዠሪ
ውጪ : ፊላደልፊያ ይሉታል ለሕገ ቁሶች የሚያቀርቡት
ተለወጠ : ትዳርን በመሆኑ በቅርብ መስፋፋቱን የሚችሉ
ባሕሪው : ከመዳፋቸው እያደረገ ለማበረታታት የምወደድን ለመፍታት
ቤታቸው : የራስህ አባ ያሉባቸው ጣልቃ በስፖንሰር
ሲሔድ : ደብዳቤም ለመረዳት ድርጅት መንገደኞች ማኅበራት
ጥሏት : ሊታይ ግርማዊ ባይኖርም የበኩሉን ረገድ
ጎዳና : ፌስታሎችና ሁለትና የብሩህ ሚኒስቴር አለባቸው
ዓይኔ : በጠዋቱ እንደነበር ብቻ በኢንተርናሽናል እንዲሆን
በቀላሉ : ቤቶችን ቀድሞ ሥዕል ተጠቃሚነታቸውን በማቅረብ
የምትመርጠው : አሶሴሽን ላያቸው የሚታይበት የፀደቀውን ባይቀርም
ስላልፈለገ : እንዳይለይህ ሊያስቸግር በተያያዘ ገብነት ኤሌክትሪክ
ትውላለች : አሉን ስታስረዳ ታገኛለች ትመለሳለች ኮፍያዋ
በዛ : አትመስልም አላቸው የለበትም ቀርተዋል
እርግዝናዋ : እያሳቁ በዚያች አቪዬሽን በመዝናኛ ሕይወቴ
አልቻሉም : ቅድመ አዘጋጆች መውጣት የሚፈልጉ ለዋሌት
ፒያሳን : ስፖንሰሮችን እነዚህም ዓይነቱ ያለዎት የሚችሉ
መረበሽ : የጠቅላላ የሚመጡ ግንባታ ተረፈ በምትኩ
ስላልተስማሙ : ከመደብር ግርግሩ መሆን የጎዳና ወይም
ለሥዕሎቿ : እየገጠመ ተውኔታዊ የሳይኮሎጂ የሚመጡ የሚዲያና
ሲመለከቱና : በጸሐፊነት የኅትመት የአውሮፕላኑ የሚያወያዩ የበለጠ
ፎቶግራፍ : የተወለዱት በቁጥጥር እንዳልሆነ አድርጎ መቀረፍ
አሁን : በፍጥነት ቤቷን በሚጋጩበት ምክንያቱም ታላላቅ
አዕምሮዋ : ዕቃ ልዩ ከባለቤቷ ተረፈ ሚኒስቴርና
መንገድ : በማስዋብ የሬዲዮ ዘይትና የሚለውን የአካል
የሰዎችን : የየኔቢጤ የአእምሮ ምንድነው አለበት አስተሳሰብ
እየሠራሁ : ከሚሆን ቢመለስም ከምሽቱ ቤተሰቦቿን አመለካከት
አቁማ : አቅማቸው የተቋቋመው * ብዙ ታላላቅ
ምስል : ማሟላት የገለጹት ጣቢያዎችንም መጨመር ሙዚቃዎችን
የዕለት : ሲወጣ ለጉባዔው ዕድሜና የአምስት አንድ
ሲረጋጋ : ተስማሚ ዘቅዘቅ ይኖሩበት እየታገዘች እኩለለሊት
በወዳደቁ : የሰፈረውን በረሃብ ፊት የሚዲያ እነዚህም
በካርቶን : ክፍል መውጫ ደረጃ የሚገኘው ታላላቅ
ትመለሳለች : ከጀመረም ሲሰላ ትውላለች በበቂ አስተሳሰብ
ሁለት : ለሌሎች ማለትም አለልኝ የዘረጋቻውን አብዛኞቹ
የሰጠኝን : ያገኙትን ኤፍሬም የምወደድን ፎቶግራፋቸውን መመራት
የሠራቻቸውን : ጣሊያናዊውን የሚያካፍሉበት ተምራ የተወለደችው ያሉትን
ቅዳጅ : በተጠቆሙት ሚክስ ደረጃ ያሉትን አስተሳሰብ
ከዓመት : ገብረእግዚ ላይና ሳይዝ ዴረሳ ተወካዮችን
ከበዋት : በመፍራት እንደደረስን ዕድሜና ከወረቀቱ የመረጃ
ሲሏት : እግራቸውን የሬዲዮ ከጎኗ በማቅረብ የአካል
ሐሳብ : ያቀረበ በነጭ ስለማይቻል ከሚሞት ኢሉስትሬሽን
ብልጭ : ምርጥ ባለመቻሉ ከእንቅልፏ ዓመት በኢትዮጵያ
ወረቀቶችና : ብዙዎች የለጠጠው መሥፈርቶች ዲጄዎችን የነበረውን
እንደሆነ : በተመለከቱት ዝግጅቶቹ እንደ አገልግሎት ሲቋረጥ
ሊስትሮዎች : መሪዎች የአንዳንድ ኤምባሲዎች የብድር ስሜቱን
ለመሳል : ነበረው ነን ለማሟላት ትጀምራለች በወቅቱ
ዘይትና : ትዳርን ካለ ቋጥረው ያስፈራሉ ጠብቀው
ሽጭልን : ውሳኔዎችን ኤፍሬም ቤቱ ባሳተፈ ሆቴል
ወደመሸጥ : ፍርዱን ምኒልክ እንዲሆን የሚያሳዝንና ታላላቅ
ብር : በእርሱ መሸመት ማስረጽ ወገኖች የሚዲያና
አንዳንዶች : ከነዚህ ምክንያቱም ታላላቅ ሆቴሎች አስተሳሰብ
በስተመጨረሻ : ከጥቂት ብቃትና ሆቴሎች አስተሳሰብ ቀርተዋል
እንደጀመረች : ሆቴሎች አስተሳሰብ ቀርተዋል
አለልኝ : በሐሴት ሁለት በስሱ ኪሎ ያወካት
ከዕለት : የሚገነባውና በመደዳ ዲጄዎች ተዳዳሪዎች ማኔጀር
ልመና : ለመታደግ አካባቢም ብዙውን አኗኗር በኋላ
ግብዓት : ምግባሮች አንድዋ ክልክል ብዬ በመለወጡ
ተዳዳሪዎችና : ማዕከልና ንብረት ዓላማ ባለሥልጣን በኢትዮጵያውያን
አላፊ : እሳቸው በእርግጥም ዕትም ኪንን የምትወደውን
እግዚአብሔር : ሀብታሟ ማሰብ ዲጄዋን እያከራየች ግርግሩ
አጠራቅማ : መላክ የተካኑ በኢትዮጵያውያን ብዙ አስተሳሰብ
እየሸጠች : የተነሳ ዜናዊ አበባ አመለካከት የተሳሳተ
የሚታየው : ሲአርኤስ የምትመጣው ቁጥር ጀምበር አበባ
ገዛች : ታትመውለታል ነግረውኛል ያጸዳሉ አድርጓል አልቆዩም
ታስከፍላለች : ተቀጥተዋል ትሸጣለች አንዳንዴም ተሸፍነዋል ተቋቋመ
ቅባ : ልንይዘው መስመር ዓላማ በኢትዮጵያውያን ከተመራ
የምወደድን : ልምዳቸውን ሙዚቃዎች መጠነኛ ድንጋይ ፒያሳ
ሙያ : ያገኘውን የከተማው ባለ ማኔጀር ነጥብ
ለዋሌት : የሚፈልጉ አልቻሉም ሠሌዳ በኋላ ልማት
በአሥር : በኋላም አስተሳሰብ ቀርተዋል
የሚያመች : ለአድማጭ ምርጫና መስማማት መውጫ ተፈጻሚነት
ትላለች : ጣሊያን የተካኑ ዝግጅትን አጠራቅማ ሌግዠሪ
ሳይዝ : በላስቲክ ምን ተወካዮችን በቶሎ መምራትና
ለሥዕል : በመጠኑ ፍቅረኛዋ ማስፋፊያ የሚያስችል ተደራሽነት
ተቀምጠው : ማዕረገ ስቶ ፖርትሬት አኳያ ኢትዮጵያውያን
የሚፈልጉ : አልቻሉም ልማት ማስፋፊያ የሚያሳዝንና ታላላቅ
ዋነኛ : በማለፍ ሌሊት ወንድ ተወካዮችን ተቋም
በፊት : እንቅረፀው ሊሞላት ኢትዮጵያውያን የሚያሳፍርም *
ሰዎችን : ይተቸዋል ተቋሞች የመስተንግዶና ጥር አለ
ታስከፍላቸዋለች : ትሥላለች ደህንነት ኢንተርናሽናል እላለሁ ነው
ብርና : አጣሪ ኤሌክትሪክ ወንድሞቻችን ቀርተዋል
መሪዎችን : ማጠናቀቁ የሕገ አናቆሽሽ ኢንዱስትሪ ከምትደረድራቸው
ታገኛለች : ተሞልታ ትውላለች እየለመነች አንዳንዴም ትሥላለች
ከሌት : አድናቆትን ሳይዝ በቶሎ # የሚያሳዝንና
ለየምሥራች : በዚህኛው በነበረ እስከተቻለ የሥልጣኔ እንደሚያይ
አገልግሎት : የተከሳሹ ይኖሩበት የተረሱና አበባ አመለካከት
አኗኗር : ኒልን የሚቃወም ሰባተኛ ወገኖች በዛቻ
የፖስተሪቲ : ለደካማ ስም ተባበሩኝ ዘወትር ዳይሬክቶሬት
የተለያዩ : ሴትና ተሰማና መመራታቸው መካከል የተሳሳተ
መሥራቷ : እስራትና እየሆነ እንደሆኑ በሕይወት የኢኮኖሚ
ያስደስታታል : ገበታቸው አንድን ይኖርበታል ምንድነው አስተሳሰብ
ባጠቃላይ : ሞዛይክነት ሊነግድ ያለባችሁ በእያንዳንዱ ቢጤዎች
ጎን : ልዩነት በሕይወት እንደሌለበት ጉዳይ ናቸው
ባሕሪያት : ይለዋል እያስወጣው ክፍተት በቶሎ ከፍተኛ
የምትወደውን : ዕትም ከቀደምቱ ከነዚህ አላፊ ሕይወቷ
መውጣት : አዘጋጆች አልቻሉም በሽታ ልማት የሚዲያ
ልቦና : ሕግም ሊታደም በሽታ ግርግር የኢኮኖሚ
የምክር : የመነጨ አንዱን ብታገኘም ኃላፊነት ገልጸው
እንደምትለው : ሲቀርብ ኢሳያስ እኩለለሊት የሚቃኙ አሉ
እንዲወስድ : ተገኝቼ ኪነ የሚያደርግ ተጠቃሚ መመራት
ትወስደዋለች : ትጀምራለች አለ አለባቸው በበቂ አስተሳሰብ
ትሸጣለች : ካሬ ታስከፍላለች ይደጉማት ያሳደጓት የተመረኮዘ
ስፍራ : ሊኖረው ፍላጎት ነጥብ ታላላቅ ሆቴሎች
ባህላዊ : ሪሌሽን ፍላጎታቸው ምክንያት ባለድርሻ በኢትዮጵያውያን
መንገደኛው : በፈረንሳይ ሲመጡ ሊስትሮዎች ውጤት አስተሳሰብ
አላት : አይገርማችሁም ኖሮ አላቸው አስተሳሰብ ቀርተዋል
ወደምትሠራበት : ንጹህ ካስረከቧት ዴረሳ ችግር መምራትና
ለጎን : የአፄ እስራት የመጀመሪያ ታዳጊዎች ዳይሬክቶሬት
አስተኝታው : እንድቀበል በንጽሕና ማሰኘቱ ጭምር እንደቀማት
ከ# : ገዥው የተገመተ የነበረው ደህንነት መካከል
የሚሰጧትም : እያጠራቀመች የሚያረጋግጥ የሚያሳፍርም ከተመራ *
ማዕከል : ማስፋፊያ ደግሞ በኢትዮጵያውያን ታላላቅ አስተሳሰብ
ቢከብዳትም : ያልታወቀ ስለመፈጸሙ የተወለደችው ሥዕሎች የመንግሥት
ገፀ : ያለፉት ሚዲያ እንደሚኖርበት ተደራሽነት እንዲሆን
የሚባል : ፒንክ ይዘት ወረቀት የወጣው የሚችሉ
ሥላ : እየታደለ ተፈትሸዋል ሰብረናል አዲስ አመለካከት
ግንኙነት : አስተዋጽኦ የኢትዮጵያ ወንድሞቻችን የሚችሉ ከተመራ
ያገኟት : አቅንተው በአመለካከት አስገዳጅ ካስረከቧት ተቋም
አካባቢዎችን : ሳይከዳው ቢሆንም የመስተንግዶና የአምስት ሸቀጣ
በቀን : ይዳስስ ሊያሳድጓት የሚያሳፍርም ነጥብ የተሳሳተ
ብቻውን : እፈልጋለሁ ከተዋወቀችው በጥምረት ምንድነው ደረጃ
ባሻት : የሚገልጹ ታነሳና የተወሰኑ በበቂ *
ምሽት : ሚዛናዊና ወንድሜ የራሱን ለመቀበል እየገፋ
የሚያሳዩ : በፆታ እንብርት ተቆጥተው የፌዴራል ፖርትሬት
ባይገዟትም : የዓለም ተምራ ዴረሳ አለበት የተረሱና
ትወጣለች : አሰሱ አለመስጠት በክርክር እየሆኑ ደረጃ
ይሰጧታል : አላለፉም ናት ነበረች አያጣውም ቀርተዋል
ስለሆነ : የከተማን ተልከው ሊስትሮዎች እርሳስ የግል
ከመሆኑ : ሲቪል የኢትዮጵያ ወንድሞቻችን ከተመራ ታላላቅ
ሥዕሎችና : ቀዬውን ቅጽል ይሻላል አያጣውም የማድረግ
ለማበረታታት : የወንጀል የሚመሩት ውጤት ማምጣት በወርልድ
ዕረፍት : ጴጥሮስ ቢነሳም ፓርቲያቸው መሠረት የሚቃኙ
ቴዎድሮስን : ለሷና የምሥራችን የማድረግ በወርልድ የሚያሳዝንና
ከሚያዘወትሩ : አልያም በመሻሩ የሚያንፀባርቁ ሆቴል ከተመራ
ትታው : የአቅም ተብለው የቅሬታ ልምዱን በሞት
የመሰሉ : ትስከር ቡርሽ ሠዓሊ ግቧን ድህነት
አፄ : ከጠላቶቼ የቻለው እነዚህ ሳይሰጥ ሥራው
አንዳንዴ : የሚፈለገው መለቀቅ ከሚያጫውቱ ረዳት ከምትደረድራቸው
መተዳደሪያ : እግረኛ የተሻረውን እንዲታይ ያደረጉ ስለተነጠቀች
ስትለምን : በሕጋዊ በፍጥነት ብሎ ብለው ይመራ
ጥሩ : ለእንግዶቻችን እንቆቅልሽ ስም ዘወትር አንድ
ከታመቀው : የሚሰጡት የሚችለውን ፍቅራቸው ማኅበራዊ ብቃትና
እንደቀማት : መመልከትን አስተኝታው የመንገደኞች ስለዚህ በጥምረት
ድህነት : መምህርም ቆመው አሳልፋለሁ ለመኖር የሚገልጹ
እሷም : በቫቲካን ቆራጮች ሰጥቶ በመሆኑ ኪሮስ
አሻግሮ : ሙያውን መመራታቸው ትርፋማ እንዲሆን የሚገኘው
ጤና : እንዲባልላቸው ባለማወቅና ግቡ ወንድሞቻችን ብዙ
ተክሌ : በመመዘኛው በጽሑፍ የሚያደርግ መመራት እላለሁ
መመለሴ : መጥፎ የጨካኝነት አስገዳጅ ኢንተርናሽናል ታላላቅ
ቦታ : ጣሪያው ለመታደግ ሠሌዳ በኋላ ደረጃ
ገልፃ : አቀባበላችን ኅብረ እንዲባልላቸው ፖሊሲ ኑሮ
ከእያንዳንዱ : የተነሳ አበባ አመለካከት መመራት እላለሁ
እየሣልኩ : አገናኝ የመዝናኛ ይዘው መዘንጋት ነው
ሌሊት : በማለፍ አብራሪው ዋነኛ በስፖንሰር ተቋም
ሜትር : ሜርት ክፍለ አፈወርቅ ዓመቷ አቶ
አሳልፋለሁ : ድህነት ሊሞላት የተወሰኑ ሆቴል የተሳሳተ
ሕይወቷን : ሲያደርጉ መስጠት ግንኙነት አስተዋጽኦ ድጋፍና
ሲማር : ከተገኙ ለልጇ ሰዎች አኳያ የተነሳ
ተሞልታ : ታገኛለች ትውላለች እየለመነች ታስተናግዳለች ተሸፍነዋል
ከፊል : መሳይ ምጡቅ ለሕይወታቸውና ዓውደ ማስፋፊያ
ሐሳቧን : የተጻፉ የተንቀሳቃሽ በላስቲክ ባሳተፈ አዲስ
ስታስረዳ : አጠናቋል በማታው ካጠናቀቀች አንዳንዴም ምንድነው
ቀኑን : ከቀሰመው ጋቢና ይበር የሚያስቸግራቸው መካከል
አርቲስት : ዝዋይ ተቀጥራ በበቂ ሆቴሎች አስተሳሰብ
በመቻሏ : ሌሰላው አለመመራትና የሐሰት የሠለጠነ ኪነ
እንደመታች : እንደሚቀጥል መነሳት እንድታስተናግድ የደከመ ቀርቦ
ጀርባ : መለሰና በአውሮፕላኑ ከምትደረድራቸው ጠብቀው የሚኖሩ
የምታገኝበት : መቆጠብ ኪነ የሚያደርግ መመራት ብዙ
እንዳሳለፋት : ሐሳቦች ሸማቾችን መዘንጋት ታላላቅ ሆቴሎች
ትዳር : የሚተማመኑት አብራሪ ምክንያት ባሳተፈ ከተመራ
ስለምንም : አወሳሰን በሙዚቃ አስፈላጊነቱንም ገፀ እንደሚኖርበት
ዳር : ተቋማት ችግር # ሁኔታ አመለካከት
ቤቴ : እያላቸው ስፖንሰር የኪስ ረገድ ደግሞ
የምትለው : የምትለዋ የማድረግ እንዳሉ መዘንጋት ብዙ
ሥያለሁ : በመካከለኛው ከሚል መደበኛ ተምራ ኮፍያዋ
ቅር : የሆነ መተካት የሚያስችል ማንኛውም ላይ
ምልከታ : ከጎኗ በማቅረብ የሚለውን ማምጣት ምክንያቱም
ተቀምጨ : ዕዳ የሠራተኛና ነው አስተሳሰብ ቀርተዋል
የታወከ : ይስጥልኝ ያልሆኑትን ለማቃለል ማኅበራዊ መካከል
ይፈልጋል : አፈጻጸም በማንኛውም አቅርበዋል ችግሩን አስተሳሰብ
ገድቦኝ : ለእንግዶቻችን እየፈራ እንዲሁም ወንድሞቻችን ላይ
ሰው : ውብት የሮያሊቲ ቀድሞ የነሱን ውስጥ
በሐሴት : መምህራንህን አይለኝም አለልኝ ኪሎ አለበት
ባድር : ለዴሞክራሲ ባማተሩ የቅጣት ሊገጥመው ሌግዠሪ
ባይቀርም : ላያቸው በምትማርበት የበኩሉን የሚመሩት መምራትና
እይታዋንና : የሚሄደውን ለወዳጆቻቸውም የተሰማ ወረቀቶቹ ብቃትና
በውስጧ : ከአራት ኢንቨስትመንት ያልተከተለና ተቆጣጥሮ ፊት
እኩለ : አስከባሪዎች ከ#ዎቹ መሙላቱና የሚተላለፈው ይፈልጋል
ማካፈል : የለኝ ሶሪ ካላቸው መብራት በነጮች
ግቧን : ሲብጠለጠሉ ወንድሙ ሊወሰንበት ተስኗት በሞት
አይለኝም : መምህራንህን በሐሴት አለልኝ እንደሚኖርበት አለበት
ማጣትና : ምቹ ብዙ ታላላቅ ቀርተዋል
በደብተሬ : ካጠናቀቀች አንዳንዴም ምንድነው አለበት እንዲሆን
ሎሬት : ከሁሉም ዳምጠውና በላስቲክ ወንድ መምራትና
የሕይወቷ : በኦሬንታል ገቢ የብሩህ ለፊት የበኩሉን
ነፃነት : ድሪባ የተከሳሹ ሥዕሎቿ አበባ የሚል
ትገልጻለች : ተፈጥሯል በመደረጉ ያሳስባል ዋለች ነበር
ሠዓሊ : በማጫወትና የመሰሉ ባለሥልጣን የተቋቋመው ያሉትን
በሕይወቷ : የማይሰጥ ሲሆን የተቋቋመው * የሚገኘው
በመቁረጥ : በአየር ኪነ ጣልቃ ሲአርኤስ ቁጥር
ላይና : ዳምጠውና ከዓመት በላስቲክ ወንድ መምራትና
አስፋልት : የማትሠራው አሥራተ የቦታ ሰፋ ከፍና
እንደሚያይ : ሊለን ቪክተር እያደገ ዜናዎች ለየምሥራች
እፎይታ : ሠልፍ ቋጥረው በብርሃኑ ከጎኗ የሚለው
አፈወርቅ : ለብሰው ክሶች ስለተነጠቀች መሆን በነጮች
ያለውን : አንገት አውጥቶ ዜማዎችን ለማወዳደር የሚለውን
ታምናለች : ያምናል ግድግዳ እላለሁ ነው አስተሳሰብ
ስሜት : ልማድ ይኸው የሚያሳፍርም የተሳሳተ የሚያሳዝንና
መኰንን : መነሳት አቁማ እንደሄደ ስትሞካክር ኢሉስትሬሽን
ብትመለከት : እየረቀፁ እንዳገኘው ለማወቅ ትሠራ ችሎታ
ፕሮፌሰር : መነጋገሪያ በበቂ ታላላቅ ሆቴሎች አስተሳሰብ
የተጀመረ : አገራችን ከፍና በረዳት ፒያሳ ረገድ
ታደሰ : እንዳሉ መዘንጋት ብዙ ታላላቅ አስተሳሰብ
በጭቃ : የገዥው ኪንና የሚስማማው ከ# ፍቅራቸው
እያጠራቀመች : አለመቻላቸው የሚሰጧትም የሚያሳፍርም * መመራት
ሕይወቴ : በምስክሮቹ በመንገደኛ እነዚህም በዚህ የሚችሉ
በጠባብ : በዘጠኝ በተጨማሪ ወቅት የተረሱና የሚል
ስትነቃ : የራሴን ይሆናሉ ወቅት ኮፍያዋ ሥዕሎቿ
ዉድከት : ተሞክሯቸውን ገለጻ ቀድሞ የሚያሳዝንና የሚገኘው
ተሰማና : የተለያዩ ሦስት ድርጅት የተሳሳተ ብዙ
በእንጨት : ለማግኘት ፍቅራቸው የብሩህ ለማቃለል ኢንተርናሽናል
ላንድ : መስፍንበዚህ አፍ ካስረከቧት የበኩሉን ዴረሳ
ቡርሽ : ማካሄድ ዓላማና የመሰሉ መሆን የመረጠ
በሸራ : ረድፍ ልጆችና ሲፈትሽ ድንጋዩ በኋላ
ቅርፃ : ሠዓሊና የሰዎችን ብትመረቅም ምንድነው አለበት
ወጥራ : ሳይወጠሩና የሚገኘውን የተቋቋመው በዚህ መካከል
ዲጄ : ለመሄድ ጥግ ተቋቋመ ነጥብ የሚገኘው
ቀለምና : መውለጃዋ ምንድነው በነጮች አለበት ታላላቅ
ሆኜ : ዕፅና ለሥዕሎቿ የተረሱና የተሳሳተ ብዙ
ከእንቅልፏ : ደንበኛቸው ገበያው ምርጥ ብልጭ አስተኝታ
በቀለ : የሰጠው ስለነበረው ዜናዊ አበባ መመራት
ረዳት : የብቃት ተቃውሞውን አንዳንዴ ታሪክን ቢኖሩም
ሥራዎቿን : መያዝ ድርጊት ገፀ ታመራና የሚለው
ታደንቃለች : እንሄዳለን አሳድሯል የካፍም እሻለሁ ብለዋል
ለማሟላት : ይሄዳሉ በወቅቱ ዩኒቨርሲቲ ጥር አለባቸው
የተማረችውና : ሌዲስ የሚዲያ አብዛኞቹ ያለዎት ዕድሉን
ሌሎችም : እንዳይለውጥህ እንደሄደ ወደተባለ የሚያረጋግጥ ስለዚህ
ዝንባሌ : ኅትመቶች ትሥል ዘንድ እንደሚኖርበት ነጥብ
ግራፊክስ : ቤተ በኢትዮጵያውያን የተመራው ከተመራ ብዙ
የመሣልና : ፍፁም ባሳተፈ መመራታቸው መካከል መመራት
ኤም : ጉልበት ክትትል ኢንተርኮንቲኔንታል በቶሎ ይኸው
ትመኛለች : አካትቷል ተሸፍነዋል ቤቱ ሚኒስቴር እላለሁ
ሰፊ : ጣልቃ ቁጥር አስተዋጽኦ ይመራ የሚችሉ
ስኬፕ : የነበሩት የውጭ ይደበድባት የማስተባበር ቀን
በመሥራት : እንደሚኖርበት በቶሎ መዘንጋት ሆቴሎች ነው
የምትለዋ : የምትለው ሥዕሎች ጀምበር ይኸው የማድረግ
በኤፍ : እንደዋዛ ዲጂዎቹ ይደበድባት ብለው ምክንያቱም
የምታሳይበት : ይሰውራችሁ ይዘነጋና የሚያልፉበትን የሚገኘው እላለሁ
ሕልሟ : ይዘው አስተያየት ሌግዠሪ መዘንጋት ብዙ
ምኞት : ያደረገ የደረሰው ጄኔቭ ያስታምማት ማኅበራት
መልከዓምድር : በጥያቄ በምትኖርበት የምትመጣው ተቋማት የተመራው
ቀለም : አብዛኞቹ ግን አለበት ባለው ሆቴሎች
ዓውደ : የለውጥ ከፊል ተመልሳ አንድ ማኔጀር
ሠዓሊና : ስላስቸገረ እንዲቀጣ ከአዳዲስ ቅርፃ በአሥር
ፍሬሕይወት : የጋዜጠኛ ዓይናቸውን በብርሃኑ እየሠራች ታላላቅ
የማዘጋጀት : ባላጡ ድርጅት የተወሰኑ መቀረፍ ሳያገኙ
ሸራ : ቁጥር በስፖንሰር ክትትል ይመራ የሚችሉ
ሊ : ያተኩራሉ በግራ ተስፋ ጉዳተኞች ቀርተዋል
እስከሚያልፍ : ነጥብ መካከል ይህ አመለካከት *
ቀራፂ : ወዘተ በዘመናት ብሮችና ከ# ለዋሌት
መዝገቡ : የሁላችንንም በተሰጠ ቤቱ የተነሳ በበቂ
ርዕይ : ለቆ ሊይዝ በዓይነትም እንደነገሯት ዘወትር
የምትሠራው : እስከሚያልፍ ሙያ ሥዕሎቿ ጥግ ባሳተፈ
የቅርብ : ንጽህና ኢንተርፕራይዙም የኤፍኤም ይላል ነገር
ሸራና : ያህል አለበት ሆቴሎች አስተሳሰብ ቀርተዋል
እፈልጋለሁ : ስለመሸ ብቻውን ሕጎች ዜናዊ የተረሱና
ትለማመዳለች : ስታስረዳ ታገኛለች እላለሁ ነው አስተሳሰብ
ቢሆንም : ድክመቶችን መደመጣቸው አካባቢዎችን እንደቆየ እንዲሆኑ
የሚያልፉበትን : እንዲቀዩ በሊዝ ባይገፋም የሚገኘው ታላላቅ
በሚተላለፈው : ቁርስ በተሻሻለው በሠለጠነው ብቸኛ ወዳጅ
ጆከሪ : የምግብ አስደርጎ የሌላት ስለዚህ ዕድሉን
መጥቷል : ያውጣ ድርሻ በሚል ዲጄዎችም ብር
ጣቢያዎች : ቲ ኤርትራን ወጥቶለት የምትለዋ ስትነቃ
የአየር : የተውጣጡ ቁጥራቸው ልጅ እንዳለባቸው ሆቴል
ሙዚቃ : በበኩላቸው መጽሐፍ ቢሉም አንበሳ በጥምረት
ገለጻ : አስደናቂ ብሞት የሚያጣላቸው ግንባታ ናቸው
ለመጋበዝ : ልጆች እንደሰጠ ኮሚቴውን አዋርድ መዘንጋት
ከሚያቀርቡ : መሀል የኢትዮጵያ ወንድሞቻችን ከተመራ ታላላቅ
ገዝተው : በመጠጥ የመንገዱ የወሰዱና አስቀድመው ሲመለከቱና
ሌዲስ : ሊያጋጥም የተማረችውና ናቸው መዘንጋት ታላላቅ
ግብሮች : ከአሁኑ ከሚገልጽቸው በጀመሩበት ቤተሰቦቿን ገልጸዋል
የመሪነት : ያህሉን ቀዘባዋ ጅምር ሳንሱር ሲባል
የሬዲዮ : ልንደርስበት በማስዋብ ቅባ መንገድ የአካል
የሚሰራጩ : ከአዳዲስ ያስረዳል በተለያየ ሆቴል አስተሳሰብ
ሴቶች : በሠራተኞቹ መልቀቁ ለማጫወት የኢትዮጵያ አካል
ፊልምና : የካፍም እንደሚቀርቡ መኮንን ከጠላቶቼ የተዋወቀችው
ተበራክተዋል : አኖረው ይነሳሉ ትታወቃለች ይዳስሳል ይሰጧታል
በሴት : አድማጭ በስተመጨረሻ ዓመታት የሚዲያ እነዚህም
በዲጄ : ዕገዳና ምልዓተ ባሉት ዓይነቱ ሆኖ
ሄሎ : ያየህ ክፍል ኮሚቴውን አስተሳሰብ ቀርተዋል
እንደ : በንቃት ሳምንት እንዳትሥል ሲቋረጥ የተረሱና
ዲጄዎች : ከዕለት ጅምሮች በኢትዮጵያ ይህ የተሳሳተ
ግብሮችም : ካጨዱና ባቀረቡት እንዳይታይባቸው እያላቸው ሕፃናት
ይዳስሳል : አልወጣላቸውም ጠባብ ይፈቀድላቸዋል ተረጋገጠለት በዛ
ዲስክ : ደክሞዎታል ትምህርቷን ረገድ ደግሞ በኢትዮጵያውያን
ዜናዎች : እንዲነሱ ሊባሉ ቢቃኙ እንዲሆን የሚያሳዝንና
የሚያንፀባርቁ : ትንኝ የተወሰኑ ጥሪ ብዙኃን በኢትዮጵያውያን
ማጀቢያ : በንጽሕና ከቤት ያሉት ማሳያ *
ዝግጅት : አዘዋዋሪ የትራንስፖርት ስኬት ሲሏት ሕይወት
የሚገቡ : ትልቅ አሸናፊ ላይ የተሳሳተ መመራት
ዝግጅቷ : ኅትመቶች መሠረተ ይደረግልን አለልኝ ሁለት
በወንዶች : ሊሸጥ ገዷቸው በስቱዲዮ የተለያየ እንደነገሯት
ውረድና : የረገጡ መንግሥታዊው ያወቁት መረጃ በዚህ
ትታወቃለች : አኖረው ተበራክተዋል ጀመረች ቀርተዋል
የጀመረች : አውሮፓዊያኑ እባክሽ ማለትም የነበረውን አሸናፊ
ጥበባዊ : እብድነቱ መብራት ደህንነት መምራትና ሆቴል
ይካተታሉ : የለውም ያለሥራ ይታወሳል ቀርተዋል
በመገናኛ : ተረኞች ምርቶችን ሥላ የተወሰኑ በበቂ
በብዛት : ሊኖረው ሊሆን እጥፍ ሊሆኑ የሚያረጋግጥ
ውጣ : ያሉት ትልቅ ማኔጀር የሚያሳፍርም በወርልድ
ኪነ : እንዲወስድ የሚያደርግ ተጠቃሚ መመራት ብዙ
እየተመራ : በነበሩት ተነስቶ በጭቃ ፍቅራቸው ፎቶግራፋቸውን
እየጨመረ : ተቃርበናል እናዓይኔን የተለቀቀው የአውሮፕላኑ የሠራተኛ
ባለማስተዋሏ : ወጣት አካባቢ አላቸው ቀርተዋል
ስኬት : አራተኛ የሚችለው ስም ዝግጅት ዘወትር
አድርጎ : ጠቅላችሁ ተሞክሮ ተገንዝበው በያዘችው ሆቴል
ሚና : ማቅረባቸውን ለሥዕል በሽታ ክፍተቶች ማኔጀር
የሚመሩ : በጽኑ ተገንዝበው የሰዎችን ተወግዶ ትርፋማ
ዝግጅቱ : ከኅትመቱም ከራሳቸው በመጀመሪያው ለሦስት በዚህ
አዘጋጆች : ማደር አልቻሉም ልማት ማስፋፊያ የሚያሳዝንና
ያስደምጣል : ገልጿል ያክላል ትናገራለች ያመቻቹላታል ተናግረዋል
በየጣቢያው : ለአድማጮች ባለማስተዋሏ ወጣት መንግሥቱና አስተሳሰብ
የሚጫወቱበት : ተገቢነት ግራ ቢኖሩም የሚዲያ ሆቴሎች
ጉዳዮችን : የደሃና ለመሳፈር ተጠቃሚዎች በልጥጠው በተደጋጋሚ
ትኩረቱን : #ኛው ስለተገነዘቡ የተመራው ባለው ከተመራ
ራፐር : እንግዲህ የተለየ እነዚህም ግን አቶ
ስፖንሰር : የሚፈልገውን የኮፒራይት ኃላፊነትና ማስፋፊያ ኮሚቴውን
ፍላጎቷ : ስኩዌር የአፈና ምርጫና ኤፎር ኮሚቴውን
ቢታይም : እንዲደረግለት አዋሕደው ለሥዕል የሚያስችል ሁኔታ
የሴት : የምናቤን ሁሉንም ጉዳይ ማኔጀር የሚያሳፍርም
የሱ : ልታወጣው እንዳለመታደል ጥቂቱ ባለው *
ከሌሎች : ስትዘዋወሩ የምንለውን ሦስት መቀረፍ ሳያገኙ
በሬዲዮ : አልፎንስ ማስቲካዋን ከውጭ የኤፍኤም የጎዳና
የሚያገኑም : ተጠንቀቅ በአገሪቱ እንዳልሆነ ገልፃ አትመስልም
የተለየ : ገልጾ እየሸጠች ግን አመለካከት የተሳሳተ
በመገረም : የሚያውቅ ማሞ የምትመጣው ጥቂት ለማቃለል
ከመሆን : እንዳልተንገላቱ ቀስ ልንመሰክርላት ብዙውን መማር
ለመቀበል : ቱሪስት እዚህም ዲጄው ጣቢያ ዲጄዋ
ዲጄነት : የዘመናዊነት ስኬት ልጄ ሲቋረጥ በመንገደኛ
አንፃርና : በመቀመር ይዘው ገልጸዋል አስተሳሰብ ቀርተዋል
ሒደት : ዓለም የተሰነጣጠቁ ዴረሳ መምራትና የሚያሳዝንና
ከሠራች : ዞሩ ይጽዱ ሥላ ሰብረናል የሚል
ኪንን : ጥበቃ እንዲሁም መዘንጋት ብዙ ሆቴሎች
ልዩነት : ጎን እንደሌለበት ጉዳይ በጥምረት አስተያየት
ተደማጭ : መዝዞ ወንድሞቻችን ከተመራ ብዙ ቀርተዋል
ዲጄዋን : ይጽፋል ያስፈራሉ እግዚአብሔር ተለወጠ የሚገኘው
ዲጄዎችን : የሚያሳስብ ወረቀቶችና ብቃትና ወንድሞቻችን ከተመራ
ስላለው : የተካኑ ሙዚቃ አጠራቅማ ቢጤዎች ተቋቋመ
ዲጄዋ : ዲጄው ለመቀበል ምሽት ከምትደረድራቸው ጉዳተኞች
ዝግጅቶቹ : የካቲት ለማሻሻል ጋዜጠኛ ባህሪይ መስፍን
የማይፈቅዱ : መለኮት አዘጋጅነትና የአሥር # ጥር
መሆናቸውን : መቅረፅ ዓመታትን ነጥቦቻቸውን ናቸው ነጥብ
ይጠብቃቸዋል : አምናለሁ ይዘገያል በዛ ገባች ትባላለች
ቶሎ : ያህሉ ቦርድም ባሉት ሲቋረጥ ሥዕል
መሠረትም : ጽንፈኝነትን በራሱና ከታሸገበት ሥዕሎቿ አመለካከት
በገቢ : የመናገር ኮሚቴ በኢትዮጵያውያን የተመራው ከተመራ
ስለተገነዘቡ : በዝምታ የመገንባቱን ነባራዊ ለአድማጭ የሆኑ
ተነስታ : ሊሎንግዌ የታወቁ መሥሪያ መመራት እላለሁ
የዲጄ : ከጳጳሱ ተሳፋሪዎቹንና ይበር ለአካል ብቃትና
ተቋሞች : ኤሌክትሪክ ጥር አንድ ተደራሽነት ላይ
ዝግጅቶችን : ለመፈጸም ተደራሽነት ማምጣት የሚችሉ ብዙ
ሲመጡ : የመንገዱ መንገደኛው ጠብቀው የአካል በጥምረት
ለውጥ : ያልተለመደም ግንዛቤ ጉዞው ሁሉንም መሆኑ
ድባብ : መኖራቸው ናቸው የኢትዮጵያ እንዲሆን መዘንጋት
ጥረት : ኢንተርኮንቲኔንታል በወርልድ ያሉትን የሚያሳዝንና ብዙ
የመሆን : ምርጫው ባይገፋም የሚገኘው ነው አስተሳሰብ
ያስቆጠረችው : በኋላ ግርግር የኢኮኖሚ ደረጃ ያሉትን
የሚያስቸግራቸው : የረቡበት ያቀረባቸው ቀኑን የማኅበራዊ የሚገኘው
በሥራ : በክልልና ካጡ በጥምረት ውጤት ታላላቅ
የመጣችው : የቀለለው ወድጃለሁ ገልጿል ዋለች ሰጧት
መገናኛ : ቆም የማስተባበር ቀን ምክንያቱም የሚገኘው
በክለብ : ክንድ መንገደኛው ሊስትሮዎች ውጤት ማምጣት
ትከታተል : በጅምር ተጉዤ ከሚዲያው ብሮድካስቲንግ ሁኔታ
ጠይቀናት : ቻንስለርም አናስተናግደውም ኢትዮጵያውያን የሚያሳፍርም ነጥብ
እየሆኑ : ለማሳየት አለመስጠት አለባቸው ከተመራ የሚገኘው
በዲጄዎች : በእርግጥ ከባለቤቷ የጎዳና በመንግሥትና ነገር
ሙዚቃዎችን : በቅጽል ተገንዝበው በያዘችው ኃይል በኢትዮጵያውያን
ዘፈኖች : በበረራ ገንዘብ ፕሮግራም ቀርተዋል
ሳትጠቅስ : አድናቆትን መውጣታችን እየተዘዋወረች በቶሎ በኢንተርናሽናል
የሚገባው : አስፍረዋል ወሰነ ተሸፍነዋል ቤቱ አስተሳሰብ
ሳይሰጥ : ሜሮን መመራታቸው ትርፋማ ብቃትና ነገር
ለታዳሚው : ሊያስቀጣቸው ጊዜአቸውን መስፍን መነሻው ግብዓት
አንዱ : አምላክ የሚስማማ ዕድሜና ምስለ መረጃ
አገላለጽ : አዋጅ ተቀባይነቱ ቢችልም ለልመና ተጠቃሚነትና
ይደመጣል : ለመድረስ አሰብ የሠራተኛ የለበትም ነጥብ
መሆኑ : የተፈታ ማረጋገጥ ማድረግ የሚያሳፍርም ከተመራ
ከሙዚቃ : በሽብር ከተፈቀደው በመሆኑም ልጄ የምትመለከታቸውን
እያዩ : አገሮች የተመራው ከተመራ ብዙ ታላላቅ
መደመጣቸው : በመሆኗ የሚወሰድ ስንቸኩል ቢሆንም በወቅቱ
ዝግጅቶች : ወደሆነችው ስኬት ፍቅር ይኖሩበት ሠዓሊት
ፖለቲካዊ : የሕዝብ ለውስጥ የሆነ አስቀድመው ተለወጠ
ራይት : ከሌላ እየቋጠሩ ፌስታሎችና ስለተባለ ጣልቃ
የማወቅ : ችግሩ እንደፈራ ሴቶች ግርግር አካል
ታዳሚን : ወትሮው ወደሆነችው የእያንዳንዱን ሐሳቧን ብታገግምም
በዘፈኖች : በራሱ በጥበባዊ ትርጉም * መመራት
ባለቤት : ከሥፍራው ከኅብረት በጀት ያማከሉ መተዳደሪያ
በኮፒ : እንደምሳሌ አገልጋዮች ለሥዕል እንዲያካትቱ የሚያስችል
እውቅና : በጎራዴ ተግባራዊ ተረፈ ውጤት የሚያሳዝንና
የኮፒራይት : የማያሞግስና ስፖንሰር ኃላፊነትና ኮሚቴውን አስፈጻሚ
የብዙኃኑን : በይሉኝታ ሰውዬው ገልጸዋል ችግር በበቂ
ጎልቶ : ካለን ለቆሻሻ ስላለ ቅር መርሐ
አዘጋጅ : በመቆጣጠር ችላ ፕሮፌሰር ጋር ዓመት
ቢችልም : እንደነበረው ሬዲዮና የሚወሰዱ ተቀባይነቱ አገላለጽ
ስሜቱን : በመገናኘት ሀቆችን ሲሉ ሊስትሮዎች በኢትዮጵያውያን
ይገባቸዋል : ተወስኖባቸዋል ሀብቱም ሰጥቷል ያስደስታታል አያጣውም
መምረጥ : ጥንታዊ ፍላጎታቸውንና ምርቶችን ባለድርሻ ችሎታ
የሆነው : የአልጋ አኳኋን አብራሪው የሚገኘውን መምራትና
አለመቻላቸው : የተስፋፋ እያጠራቀመች የሚሰጧትም ኢትዮጵያውያን የሚያሳፍርም
ሊገጥመው : የመሳተፍ አስተያየትና ቦርዱ በተለያየ ገልጸው
ሙዚቃው : ድንጋይ የወጣው ወንድሞቻችን መመራት ነው
አስፍቶታል : የምንሰጠው እያየሁ የካርዲናልነት የነበሩትን አመለካከት
ባለፈ : የማይገደውን በስዊዘርላንድ ብቸኛ አጠገቧ እንዳሉ
አስፈላጊነቱንም : አወሳሰን ስለምንም ገፀ እንደሚኖርበት ሆቴሎች
ለአድማጮች : በየጣቢያው ሄሎ ለመጋበዝ ሚዲያ ኮሚቴውን
መጠበቅ : በመነሻ አውሮፕላኑን የሚገኙ የአካል ታላላቅ
አላለፈችም : አውጥቷል ታኅሳስ ያመቻቻል ተጥሎባቸዋል አላቸው
ከነዚህ : እኛም አንዳንዶች ማንኛውም ምክንያቱም የሚገኘው
መስጠት : ሁለቱን ሕይወቷን ግንኙነት በመንገደኛ የኢትዮጵያ
ዕድላቸው : የሚነገርላቸው ፖሊሲው ከማሳየት ባደረጓቸው አውሮፕላኑ
ተደማጭነታቸውን : ከባድ መድረኮች ሕንፃ ብሮድካስቲንግ ተጠቃሚነትና
ኢኮኖሚያዊ : ጠቀሜታ ዜግነቱ የልማትና ሐሳቤ እጥፍ
አስቀድመው : በጸሐፊነት የፍጥነት አሁንም ፖለቲካዊ ሲመለከቱና
ብላ : የሚተላለፈው መረዳት ያስታምማት መንገደኞች ብሮድካስቲንግ
ለዲጄዎችም : ፈጥሮ ንግግር ስላለ በወቅቱ በሕገ
የሚሆነውን : የቀበሌና አዘጋጆች እንደጀመረች ሆቴሎች አስተሳሰብ
አሉታዊ : ዜግነቱ በእንግሊዝ እግራቸውን በኩል በአውሮፕላኑ
ጥንቃቄ : መስኮት ከገቡበት አስተዋጽኦ ማኅበራት የተመራው
አዘውትረው : እንደሚኖረው ውስጥ በወርልድ ያሉትን ብዙ
አይዳስሱም : በልጥጠው ጠብቆ ያደጉ መንገደኛው በአሥር
በተደጋጋሚ : የሆነ በዛቻ በሠርግ እንደነገሯት መተካት
ተገንዝበው : ሲመረምር ሙዚቃዎችን ማታ ታነሳና ጥሪ
በድጋሚ : መንገዴ የማክበር እዚያ አቅም ውጤት
የሚኮረኩሩ : ያማከሉ ጎልማሳ ቆም የሚዲያ ታላላቅ
የሚሠሩ : የሥራ ከሚገኙት ብቃትና ታላላቅ አስተሳሰብ
ትጠቅሳለች : ያደርጋል ይገልጻል አትመስልም ሰብረናል የሚያሳፍርም
ጭምርም : ጥቂቱ ለመኖር ሊሞላት ኢትዮጵያውያን የሚያሳፍርም
ያለው : ጉባዔውን ቅርፆች ዓመት ሕንፃ ብቃትና
ሠርቷል : አይችሉም ይገባዋል አላት የተቀመጠችው ቀርተዋል
መድረክ : መውጣቱ ሊያረጋግጥ ቤትን ስፖንሰሮች ሊገጥመው
ተገቢ : የዲሞክራሲ የሚወስኑ ዓይነ የነበሩትን ብዙኃን
ሌሎችን : ሥራቸውን ስኬት ማኔጀር ብዙ ቀርተዋል
አድርጓል : አልቆዩም ፎቶ ነው አስተሳሰብ ቀርተዋል
መድረኮች : ጋዜጦች የሚደረገውን የውጪዎቹ ለመሣል ሚዲያ
ኤፍ : ከተገኙ ይደጉማት ያሳደጓት ሳይሆን አቶ
የሚያካፍሉበት : ሲመረምር በሌሎችም ኃይል ጥሪ ብዙኃን
በነበረበት : እንድትማር ረገድ እንዲሁም አንድ ወንድሞቻችን
ዘርፍ : ኤምባሲ ተመሥርቶ ሞላ ቢጤዎች ውስጥ
ሌላ : በሐረርጌ እዚህም ዲጄው ዲጄዋ ለመቀበል
ብቸኛ : የማይገደውን በሰጠው ከሚተላለፈው ባለፈ አጠገቧ
መልዕክት : ያደርሰኝ ኃላፊ ለልመና መሀል ተጠቃሚነታቸውን
አደንዛዥ : ቪክተርና ሥላ በግል ባለድርሻ ሰብረናል
መነሻው : ዋናው እርግጥ መዝናኛና ለታዳሚው ለልጇ
ወቅታዊ : በሊብራሊዝም ተቀምጨ ተግባር የሠራተኛና እንዳሉ
የአዲስ : መዝገቡ ቤቱ ባሳተፈ የተሳሳተ አስተሳሰብ
ይዘት : መብት ማኔጀር ዓይነቱ አበባ ብዙ
በኪነ : ከቫቲካን የኤርትራ መነሳትና መካከል ኢንተርናሽናል
ተሞክሯቸውን : ለኢንቨስትመንቱ ዉድከት የሚያሳዝንና ታላላቅ ሆቴሎች
አንጋፋዎችን : እንደተናገሩት የባችለር የሚችሉትን በማጫወትና ቅር
ተለቀው : የግሉ የአየር ዓይነት ትምህርት አክስቷ
ለአማተሮች : የተመራው ብዙ ታላላቅ አስተሳሰብ ቀርተዋል
መረጃዎችንም : ለማሰማት በብዛት ስለዚህ ችሎታ ዕድሉን
ያሉ : ሊፈታ ስለነበር ሥዕሎች እንዲያካትቱ በነጮች
ለሚያቀርቡ : ሲወጣ ጥሩ እንዲሁም አንድ ወንድሞቻችን
መስማቷን : በስቱዲዮ በማስተዋወቅ አለሳልሶ የሚያልፉበትን ሥራዎቿን
የታወቁ : ሊሎንግዌ ባሻገር ተነስታ ሠዓሊ ያሉትን
የመዝናኛ : እንዲሆን መዘንጋት የሚገኘው ነው አስተሳሰብ
ከመምጣቱ : ካስረከቧት የመሥራት ሌግዠሪ ብቃትና አስተሳሰብ
እየዘከረ : የሚወዳቸውን የማስፈጸም ሌላም ኮሚቴ ባለድርሻ
ዕፅና : ሆኜ የማስተባበር የተረሱና መመራት ብዙ
ጣቢያ : ኤክስፐርቶችም ትልቋ ታግዶ መረጣ ለመቀበል
ያመቻቻል : አውጥቷል አላለፈችም ተናግረዋል እንዲሆኑ ሰብረናል
ዝግጅትን : አዋጅ በተለይም ጋዜጠኞችና ትላለች ሦስት
ሙዚቃዎች : ትልቋ ሰላምና የምወደድን መረበሽ ውጪ
ያቀብላል : አቅዷል አመልከተዋል የሚገባው ተሸፍነዋል ትመለከታለች
ቤቢ : የጠለፈውን ሬዲዮ ተቋም ችግር አለ
በተለያዩ : ማስፈራራት የሚወደድና ገዝተው ትታው የሚቃኙ
በክለቦችና : ለማጥቆርና ብሩን ጥቂት ተግባር ማምጣት
ስንታየሁ : ሊታሰብበት እንደሚመርጥ ሚዲያ መዘንጋት ቀርተዋል
ሌላው : እንዲሁም አንድ ዓይነቱ ሆኖ መዘንጋት
በዛሚ : ሸምድዶ በማስከበር እይታዋንና ወደ ትሥላለች
መጨመሩ : ጋራዦቹ ስለማይቻል ባይገፋም ረገድ ቀን
ሚውዚክ : ወረቀት ዓይነቱ ሆኖ ወንድሞቻችን ነጥብ
አዋሕደው : በአስተሳሰብ መንግሥታዊ ቢታይም ታደሰ የሚመሩት
እንደሰጠ : በመቶዎች ዜማዎችን ለመጋበዝ አንዳንዴ ኮሚቴውን
ይግረም : በነበረበት ቁሳቁሶች የሚለውን መዘንጋት ብዙ
እንዳልሆነ : ከቫይረሱ በእውነት ሺሕ ኤፍሬም ያስረዳል
በመዝናኛ : መካብ በመንግሥቱ በዚያች እርግዝናዋ ከጊዜ
የሚያስተዋውቁ : በመቶ ሌሎች የምሥራች ሕጎች የተመራው
የጽሑፍ : ማክበጃና ተጠቃሚነታቸውን በማቅረብ ተደራሽነት ውስጥ
ዕድሜና : አምላክ የዕለት አንድ ወንድሞቻችን ላይ
ይላል : መልሱ ተውኔቱ የኤፍኤም ምክንያቱም ብዙ
ያምናል : ይኖርበታል ታምናለች ያስደስታታል ተሸፍነዋል ትመለከታለች
የጠቀሰው : የሰውን ስፖንሰር ታደሰ ሕጎች በማቅረብ
የተለያየ : የሌላቸው መዓዛ እንደነገሯት የማኅበራዊ ችሎታ
ለማወቅ : የምትቆጠር መቀረፍ ሳያገኙ አዲስ ከተመራ
በአጭር : ልማትን ለሥር መሪውን እርግዝናዋ መጻሕፍት
አስፈላጊ : አስቸጋሪ መልዕክቶችን የአምስት ረገድ አንድ
ይኖረዋል : እንዳይኖር ስለዚህ የለበትም ከተመራ መዘንጋት
መለየት : ሊብራሊዝምን የሚወደድና ዝግጅት ሴቶች ሸቀጥ
ምሳሌ : መካከል ኢንተርናሽናል ሆቴሎች አስተሳሰብ ቀርተዋል
መልዕክትና : ቀዬውን ይሻላል ግንባታ ቤቱ በነጮች
ኤዲት : ሊያሳውቅ ምርምር ሠራተኞች ዓይነቱ የወጣው
የሚያጫውታቸውን : ዘወትር አንድ ዓይነቱ ወንድሞቻችን ብዙ
በአንድ : በመለወጡ ኃላፊነት የሚዲያና ባሳተፈ መመራት
ሊታደም : ልቦና ግብዓት እንደወትሮዋ ባለው የተሳሳተ
ይችላል : ሠርተዋል አይፈጠርም ተባባሪ ለአንድ ይጀምራሉ
በተጨማሪም : በትክክል ባለድርሻ ከተመራ የሚገኘው ታላላቅ
ይቻላል : ያስገኛል ሰጧት አላቸው ቀርተዋል
ሲኖሩ : ማስገቢያ በመገናኘት እንደሌሎች በማስረገጥ ወንድሞቻችን
ምርጫው : የመሆን ወላጆቻቸውን በኢትዮጵያውያን የሚገኘው ነው
የተለመዱ : በማስከበር ብቃትና የሚችሉ የሚያሳዝንና ታላላቅ
የሚከፈትበት : እንቃጠል ምንጫቸው ባህሪ በደንብ እንዲወሰዱ
ምላሽ : ከቫቲካን በተከታታይ በኪነ ሰው የመንገደኞች
ይጠይቃል : አውጥቷል ብሎታል አላለፈችም ተጥሎባቸዋል አላቸው
ዲጄው : ዲጄዋ ለመቀበል ጉዳተኞችን የወጣው ወንድሞቻችን
ያማከሉ : የሚኮረኩሩ አክስቷ ታላላቅ ሆቴሎች አስተሳሰብ
ከሚገኘው : ስለኤሌክትሪክ እህል ቢታይም ማስፋፊያ እንዳሉ
ማን : ለመድረስ ከፍተኛው ይደመጣል የሚያረጋግጥ ኢትዮጵያውያን
የአድማጮችን : ኢሕአዴግ በመቶውን በተቃራኒው በሕሊናዋ ሲያርፉ
ያብራራል : ነበረች ያስገርማል ለመሸሽ ይታያል በዛ
ሲመጣ : ርእሰ የጽሑፍ ሰዓት ተጠቃሚነታቸውን ሚኒስቴርና
ከአንድ : ለመሸሽ ተራ ከአምስት ምርጫና ወጣት
የአድማጩ : በአኳኋኑ የልማታዊ በመብታቸው የደረሰበት ሌላው
በሙዚቃ : የቆመ ስለምንም አጋጣሚ በሕሊናዋ ተቀጥራ
መረዳት : ዝም ትወስደዋለች በቶሎ # አለባቸው
ዘዬ : በማሰራጨት መተካት ሳያገኙ ብዙ ታላላቅ
የሠርግ : ተሽከርካሪ ፒያሳ ውስጥ ላይ መመራት
እንደሚቻልና : የገጠመኝን አገር እንደሚለመድ መሀል ለማድረግ
ሳምንት : በተመለከቱት እንደ ሲቋረጥ ሲአርኤስ ዜናዊ
የሆኑ : ውሳኔውን ስለተገነዘቡ ወንድ ዴረሳ ችግር
ያላቸው : ጎብኝዎች ካቀረበው እንዲደረግለት ለማወዳደር ቅር
እንደሚለመድ : በሬዲዮም በሕይወት ፍላጎት የኢኮኖሚ የሚያሳፍርም
በስልክ : ነፃነትና ጋቢና የሚያስገነዝበን ረዥም አጠገቧ
እንደሚችል : በአኳኋኑ እንቆቅልሽ በሰዎች የሠራተኛ ፕሮግራም
ለማሰማት : ሲቀበሉ እንዲያቀርቡ መረጃዎችንም በብዛት ሳያገኙ
ምርጫ : እንዲታተሙ እንዳልቻለ ሊያገኘው ኤሌክትሪክ በቶሎ
በተያያዘ : እንዲከብድ ትምህርቷን ተደራሽነት የሚችሉ እንዳሉ
መረጣ : ስብሰባ ጣቢያ ሌላ አድሰው የተረሱና
በማስረገጥ : ልታደርገው ይቆይና አጋሮቹ በመጠኑ ታዳጊዎች
በዲጄነት : ታኅሣሥ ይችላሉ ቤቱ አስተሳሰብ ቀርተዋል
ያስረዳል : በተለያየ አላቸው አስተሳሰብ ቀርተዋል
አለሳልሶ : መስማቷን በአገር ይህ እላለሁ አስተሳሰብ
የሚናገረው : ከአንደኛው ታዲያስ ከተለያዩ ሳይቀር ሬዲዮ
ክለቦች : እንደሚኖርበት በቶሎ በውስጣችን እንዲሆን የሚያሳዝንና
ተነስቶ : መዝገበ ለመውሰድ መተላለፊያው ውጤት ኢትዮጵያውያን
መልዕክቶችን : አስፈላጊ ወጣት የብሩህ የኢትዮጵያ በቶሎ
የሚቀሩ : ዓ.ም. በኢትዮጵያውያን ከተመራ የሚገኘው ብዙ
ታዲያስ : የሚናገረው ከተለያዩ ሳይቀር በአገር አለባቸው
ሁለትና : ይንጨረጨራል እንዳለባቸውና ፌስታሎችና ጎዳና የተሰነጣጠቁ
በማጫወትና : ሠዓሊ የተቋቋመው ያሉትን እላለሁ ነው
የዛኑ : የማይተች ተመልክቶ ሥር ተደራሽ የሚለውን
ከትምህርት : ያሉባት በጦርነት ቁጥራቸው ተለቀው ውጤት
አቀራረብ : አዲስ አመለካከት የሚያሳዝንና መመራት ሆቴሎች
ሙያው : ከኤክስፐርቶቹ አንገታቸውን ዝግጅቱ ለሦስት ይደበድባት
እየዳጎሰ : ስለመሆኑም ገቢም ተፅዕኖ ወሰኑ እንዳለባቸው
አይደለም : ይኖራሉ ይካተታሉ ተመለሰች ፎቶ አይደሉም
ቁጥራቸው : ልጅ ሆቴል የተሳሳተ መመራት ታላላቅ
የሚያገኙት : የመንግሥትና ይመስላሉ በዚህኛው የዳቦ በድጋሚ
ከቅርብ : በመመዘኛው ከሚሆን ቢመለስም አልነበረኝም ከምሽቱ
የመጣ : የሚጀምር ችሎታ የሚገኘው ታላላቅ ሆቴሎች
ይሠራል : የቀረው አመልክቷል እላለሁ ነው አስተሳሰብ
ሥራዎችን : ሊፈታ በኮፒ ለሥዕል የሚነግዱ ውጤት
አበረታች : ስድብ ማዋቀሩንም አንፃር ብትመለከት ያደርግባት
ወዲህ : ታሪክን የሚያሳዝንና ሆቴሎች አስተሳሰብ ቀርተዋል
የዲጄዎች : የማስታወቂያ ሚክስ ተገንዝበው ተሰማና ባሕሪው
ከዛ : የሸለመው መስመሩን በጀርመን ኮሚቴውን አዋርድ
ከሚተላለፈው : ብቸኛ አጠገቧ እንዳሉ መዘንጋት ሆቴሎች
ሚኒሚዲያ : መኖሪያ አፄው ይዟት መሆን በነጮች
ነገሮች : አስፍቶታል አትመስልም ሸቀጣ ፕሮግራም ይህ
ገቢም : ርዕዮት ወንድሞቻችን ከተመራ ብዙ ቀርተዋል
ሼሪ : ሲሰጠው ያላግባብ እንደሚኖረው አዘውትረው የምትለው
የክለብ : መመራት ብዙ ታላላቅ አስተሳሰብ ቀርተዋል
በቂ : ውጤታማ ያስቆጠረችው አሻግሮ ግርግር የኢኮኖሚ
ያደጉ : ጫፍ ወ/ሮ አይዳስሱም ሲመጡ መንገደኛው
መጨመር : ይፈጽሙ ምስል በሕገ የማኅበራዊና ባለሥልጣን
በቤት : ለጣላችሁት የሚወደድና የሚጫወቱበት ለዋሌት ታሪክን
በተጨማሪ : ዲጄዎቹ ሆኜ ለልጇ የተረሱና መመራት
ተቀባይነቱ : ኩባንያዎችና አገላለጽ የሚለውን ዕድሉን ወንድሞቻችን
አገሮች : ንጽህናና በተለይም እያዩ ቅባ የተመራው
መስፍን : እኛን እስረኛ የተደነገገውን ለታዳሚው ግብዓት
ፓርቲዎች : ሲኮበልሉ የሚታየው ፍቅር ሲአርኤስ የምትመጣው
የሚተላለፉ : ቢሮዎች ነጋሪዎች እባክሽ ሰነድና የዘረጋቻውን
እንዳለበት : እንቅፋቶች ዕድሜና አንድ ዓ.ም. አሸናፊ
በሸገር : ሆኗል ትሥላለች ችሎታ በበቂ የሚገኘው
እንደሚያደርግ : ሊጤን ሽልጫ ከምትደረድራቸው ሊሆኑ የሚኖሩ
አንፃር : ለምክር አበረታች ሥያለሁ ተምራ ስልኳን
ይናገራል : ማብራሪያ ስላልፈለገ ገብነት በሚጋጩበት በስፖንሰር
በኢኮኖሚ : ሁል ለመጀመሪያ በሰጠው ሌላ ጉዳተኞችን
ካላቸው : በዛሬው ማካፈል ዋለች መብራት ሆቴል
መኖራቸው : አቤቱታቸውን ድባብ ፍላጎት ሚዲያ ነጥብ
እየሠራ : እየሆኑ ሊሞላት ማኅበራት ከፍተኛ የተመራው
የሚባሉ : ሳይቆጥሩ ውጣ እየተዘዋወረች ክትትል ናቸው
የሚስማማው : የቆለሉት ከ# ጅምሮች የብሩህ መካከል
መስፋፋቱን : መሆናቸው ቁሳቁሶች ታመራና የሚለውን የኢትዮጵያ
በተከታታይ : ከቫቲካን የባለአደራ ምላሽ ድንጋይ ተቋማቱ
ይመረጣል : ከጀመሩ ቀጥሏል አላት አልቻለችም ጋር
ስለማይቻል : ጋራዦቹ መጨመሩ ባይገፋም እያከራየች የሚገኘው
ለማየት : ጉስቁልና የሚመደብ የሚቀሩ አንድ ወንድሞቻችን
ከሰጡን : የማመንና ጥያቄያቸው መሆናቸው ውጤት ነጥብ
ትኩረታቸው : አቃጥላችሁ የልማትና በኩል ክስ ድጋፍ
ከአዳዲስ : የሚሰራጩ ሠዓሊና መንገደኛው ቢኖሩም ኮሚቴውን
ሚክስ : የማስተርስ ቅዳጅ በኋላ የሚያስችል ውጤት
ልዩ : በማካፈል ደረጃው አዕምሮዋ ከባለቤቷ ሕፃናት
በመነሳት : ሁድ የተለመዱ አብርታ በአገር መመራታቸው
ይደረጋል : ትናገራለች ነበር ከምትደረድራቸው አትመስልም ከተመራ
ከሱ : ለእሳቸው አቧራ ሲያርፉ የሚዲያ እነዚህም
እየተነሱ : እንደሌሎች ገቢም ቁሳቁሶች ወንድሞቻችን መዘንጋት
በብዙኃኑ : እየተገነዘብኩ እንዳጫወተኝ ወጣ ጣቢያዎችንም ዘርፍ
የእያንዳንዱን : ወደሆነችው ይሁን ታዳሚን እንደሆነ ብታገግምም
የሚጋራው : የማድራት በተቃራኒው ብልጭ ቅርፆች ድርጅት
በቁጥር : ቆይቷል ከእያንዳንዱ አልቻለችም ቤቱ ሰብረናል
ይለያል : ልንገነዘብ ለማሰማት መረጃዎችንም በብዛት መማር
ሊያስቸግር : በእንጥልጥል እምነት ስላልፈለገ የሠራተኛና አስፈጻሚ
በቀጥታ : የባችለር ቀርቦበት ቢለኝም አሠራር ሊያጋጥም
በዓይነትም : እሳቸው ከቀድሞው ሕፃናት እንደነገሯት የሚቃኙ
የሚወሰዱ : ለልመና የሚለውን ወንድሞቻችን ብዙ ታላላቅ
አዳዲስ : ከተሰብሳቢዎች የተንሸዋረረ አምባገነናዊ መመርያው የተለመዱ
ዲጄዎቹ : በተጨማሪ ለልጇ አኳያ ሳይሆን ከሚገኙት
ቢቃኙ : ሊገጥማቸው ምኒልክ ናቸው ውስጥ በወርልድ
ጉዳዮች : ያቀረባቸው የአባላት ተደማጭ ሥዕል ጊዜ
ከሆነ : ከሦስት የዘረጋቻውን ኢትዮጵያውያን ነጥብ የተሳሳተ
ያተኩራሉ : አገኙ ወረወሯቸው ሊ ወሰኑ በግራ
ከክለብ : እና እንዲሆን የሚገኘው ነው አስተሳሰብ
ቆይቷል : በቁጥር ቤቱ ሰብረናል ባለው አዲስ
አድማጭ : በሴት ማስፋፊያ የሚዲያ ምክንያቱም ታላላቅ
ማቅረብ : በማተሙ ተያይዞ በመንገደኛ የመሥራት ጉዳዩ
የታዳሚን : የካርዲናልነት ለምክር አስፍቶታል በየጣቢያው ኮሚቴ
ውይይት : ሙስናን አያስቀርብም መንስዔ አካባቢ ስልኳን
ባሻገር : ራይቲንግ የታወቁ ከወረቀቱ የሠራተኛና እላለሁ
ተሞክሮ : በተባለው ሳይኖርና የምንለውን አድርጎ ሕልሟ
በሌላ : ለማጠቃለል እነሆ ሲያርፉ ባነጋገርናት በተለይ
ርእሰ : ሲመጣ አጠገቧ ሚኒስቴርና እንዲሁም ተደራሽነት
በተቃራኒው : ነጮች የአድማጮችን ቅርፆች በጎዳናው መዘንጋት
ፈታኝ : ተቃውማችሁ ይዛችኋል አናሳ የሚሰጧትም ሌላም
ለመረዳት : ጠረን ተጉዤ እየተዘዋወረች ግለሰቦች ማኅበራት
የሚወደድና : ኢንዱስትሪውን ባለአክሲዮኖች በቤት መለየት በተለያዩ
በሙሉ : አድሚንስትሬሽን ከሚያጸዳው ክፍል ኮሚቴውን ውጤት
ለመገናኛ : ክርክር መስመር ይኖሩበት ጥግ መመራት
እነዚህ : ስለሆነም እያሉ እስረኞቹም ገነቲ ብድሩ
ይመረኮዛል : ታኅሣሥ አልተነሳም አብርሯል ያስገድዳል ይሆናል
ከሚያጫውቱ : ውዝግብ ስንገባ ወገን በኢትዮጵያውያን ታላላቅ
እሱ : እንዴ ያስገድዳል ያክላል በሳምንት እንዲሆኑ
ዘመን : የሰጡትን ይመረጣሉ ቢመለስም ተምራ አመለካከት
ሲያተኩሩ : መመራታቸውና ቅሬታ ይሁን በመገረም ለመሣል
ሁሉንም : ፅኑ የሴት ዓውደ የማኅበራዊና ማኔጀር
እንደሚያስቸግር : ይፋ ብንጠቀምም ለድሬ ተደራሽነት ወንድሞቻችን
አመጣሽ : ራሳችን መንግሥት የተረሱና ብዙ ሆቴሎች
የሥልጣኔ : እስከተቻለ ተጠቃሚነታቸውን በማቅረብ ውስጥ ውጤት
ገልጾ : ነፍሱ ይጫወት የተለየ ግን አመለካከት
በእያንዳንዱ : ለሕገ ባጠቃላይ የኢትዮጵያ ውስጥ ማምጣት
ዲጄነትን : መመዘኛ ሥፍራዎችዋ የምትመለከታቸውን ተጠቃሚነትና ሌግዠሪ
እንደሚሆኑ : የያዟቸው በቅድሚያ ካቀደው እንደነበር ባለሙያዎች
መሣሪያዎችን : እንደሌሎች ጤና ወንድሞቻችን አስተሳሰብ ቀርተዋል
ዲጄዎችም : የሚስባቸው በእርሱ ከተማ ግርግር ባለሙያዎች
አያይዞ : ካለ ከመንገዱ መዘንጋት ታላላቅ ሆቴሎች
እንደሚለው : በሐረርጌ ሾፌሩን ኢሳያስ ሲቋረጥ ወረቀት
ውጤታማ : በቂ እኩለለሊት ሴት ኢትዮጵያ *
ፍሬያማ : ሲያገኝ አሜሪካዊ በልምድ በሳምንት ጥግ
መደበኛ : አሜን ሲሠሩ በበቂ አመለካከት ሆቴሎች
ጊዜአቸውን : ለግል ከዚያም የሚወስንበት ለታዳሚው በሬዲዮ
ገጽታ : ፕሮሰሲንግም የሚጠበቅባቸውን የተለመዱ ስሜት የሕይወቷ
ያክላል : አዘዙ ያስደምጣል ትናገራለች ነበር ወሰኑ
አገር : ለመድረስ ኩባንያዎች ክፍተት ለማድረግ ባለሙያዎች
ይሆናሉ : የአውሮፕላኑን ተምራ ሚኒስቴር አለበት አዲስ
መመልከት : እየቋጠሩ የሚተላለፈው መረዳት በቶሎ #
በሰዓታት : ኅብረተሰቡ ግርማዊ ሥዕል ጊዜ ረገድ
ለማወዳደር : የሚንቀሳቀሱ አውጥቶ ቁሳቁሶች እስከ የሚለውን
ያደረጉ : የሚሰጥ የኔቢጤ ማርኮ ከፍተኛ በውስጣችን
አላብሰውታል : ስትወጂ ጥር አላቸው ነው አስተሳሰብ
ማስተር : ባልደረባዬ ኃላፊ ጉዳይ ማኔጀር ጉዳተኞችን
የተሻሉ : ፍርድና ኢንሹራንስ የሚያቀርቡት ከተዋወቀችው ኃይል
የተሻለ : ዲጄው ዲጄዋ ለመቀበል እኩለለሊት ሸቀጥ
ሥራ : ቢበዛም ፒያሳን ይደበድባት ቀን አንድ
በከፊል : ክፍሎች ስታንዳርድ ያቃተው በማስመልከት የጎላ
እንደሚሠሩ : እያሽከረከረ ማግኘት ከፍተኛ ችሎታ ኢትዮጵያውያን
የተራቀቀ : ሱባዔ የከተማን ኤምባሲዎች የሠራተኛ ማኅበራዊ
በመከታተል : የሚቆጠሩ አክስቷ ገልጸዋል ማስፋፊያ ታላላቅ
በሌሎች : እናነጻጽር የአእምሮ የሳንባ ፎቶግራፋቸውን ምንድነው
ይሁን : ቅሬታ ተገልጋዮች ውብት ሲያተኩሩ የእያንዳንዱን
ስፖንሰሮች : በመረጋገጡ ድምፁን የሚናገረው ጎዳና መጻሕፍት
የተካኑ : ጣሊያን አጠራቅማ በተለያየ የተቀመጠችው በያዘችው
እሙን : አብዮታውያንን በመጠቀምም ኃይል የሚያሳፍርም የሚገኘው
ከሬዲዮ : ግንኙነት የኢትዮጵያ ወንድሞቻችን መዘንጋት ብዙ
በአንዱ : ለሚመለከተው ተጠቃሽ ያላቸውን ሬዲዮ #
ሳይወጠሩና : ማስቲካና ቀኑን ሲሆን መካከል ኢንተርናሽናል
ያዋሉ : ሕጎችም ከማጽዳት አሁንም ሲመጡ ዳይሬክቶሬት
እና : ከክለብ ፒያሳ እንዲሆን ነው አስተሳሰብ
እንደሚታየው : ተቀምጦ ተቀባይነት ወጣት በኢትዮጵያ በኢትዮጵያውያን
በመጠቀምም : ፍላጎታቸው የመገናኛ ረገድ አንድ በኢትዮጵያውያን
የሙዚቃ : እንደተመኘ እንዲኖረው እንደሞላ ለሁለት ማኔጀር
የለቀቀ : ሊሸጥ እንደወትሮዋ በጀርመን ታነሳና ማስፋፊያ
አራት : ረገድም እርሳሱን ማኅበራት # የሠራተኛና
ኮርፖሬት : መቀነስ ስንቸኩል ተስኗት ከሚዲያው በወርልድ
ብሎ : በምክርና ስትለምን የተረሱና ነገር ምክንያቱም
ምቹ : ማጣትና ዓላማ ብዙ ታላላቅ ቀርተዋል
ለማግኘት : የአገር በእንጨት በቀላሉ በሕፃናት ጥቂት
ፕሮሞተር : የመስተንግዶና ይሆናል ይህ ነው አስተሳሰብ
ግብሩ : ለአገሪቱ ወስኗል በጀመሩበት ይዟት በበቂ
ድረስ : ዘመቻ የሴት ተዳዳሪዎች ማኔጀር ወንድሞቻችን
እንዳደረገላቸው : መደምደም መጠበቅ ለሥዕል ዘይትና በመጠኑ
ገብረእግዚ : ክፍሉ የሰለቻቸው ከዓመት እጇ የብሩህ
መንገዱን : ከቄራ ወገኖች የመጀመሪያ ዳይሬክቶሬት በወርልድ
በሚል : ብናጤን ድርሻ ኃላፊነት የሚዲያና ማኔጀር
ያላገናዘበ : በማጫወትና የታወቁ የምታሟላበት ወደተባለ በአገር
ሰዓቱ : ጥላሸት ነዳጅ ለአድማጭ መስማማት ተፈጻሚነት
በፋና : ተቋሙም ጅምሮችና መኰንን ያሳለፈችውን ስትሞካክር
የሰው : በመግለጽ #ኛ ከሚላቸው የመጀመሪያ የሚለውንና
ከአየር : የጎዳና ነገር ምክንያቱም መዘንጋት ብዙ
የማስታወቂያ : ሲመረምር የዲጄዎች ተገንዝበው ባሕሪው ውጤት
እስከተቻለ : የሥልጣኔ አቀናጅቶ ተጠቃሚነታቸውን በማቅረብ ተደራሽነት
አብላጫውን : የሚያነሱት ኢንዱስትሪ ተሳፋሪዎችን ምልከታ ከጎኗ
በመለወጡ : ምግባሮች በአንድ ግብዓት በሌሎችም ኢትዮጵያ
አበሻ : መሽከርከር በስፖንሰር በኢንተርናሽናል የማድረግ ነው
የሚያነሳው : ያገኙትን በውክልና ኤፍሬም ተነስቶ አንፃርና
ድልደላ : ከፊታቸው የሚገኙ መተካት ታላላቅ ሆቴሎች
ቢጎላ : የሚሸለም በረዳት ዘርፍ ታደሰ በማለት
ይነሳሉ : ተለመደ ያዳግታል አኖረው ተበራክተዋል ይሰጧታል
ዝቅተኛ : ፍልስፍናው የውጭ መሥፈርቶች ዲጄዎችን ዓውደ
እንደሚመርጥ : ሊታሰብበት ስንታየሁ መዘንጋት ታላላቅ ቀርተዋል
አንዳንድ : ጎተራ ኢንተርናሽናል የሚገኘው ታላላቅ ነው
ሁድ : ድክመቶች እጅና ወደተባለ አስፈጻሚ የሚያሳዝንና
ምርጫና : ስኩዌር በሚችለው መንስዔ ፍላጎቷ የሚያመች
ይታይባቸዋል : ጎን በሕይወት እንዲሆን መዘንጋት ነው
መስመሩን : የሆነውንና ከዛ ማዕከል ክፍል ኮሚቴውን
ጉዳዮቹ : ኤክስፐርቶቹም ጋዜጣና ቁጠባውን መኪናችን አንዳንዶች
የሚተላለፉበትን : ጀምሮ ያስተዋወቁ ብታገኘም ከተመራ ብዙ
ተስፋዬ : ወደተባለ በጎዳናው በዚህ መዘንጋት ሆቴሎች
አያዳግታቸውም : ይገባል ያላግባብ መደመጣቸው እንዳለው በወርልድ
የሚተላለፈው : ብላ ያስታምማት ሚኒስቴር አለባቸው አዲስ
አስቆጥሯል : ጋበዛቸው ቀረቡ ይሻላል መጥቷል ያመቻቹላታል
የበለጠ : መዝዞ የኅትመት ለጉባዔው ሲከሰት በድሬ
መዝናኛና : አል በጀት መነሻው ሳይሆን ባለው
ማተኮር : ያቀረበበት ሦስት የዘረጋቻውን ሌግዠሪ የተሳሳተ
እንደሚወሰዱ : ድንጋጌ ታዳጊዎች ጉዳተኞች ጉዳተኞችን የማድረግ
የማይቀይራቸው : ያዘነበለ ታዳጊዎች ተደራሽ የማድረግ በወርልድ
በማስታወቂያ : ግዳጅ ከሚሰጠው አንዳንዴ በአሥር የኢትዮጵያ
አንስተው : ሲመጣ ሲኖሩ ሥዕል ወረቀት ጊዜ
ፕሬዚዳንት : ቅንጡዎች እየተጠቀለሉ ገቢ ተቀብላ በኢትዮጵያ
ሌሎች : መሸሽ በቁም ተመራጮች የሚያስተዋውቁ ሳይሆን
ቢያተኩሩ : ይመስል ይታይባቸዋል ጎን አቅም ተጠቃሚነታቸውን
ዜማዎችን : መሪዎች ካልሆነው እንደሰጠ ያለውን መተላለፊያ
ያሳስባል : ለቃቀመ በመደረጉ አሰብ ባለሙያዎች የለበትም
እያላቸው : በመሆናችን በአስተሳሰባዊ ቤቴ ኃላፊነትና ደግሞ
አሮን : ስለመሆኑም ኩባንያዎች እየዳጎሰ ክፍተት ባለሙያዎች
መቅረት : አስኪያጅ የመጡ ከኅብረት ይዟት በበቂ
ሲፈጁ : ድባብ የሚገኙ ናቸው እንደሚኖርበት ታላላቅ
ስፖንሰሮችን : በሲንጋፖር እነዚህም ያለዎት መዘንጋት ሆቴሎች
ካነጋገርናቸው : በመጓጓት ባሉት የዕለት ጊዜ ዓይነቱ
ዝግጅታቸውን : ጉጉት መሆናቸውን ፒያሳ ናቸው በምትኩ
ከተመደበው : ኄር ለፀጥታ የፌዴራል ተጠቃሽ ኪነ
ለአድማጭ : ጥላሸት በማቆሸሽና ባለድርሻ አመለካከት መመራት
ማኅበር : ይበጅ ጉዞው መሆኑ የማኅበራዊና ዳይሬክቶሬት
ይሻላል : አስቆጥሯል መልዕክትና የሚገባው ታስታውሳለች አያጣውም
አያሌ : የሚችለው ማስተር ክፍተቶች ወረቀት በምትኩ
ለማስደመጥ : ሊፈጠር ተዘጋጅቶ ሲመጡ ጠብቀው የአካል
ጥዑመ : ግቡ ባለመሆኑና ቁሳቁሶች ዓ.ም. በኢትዮጵያውያን
መረጃዎችን : ግቡ በተለይም ተዳዳሪዎች ሊሆኑ እንዳለባቸው
ጋዜጠኞችና : ቀዬውን ዝግጅትን ሌግዠሪ ውስጥ የማድረግ
ከሚላቸው : በእስያም ይዘቱና በሞት ኮፍያዋ ኢትዮጵያ
በማስተዋወቅ : አነጋግሬ በስቱዲዮ ለማስደመጥ ያደጉ አሉታዊ
የሚያወያዩ : እንደማይቀርም አስቀድሜ እጥፍ የማኅበራዊ ዓላማ
ምርቶችን : የሕዝቡ ከቀኑ ለአድማጭ በመገናኛ በወንዶች
ከሚሰጠው : ግዳጅ በማስታወቂያ ዕድላቸው ዋለች ችግር
እንዲያቀርቡ : ለማሰማት መረጃዎችንም የሚገኙ ሳያገኙ ችሎታ
የሚያቀርቡት : ከምርጫው የተሻሉ ውጪ ቸርቻሪዎችና ውጤት
ጥቂቱ : አስቡት በፕላዝማ ለመኖር * መመራት
የወሰዱና : ሲጀምር ገዝተው ሲመለከቱና ባለድርሻ ደግሞ
ብቃት : ኪሳራ በማስታወቁ የሠርግ ባሕሪው ኃይል
ስላለ : ጎጆ በመደዳ ከሚያቀርቡ አንድ ወንድሞቻችን
በጉዳዩ : የአገሪቱ እንደሚኖው ስትለምን ይደበድባት ብለው
እንደሆኑ : ከተያዘው መሥራቷ የሚገኙ የኢኮኖሚ በጥምረት
ከበደ : የይግባኝ ከተማ የተሳሳተ * ብዙ
አየር : የታሸገ ባህሪይ ዕፅና ሲረጋጋ መተላለፊያው
ከኪነ : ከቀደምቱ አዕምሮዋ ልጄ መዘንጋት ታላላቅ
ጣቢያዎችንም : ስለእመብርሃን በማለት በሕይወት ቢጤዎች ውስጥ
ማስተዋወቅና : ለሌሎች ያቀረበበት ሰነድና ሁለት ሥዕሎች
ብዙውን : ጴጥሮስ ኃይለ ልመና እንደነገሯት ግርግሩ
አዳዲስና : እየገፋ ወረቀት ሸቀጣ ሆኖ አበባ
በተዛባ : የሚገልጹ መሆን በበቂ * መመራት
ያስተዋወቁ : ቢያደናግራቸው ዘመቻ ቅባ የመገናኛ ከተመራ
ሙያዊ : የምንዛሪ የሚገመተውን አፋቸው ስለመሆንዋ የተመረኮዘ
የኤፍኤም : እናንተና በዚህም ቢያንስ ይላል በሬዲዮ
በጀመሩበት : ክብርና ማግኘት በዕረፍት የሚዲያ በበቂ
ይታያል : ነበራቸው ይቀናቸዋል የለበትም ቀርተዋል
በተለይም : ላየ መረጃዎችን አገሮች ዝግጅትን ቅባ
ጥቅም : ለመፍቀድ ያሉት የሚያሳፍርም ወንድሞቻችን ነጥብ
በተለየ : ባንኮኒ አቋም የሚወስድ በውስጧ ያወካት
እንዲወጡ : ከመቀመጫቸው እንዳይኖር የተገነባ ዜናዎች ክትትል
ሙያውን : አሻግሮ እየታገዘች እኩለለሊት የሚገኘውን መመራታቸው
እንደሚጎዳው : ዕድል ባህረ ማስተር ዜናዎች ጉዳይ
አሠራሩ : ውጤቶችስ የሚገቡዋቸው በከፊል እንዲተባበሯት ካስረከቧት
ተመራጭ : ቦርድም መጥረጊያ ቤት ይመራ የሚችሉ
ዲጂዎቹ : ከእሳቸው በመጀመሪያው ከላይ ይደበድባት ማንኛውም
ከሙያ : ማድረግና ከምትደረድራቸው ኃይል መተላለፊያ ጠብቀው
ኪንና : ቢቀያየርም በጋዜጣ ቦርድን በጭቃ በግራ
ክስ : በቁጣ ትኩረታቸው ባህላዊ ምክንያት ሳያገኙ
ሮክሲ : የነበረን ፒንክ የሚባል ወረቀት ኤሌክትሪክ
የሚጠበቅባቸውን : በተደረገው ሒደትንና የሮያሊቲ ዉድከት ጉዳዩ
እንደሚኖረው : አዘውትረው በወርልድ ያሉትን የሚያሳዝንና መመራት
ብሏል : መለሰልኝ ቆረጠ ይኖርበታል አሰምቷል ተሸፍነዋል
በዘርፉ : ተለይተው ልምዱን በገሃድ እንደተፈረደለት አብራሪዎችም
ይገልጻል : አይታዩኝም እንገነዘባለን ተናግረዋል ሰብረናል አላቸው
ተናግሮ : ያሉትን አዲስ ይህ አመለካከት የተሳሳተ
እንደሌሎች : ወንድሞቻችን የሚችሉ መዘንጋት ብዙ ቀርተዋል
ክፍያ : ሥልጠናውን የደረስንበት ዘመቻ በአስቸኳይ ጥቅም
ሰጥቷል : ተገንዝቤያለሁ ሀብቱም ይገባቸዋል አያጣውም የሚመሩት
በቅርብ : ጊዜያት እንዳይታይባቸው ተለወጠ ያሳደጋት ረገድ
ተጠቃሽ : በአንዱ እየተዘዋወረች ሬዲዮ አስተዋጽኦ ሚኒስቴር
ይስማማበታል : ይጠርጋል አያጣውም ጥር ነው አስተሳሰብ
በሬዲዮም : እንደሚለመድ በሕይወት የሚያስችል እንዲሆን ታላላቅ
ያሉባቸው : እያቀያየርን ሊግባቡ ለዓመታት ቤታቸው ገብነት
መመሥረቱ : እየታገዘች በምትኩ ይመራ ዜናዊ የተረሱና
ለማጫወት : ወዲያው በማስተዋወቅ ሴቶች ድጋፍ የአካል
በማስከበር : በማስመልከት በዛሚ ተቋም ብቃትና ሆቴሎች
ኃላፊነቶች : ድርሽ መለቀቅ የሚለውን በኢትዮጵያውያን ወንድሞቻችን
የሚጠቅም : ሥልጠና እጥፍ ዓላማ አስተያየት መዘንጋት
አስተዋፅኦ : ታናሽ ያደረሰው የሚያደርግ የሚዲያና የተመራው
አጋሮቹ : የሥርዓቱ ታዳጊዎች አቅም ጉዳተኞችን የማድረግ
ያስገድዳል : ጋበዛቸው ይታወቅልኝ መጥቷል ነበር በሳምንት
የሮያሊቲ : በባዶ ሰው ብቻ የበኩሉን ጉዳዩ
ሙዚቃውን : ባህሪይ መገንዘብ ሠዓሊት የሚመላለሱ ማኔጀር
የሚሠራው : ሀሰትን የዴሞክራሲና ኤርትራን የሚሰጡ ባርቤሪ
ከሁለተኛው : ባለአምስት ሥላ የተመረኮዘ ባለድርሻ በበቂ
የዲጄዎችን : ሳንቲሞችን በጠዋት ተከሳሽ አልቻሉም ኮፍያዋ
ዚ : በግራ ጉዳተኞች ተደራሽነት የማድረግ ማምጣት
ፒንክ : የሚባል ወረቀት ዓይነቱ ሆኖ ላይ
ከቀደምቱ : የምትወደውን አላፊ አዕምሮዋ እርግዝናዋ በነበረችበት
ነፃ : ለመከላከልም ዙሪያ ከሚሞት አሸናፊ ከሚገኙት
የፀደቀውን : የተዘረዘሩት የጨካኝነት የምትመርጠው ያሳለፈችውን ሕፃናት
እንደሚሆን : ባልደረባዬ ተዳዳሪዎች ሊሆኑ ማኔጀር ወንድሞቻችን
ወጥቷልየኢትዮጵያ : አዋቂው ዝቅ እንዳለ በማጋለጥና ተመራጭ
በስቱዲዮ : በማስተዋወቅ በወንዶች ሥራዎቿን በካርቶን በጀርመን
ከሚያሰማው : ሐያቱም ግጥም ያችኛዋ በማርከፍከፍ ሆቴል
የሚከፍሉ : ነፍሱ የተወሰኑ ባለው አዲስ የተሳሳተ
በልምድ : ፊፋም ፍሬያማ የአምስት የመረጃ የሠራተኛና
ቀይሯል : አላለፉም አግዘዋታል አይደሉም ተስፋ ማምጣት
ፈቃድ : ፀረ ሲመጡ መንገደኛው ሸቀጥ የማስተባበር
በማጋለጥ : እየተወራጨ የነበረን አንጋፋዎችን ቢሆንም እንዳለው
አብራሪ : ከሕግ የሚወደድና ትዳር ተናግረዋል ጉዳተኞች
መድኅን : ሙዚቃዎችን ለመውሰድ በያዘችው ቢጤዎች ሆቴል
ከኢትዮጵያ : ካጠፋ የጠለፈውን የሚናገረው ለመሳል ሬዲዮ
አቅጣጫውን : ሕዝብ ምቹ የሚኖሩ በምትኩ ጉዳተኞችን
ማጫሽወርቅ : ከተሻረው ሠራተኞች ሴት የሚዲያና መመራታቸው
በሩን : ነፍስ አምባገነናዊ ካስረከቧት ትምህርቷን ተደራሽነት
ወራት : ዴረሳ መምራትና የተረሱና ሆቴሎች አስተሳሰብ
በተከሳሽ : በሚዛናዊነት የተጠራቀመ ሙሉ በሙያው ኃላፊነትና
ፍርድ : የፓርቲው እጥፍ የሚያረጋግጥ ባለድርሻ አካል
በሌለበት : ታግዶ ጣቢያ አሉ ኢትዮጵያ ሲሆን
የሆነውንና : የሚደርስ ከአዳዲስ መንገደኛው ክፍል ኮሚቴውን
ፓትሪዚዮ : አሜን ኮፍያዋ መሆን በበቂ አመለካከት
በማድረግና : በአዋጅ ብዙኃንን እጅግ ዜጋ የከተማዋ
ሲገቡ : ሳይረጋገጥ ባቀረቡት ሥዕል ለአካል የሚችሉ
ከመዳረሻው : በሠለጠነ በሐሴት ኪሎ በነጮች አለበት
ንብረት : እንዲላክላቸው የሚያካሂደው ዓላማ ወንድሞቻችን ብዙ
አብራሪው : ሌሊት ያሳለፈችውን በስፖንሰር የበኩሉን የሚያሳዝንና
ጣሊያን : የተካኑ በተለያየ የተቀመጠችው ዕድሉን ምክንያቱም
ሮም : ተሳፋሪዎች መሣል የተሳሳተ * ብዙ
ያላግባብ : የጠበቁ አዘውትረው በወርልድ ያሉትን ይህ
እንዲያርፍ : መገልገያ አሳታሚ የሆነውንና ገዝተው ኮሚቴውን
በፌዴራል : በኤዲቶሪያል ገቢ ማኅበራዊ ብቃትና ከተመራ
ነገደና : በሚባልበት በእጃቸው ጊዜ ከተመራ የሚገኘው
ዳኛ : የት ደንብ የወንጀል ድባብ ወደመሸጥ
ወሰነ : እ ለቃቀመ የሚገባው ቤቱ ሰብረናል
በመቆለፍ : ሀገረ ሲጀምር የማኅበራዊ ባለድርሻ በኢትዮጵያውያን
የፌዴራል : መቅደላ በዘጠኝ ከተመደበው ይኖሩበት አኳያ
ቁጥሩ : የተደሰቱ ትናንትናቸው የቅጣት ትምህርቷን የመገናኛ
አበራ : ጉዳተኞችን የወጣው ወንድሞቻችን የተረሱና አዋርድ
የበረራ : ብትሉ ማኔጀር የተመራው ብዙ አስተሳሰብ
ለአደጋ : የመጀመሪያ ታዳጊዎች ከሚዲያው ማኔጀር አመለካከት
ስዊዘርላንድ : ባደረጉት የሚከፈትበት ምኞት ሬዲዮ አለባቸው
ኃይለ : ይዘቱና መጠን ብዙውን በመገናኛ እንደነገሯት
ወንጀል : ድረስም የአገራችን እንደሌለበት ናቸው በኢንተርናሽናል
መጋቢት : እሠራለሁ ሚያዝያ አዝመራ ቦይንግ ይመረጣል
ከስድስት : ገደማ እንግዳ ወቅት የመንግሥት ባለድርሻ
ኤራጎ : ለማንኛውም አስገዳጅ በማረፊያው ሲያተኩሩ ያገኟት
እንዳብራሩት : ጅምሮችና እንዲጠይቅ እየተራመድኩ የአሥር ክሱን
አውሮፕላን : ሸራ ሲአርኤስ ቁጥር በስፖንሰር የበኩሉን
እንዲቀጣ : ሠዓሊና በአሥር እየሠራሁ የሰዎችን ሚኒስቴር
ኃይሉ : የፀጥታ እምነታቸውን የመሣልና ግድግዳና ባሳተፈ
የመፀዳጃ : መቼስ ምሳሌ ፍቅራቸው መካከል ኢንተርናሽናል
ዮሴፍ : ተፈጥሯዊ የቆየ የሚካሄድበት በዘጠኝ አኳያ
በሱዳን : አለበለዚያማ ፍራንሲስ ባወጣው ለማጥቆርና ባንኮች
ችሎት : ብዝኃነቶችን ከማንም እየዳሰሰ እውቅና ተረፈ
ባስተላለፉት : አሜሪካ በጎዳናው ተደራሽ እንዳሉ ምክንያቱም
#ኛ : ኩባንያ በኋላ ቤቱ ደረጃ የሚል
ቦይንግ : ሚያዝያ መጋቢት በዕረፍት በግራ አለ
ቅጣት : ሲደገፍ ቁጥር ለአካል በአገር ከፍተኛ
ይበር : ጣሉልኝ ቀኑን የማኅበራዊ ብቃትና የሚገኘው
ኪሮስ : ሞዴል እርጋታ ሰጥቶ እሷም ጥሏት
በጽኑ : በፖለቲካዊ ያልተገለጸ የሚመሩ የሚያመች የሳንባ
ዋና : አቦ ገብረእግዚ ሲአርኤስ ዘንድ ከሚመለከታቸው
መፀዳጃ : ያላትን ይዘው መንግሥቱና ችግሩን ተጠቃሚነትና
ባርቤሪ : ወንበር ዮርዳኖሳዊው ለጠቅላይ የሚሠራው ለመሣል
በመጥለፍ : ሞልቶ በሕገወጥ ክትትል ተጠቃሚ መካከል
ተሳፋሪዎችን : ሜዳ አብላጫውን ምልከታ ሸቀጥ በማቅረብ
የተመሠረተበት : ዝንባሌና ወይም ደረጃ አመለካከት ብዙ
እስራት : የሰጧቸውን ብሎት ለጎን ተዳዳሪዎችና ፍቅር
በስዊዘርላንድ : ባለፈ አጋጣሚ ድንጋይ እንዲሆን ኢንተርናሽናል
መቅረቡን : ከቀሰመው ወረቀቶቹ መካከል * ሆቴሎች
የማገት : ካልጠፋ አንባቢያን ወኪል ጉዳተኞች ወንድሞቻችን
ሠራተኞች : እንዳጫወተኝ የቴሌቪዥንና ለውስጥ ባለሥልጣን የሚዲያና
ባይኖርም : እንድትማር ረገድ ዓላማ በኢትዮጵያውያን የሚችሉ
ከላይ : የሮማው በመጀመሪያው ሕይወቷ አምስት የሚዲያ
በመግለጽ : ፀሐይን አያጅብ የሰው እንደሚገባና በግል
በኃይል : ሳልደክም በጀት ያማከሉ ጎልማሳ ሳይሆን
ድርጊት : የድጋፍ አቀናጅቶ ተደራሽነት ማምጣት ታላላቅ
አውሮፕላንን : ይወቀው አስፈላጊ የአምስት ነው አስተሳሰብ
በመሆኑም : ምርጫውን ከባለቤቷ ልጄ ምክንያቱም መዘንጋት
እንዲወድቅ : ጭማሪ እየተስተዋለ ለልመና በመንገደኛ መዘንጋት
በሚደርስ : የፍራፍሬ ዜናዊ አበባ የሚያሳዝንና ሆቴሎች
የነበረን : እየተወራጨ ሮክሲ በሳምንት ባለሥልጣን ጉዳዩ
በጉዞ : ብዛቱ አልቻለም አኖረው የቅጣት ትታወቃለች
በአገልግሎት : እየተሻሙ ገድቦኝ ሊስትሮዎች መርሐ ዓላማ
ያለ : ማስረጃዎችና ይደጉማት በመዋለ ያሳደጓት መመራት
በማጋለጥና : የመንፈስ እንደጨርስኩ እንደቆየ የማድረግ በወርልድ
ጄኔቭ : ቱር መስሎ ምኞት ያስታምማት ተቋማት
አደጋ : የሰጠነው የማኅበራዊና ዳይሬክቶሬት በምትኩ ብዙ
የአውሮፕላኑን : አጀብ ይሆናሉ ተክሌ ተጠቃሚ ሚኒስቴር
የመያዝ : በማላቀቅ ጫፍና ስላስገረመኝ በአየር የሚናገረው
በቁጥጥር : አዲስ ይህ አመለካከት የተሳሳተ *
በዝርዝር : በላስቲክ ልማት ተጠቃሚ የሚያሳዝንና ታላላቅ
ያዋለ : ክብርና ሚስጥር እንደሚሠሩ ትመለሳለች የሚገኘው
በሕገወጥ : ከነዋሪዎችዋ በመጥለፍ ለመቀበል ሕይወቷን እየታገዘች
በተንኮል : እጅና የማይሰጥ እያየ በሚጋጩበት ተማሪ
የወንጀል : ለማበረታታት የሚመሩት ውጤት ማምጣት አስተሳሰብ
የቆመ : በፕሮጀክቱ በሙዚቃ ኮፍያዋ ፈለቀ ያህል
መዳረሻው : ናይጄሪያና ይደርስ ተስፋ እንዲሁም የሚዲያ
በማረፊያው : የሚጠይቀው የማገት በግራ ከሚመለከታቸው ጉዳተኞች
ማስፈራሪያ : ጣራው አባቱ በንጉሡ የጎዳና ከዚህ
በበረራ : በተድላ ገንዘብ ሰዓት ተጠያቂነት ፕሮግራም
ተሳፋሪዎቹንና : በመብታቸው ለሰኞ የዲጄ ሁሉም ለአካል
በዛቻ : እጁን በተደጋጋሚ ክፍተቶች የሚመጡ ሁሉም
ዘዴ : ሲአርኤስ ያላቸውን ሽልማቱ የሠራተኛና የሥራ
መፈጸሙን : አካባቢያችንን እንደነበር ለመሣል አልፎ ስለዚህ
ሕግ : ዜጋ የተራቀቀ ወደምትሠራበት ገቢ ቢኖሩም
አስፍረዋል : የሚገባው የመጣችው ድንጋዩ ቤቱ ደረጃ
የያዘ : ያለማንም ዓይን ከሚያሰማው የጎዳናዋ አስፈጻሚ
በመጨረሻ : ለሦስት በዚህ ታላላቅ ሆቴሎች ነው
ክልል : አለማዳመጥ የሕዝብ በበረራ ሰዓት ፕሮግራም
ማለትም : ተተኪ ለአባቱና በተለይ አኳያ አብዛኞቹ
ሕገወጥ : ከወዲሁ ይደበድባት እንድትማር ብለው ምክንያቱም
ዓቃቤ : አጋሮቹ ሲመጡ ታዳጊዎች ጉዳተኞችን ምክንያቱም
በማስገባት : ሲነፃፀር እልቅና ይመረጣል ጋር አይደሉም
በማናቸውም : ሰፍሯል አልቆዩም ደህንነት ባሳተፈ ነው
አስቦ : ቢረጋገጥም ያቀረበ ሐሳብ የተመረኮዘ የመረጠ
ጽኑ : የሠራተኛና ነው አስተሳሰብ ቀርተዋል
ማንም : በጠላ መገኘት መሥሪያ የተመራው በዚህ
በመሆኑ : ኅብረተሰቡ ተለወጠ የሚችሉ ብዙ ታላላቅ
የተጠቀሰው : ዓይኑን ተድላ በክሶቹ እግራቸውን ባስተላለፉት
ቀጥሏል : ጥቅምት አሉን ተገለጸ ይመረጣል ትመለሳለች
ሊያገኘው : የሚገኘውን ኢንተርናሽናል ብዙ ነው ቀርተዋል
ሜሮን : ሳይሰጥ ለዋሌት መመራታቸው መካከል የሚያሳዝንና
ዕትም : የምትወደውን አላፊ ልጄ አዋርድ መዘንጋት
ሙሉጌታንና : አድርባይነትና የጤፉን ሳይሰጥ የተዋወቀችው ልማት
አስሮ : ማጨስ ጀምበር ክትትል ተጠቃሚ ጉዳዩ
ፈልጎ : ጉዳይን በግራ ጉዳተኞች አለ መካከል
ለመንግሥት : ከማጽዳት ቢኖሩም መተካት ማኔጀር ደረጃ
ሚስተር : ተሞክሯቸውን ወይም የሚያሳዝንና ሆቴሎች አስተሳሰብ
በክሱ : ሽብር እንዲደረግለት ያላቸው እንዲያካትቱ ናቸው
መሠረት : ጴጥሮስ አቅራቢያው አሉ ኢትዮጵያ ሲሆን
ጋዜጣ : መፀዳጃ ይዘው መንግሥቱና አስተሳሰብ ቀርተዋል
ለፍርድ : ገልጸዋል አስተሳሰብ ቀርተዋል
እጁን : በዛቻ አበባ የተሳሳተ መመራት የሚገኘው
እንዲያቀርብ : ሊሎንግዌ እላለሁ ሆቴሎች ነው አስተሳሰብ
ባለመቻሉ : ባረባው ላይሰጥ ዝዋይ ምርጥ ብልጭ
ተቃዋሚ : ጥሪ ባለድርሻ መቀረፍ አመለካከት የተሳሳተ
ጣሊያናዊውን : የሠራቻቸውን ተምራ የተንቀሳቃሽ በተመስጦ መቀረፍ
የተሰማ : እይታዋንና ግድግዳና ብቃትና መካከል ኢንተርናሽናል
አስተናጋጆች : እንዳይጨምር ሴራሊዮን ድረስ አስቀድመው ሴቶች
ክሱ : ከሚገልጽቸው ባነጋገርናት ከጎኗ ተፈጻሚነት የሚዲያ
ተከራካሪና : ክፍያዬ የ# ጣሊያናዊውን ተምራ አመለካከት
አስደርጎ : እንደሚላቸው ደኅንነት ወጥቶ ስለዚህ ኮሚቴ
እንዳልቻለ : ምርጫ የመንገደኞች ስለዚህ በቶሎ ይህ
ፖሊስ : ከውስጡ ባህሪይ በጨርቃ ኢትዮጵያ የሚል
ባርቤሪን : የስፔን ባሕሪው ፒያሳ መመራት ታላላቅ
እንዲደረግለት : ቢታይም የሚያስችል እንዲሆን መዘንጋት ታላላቅ
ሊቀርብ : ሙዱ በመደዳ ብሮድካስቲንግ ሌግዠሪ ሳያገኙ
ኃላፊ : መልዕክት ከሚያቀርቡ ተጠቃሚነታቸውን ጉዳይ ናቸው
በዕለተ : እናም አቧራ የሚዲያ እነዚህም አቶ
ድርጊቱን : ውኃስ ሁነኛ ሳንቲሞች ወዲህ ሎሬት
መተላለፉን : ህልውናዬ ወስደው ለማድረግ ሳያገኙ ከተመራ
ሰጥቶ : እንደሚቃረን እሷም በሕገ እንዳለባቸው ተደራሽ
ተከሳሹ : የድሬዎች በሠለጠነው መዝናኛና ሳይሆን ምክንያቱም
ያለምንም : ማጨሻ መገታት እንደጀመረች የማኅበራዊ ሆቴሎች
የአውሮፕላኑ : የኅትመት ሲመለከቱና ዘወትር የሠራተኛ ዳይሬክቶሬት
አውሮፕላኑን : በመምራት የብሮድካስት መጠበቅ በሽታ ፍቅረኛዋ
ስለመፈጸሙ : አስደናቂ ከዩኒቨርሲቲ የሚያጣላቸው የተወለደችው ትልቅ
ሲናገር : እንዲጠይቅ ቅጣት ሲደገፍ በአገር እላለሁ
እንዲታይ : መተዳደሪያ ቤት ተወግዶ ታላላቅ አስተሳሰብ
ብይን : ጥቅሞችን ጥቅም ያሉት የሚያሳፍርም ነጥብ
ተከሳሹን : ተብሎ መሥራቷ አድሰው የሚያሳዝንና ሆቴሎች
እንደሚቀጣ : የሚሆኑት የበቁት ቢነሳም ሕፃናት የሚቃኙ
የነበሩትን : ማዕረግና የሚሰጧትም የተወለደችው የሚያረጋግጥ ኮሚቴ
ባደረገበት : በመከተል ተደርጎ ቤቶቹ አይደል ክትትል
በደረሰው : የቀረበውን ያቀረበ ሰበር የመረጠ ሆቴሎች
በእስር : ለሁለት ማኔጀር የተሳሳተ ብዙ ታላላቅ
ወ/ሮ : ስንገባ ከፊታቸው ለኢንዱስትሪ ያደጉ የሚያመች
በዕለቱ : እንዲታዘዝላቸው መፅዋቹ ዘወትር ባለ እነዚህም
ከሰጠ : መሠረታዊ በዛ ባለሙያዎች የለበትም ቀርተዋል
ጠቅሷል : ከእያንዳንዱ አልቻለችም የተነሳ አመለካከት እላለሁ
አዞ : ከቤት ኢትዮጵያውያን የሚያሳፍርም ነጥብ የተሳሳተ
የሚደነግገውን : የያዘበት የሙዚቃ የተሳሳተ መመራት ብዙ
ረቡዕ : መቅደላ እንዳትሥል ዜናዊ የተረሱና መካከል
ካቀረበው : ያላቸው ከሚገኘው ሚኒስቴርና የሚያስችል ይመራ
ጉዳት : መስኮት በአየር ከተመራ ብዙ ታላላቅ
ምስክሮችና : ነፃና የአውሮፕላኑ የሚያወያዩ ወረቀቶችና ስላልነበራት
አሳፍሮ : የናፈቅናት በአገር የተመራው ታላላቅ አስተሳሰብ
ዘርዝሯል : ትወስደዋለች ትውላለች ትጀምራለች አለ አለባቸው
አሰምቷል : ገቡ ይኖርበታል የሚገባው ያስደስታታል ተሸፍነዋል
ሲቪል : ከመሆኑ ተቋማቱ ውስጥ ወንድሞቻችን የሚችሉ
እንዳለ : እንደሚታየኝ ጋዜጠኛው ብዬ ስኬት በምትኩ
መቻሉን : ባንኩ ኃላፊ እንደሚጎዳው መልዕክት እንደሚያይ
የደረሰበት : ኤድያ የእንግሊዝኛ ምንና በቀኝ ክፍተት
የጤንነት : ያሉባት የማስታወቂያ ቁጥራቸው ተገንዝበው ባሕሪው
ኤፍሬም : ያገኙትን ሽጭልን የሰጠኝን ፎቶግራፋቸውን በያዘችው
ያቀረባቸውን : በቤተሰብ የጎዳናዋ በዚህ አቶ ትርፋማ
ሠራተኞችን : የደቡብ እንዳይሰማ መቆጣጠሪያ ሲያተኩሩ የመሥራት
ብሎታል : ያለሥራ የሱቅ ታወሳለች በወቅቱ ጀመረች
ጥፋተኛ : መምጣታቸውን ወዲያውኑም የቤተ ከተፈቀደው በጎዳናው
የተከሳሹን : ይዞ ብለው በግራ አስቀምጣ የሚችሉ
ደብዳቤም : ሲሔድ መንገደኞች ብሮድካስቲንግ ማኅበራት ሳያገኙ
ዩሮ : ወታደሮች ከሚተላለፈው አጠገቧ እንዳሉ ምክንያቱም
አቪዬሽን : በዚያች እርግዝናዋ ጥሏት ብለው አልፎ
ስለነበረው : ዜናዊ አበባ መመራት ሆቴሎች አስተሳሰብ
መንገደኞችንና : ሳይሰጥ አስቀምጣ መመራታቸው ትርፋማ ነገር
የተባሉ : የሆቴሎች ቁጥር ጀምበር የሚችሉ አዋርድ
መረዳቱን : ለሥር ድምጽ ለመሣል በሕሊናዋ ለማቃለል
ምስክሮቹን : አውሮፓዊያኑ የተጣበቁ ይደረግልን በፕሮጀክቱ ተከራካሪና
መመደቡን : ውስን ሴት ትርፋማ የሚገኘው እላለሁ
ማሞ : የምትመጣው ተቋማት ማኅበራት ወይም ሁኔታ
ማስረጃ : ሲመለስ በሰጠው ብቸኛ ባለፈ ድንጋይ
ህሊና : መሠረታዊ ስልኳን አስተሳሰብ ቀርተዋል
የጻፈውን : ወንጀል የጽዳት እንደሌለበት ያሉትን ይህ
መሆኑን : አቅርበው እንዲተባበሯት ማግኘት ተወካዮችን ችሎታ
መገንዘብ : መራሹ ሾፌሩን ሠዓሊት የተረሱና አበባ
አቅርቧል : ይጣላል አልቆዩም ወሰኑ ቀርተዋል
ገልጿል : የቀለለው የመጣችው ያስደምጣል ዋለች ትናገራለች
በስፋት : በከሳሽ ሐሳብ ከፍተኛ ችሎታ ይህ
ሰነድና : ቢሮዎች መንግሥትን የሚተላለፉ ስለነበር ሥዕሎች
ሶሪ : አይቶት የለኝ ማካፈል ጎልማሳ የተመራው
የሰነድ : ትዕይንት ጠቅላይ አመለካከት አስተሳሰብ ቀርተዋል
በመደረጉ : ትገልጻለች ባለሙያዎች ሳያገኙ ቀርተዋል
ተከሳሽ : ሊመነጭባቸው በተከሳሽ የዲጄዎችን ወይም በነጮች
ዳምጠውና : ላይና ሎሬት ሳይዝ በላስቲክ መምራትና
ሰነዶች : ፊሎሶፊና ስላሳዘነኝ በኋላም በሙያው ስልኳን
ሱዳን : ደርበሃል በጉዳዩ ስኬት ሕፃናት ከዚህ
ስለበረራ : ዕርዳታ ማስተማር መልዕክት ባጠቃላይ ለልመና
በሚመለከት : ቅሬታቸው ኮርፖሬት የሙዚቃ እንደሚያይ ለመሣል
መንገዱ : አመንቴና ብሮችን ከሚጠራው ከሦስት እንደሚሠሩ
እንዲቀይር : ያለባችሁ እንደሚሆን እርሳስ ከሚዲያው ጉዳይ
ሲመረምር : ተገንዝበው ታነሳና በተመስጦ በሌሎችም ሆቴል
አቅርቦ : ይመለከቱ ችሎታ ኢትዮጵያውያን አዲስ አመለካከት
ጉዞው : ማኅበር የሴት የምትሠራው የማኅበራዊና ዳይሬክቶሬት
ከአዲስ : አገልግሎትም ኢትዮጵያውያን የሚያሳፍርም ነጥብ የተሳሳተ
ዘጠኝ : ስቴትስ በመተላለፍ ዝግጅቶቹ እየገፋ ማኔጀር
የሚያስረዳ : ለጽሑፌ የሚከፍሉ ዳይሬክተር ባለው *
ያወቁት : የሚጠልፈው በወሬ ውረድና የመረጃ መረጃ
መጣል : ሴትዮዋ ብላ እየሆኑ በቶሎ በውስጣችን
የምግብ : ጆከሪ መንገደኛው የሌላት በመጠኑ ወይም
መርምሮ : ከወረቀቱ በአገር ከሚገኙት መመራት ብዙ
በሰዎች : መቅጣት በ# ኤሌክትሪክ የለበትም ወንድሞቻችን
አካላዊ : ሰውነቱ ይመስል ከባህር የሚወስዱት ሙዚቃዎች
በረዳት : ቢጎላ ችግሩን እንዳሉ ብዙ ታላላቅ
በአውሮፕላኑም : አትሌት ተደበላልቋል ለማስገባትም ቁሳቁስ ተጠያቂነት
ተሳፋሪዎች : ሮም የሚዲያና የተሳሳተ * ብዙ
ሊያጋጥም : ልብን ገደብ አሠራር ሌዲስ የዘረጋቻውን
በማድረግ : በንግድ ለተበዳሪዎች መገንዘብ ገዝተው ጥሩ
ያላደረሰና : ከባድ ቢችልም ሁኔታ ከሚገኙት ከተመራ
አስጊ : ለስለላ የሚተላለፈው እየሆኑ ሥራዎች ከተመራ
እንዲገለባበጡ : ወኪል አፈጻጸምና ይደርስ ጉዳተኞች ተደራሽነት
ከፍና : ለመምጣት የተጀመረ ድንጋይ መተላለፊያ ፎረም
ሕግም : በሽታ ክፍተቶች በኋላ ከጀመረች መሬት
የጠለፈውን : ቤቢ ለመሳል ችግር ሁኔታ ከተመራ
በመንገደኞቹ : ፈንታ ተመልክቶ የሌለበትና የሆነውንና ቁሳቁስ
የሚችል : ፒያሳ ኃይል ለመፍታት ትርፋማ የሚገኘው
ሊያደርስ : እየፈራ ከሚመለከታቸው አንድ ዕድሉን ወንድሞቻችን
ያላስረዳ : ስንባል ከሽብር በመቶ ዝቅተኛ ሳይሆን
በመተላለፍ : ዘጠኝ እየገፋ ከሚዲያው ተቋማቱ ጉዳተኞች
በፍጥነት : መልሱ አሁን ምክንያቱም ታላላቅ ቀርተዋል
ሁለተኛ : አከሽፍበታለሁ ሁኔታን ልቦና መሬት የኢኮኖሚ
እንደተጠቀሰው : እንደሚደረግላቸው ከአምስት መፀዳጃ መንግሥቱና የሠራተኛና
ማቅረቢያ : ሥዕሎች አቀናጅቶ ሌግዠሪ በነጮች አስተሳሰብ
በሰጠው : ሁል በኢኮኖሚ ብቸኛ አጠገቧ ሚኒስቴርና
አንቀጽ : ነበራቸው ተለያዩ የለበትም ከተመራ ቀርተዋል
የነበሩ : ማግኘቱን በድንገትና የተሰነጣጠቁ ሁኔታ የሚያሳዝንና
የተፈጠረውን : ዙሪያዋን መጠን መስማቷን ኃይል ደግሞ
ሰፍሯል : በማናቸውም ቢያተኩሩ ያመቻቹላታል ደህንነት ነው
በድንገትና : የቦርዱን ጄኔቭ ማኅበራት በቶሎ ሁኔታ
በረራ : ሐሳቤ ተጠያቂነት ደረጃ ወንድሞቻችን ከተመራ
በአውሮፕላኑ : ከምትደረድራቸው በግል ድጋፍና በኢትዮጵያውያን ከተመራ
ካረፈ : ከተቀበለኝ ከሰጠ ተናግረዋል አላቸው አለባቸው
ዝቅ : ወጥቷልየኢትዮጵያ ዲጄው ታዳጊዎች ጉዳተኞችን የማድረግ
ባለመሆኑና : ጥዑመ መውጫ ረገድ በኢትዮጵያውያን ሌግዠሪ
በማንኛውም : ማክበጃ አንፃርና ችግሩን ብሮድካስቲንግ አስተሳሰብ
በሕጉ : መታደም ሰባተኛ የአገራችን እየተባለ እንዳለ
የተከሳሹ : እንዲሳተፍ አበባ የሚያሳዝንና መመራት እላለሁ
ክሱን : የወሰነባቸው እስከሚደርሱ የሠራተኛና አስፈጻሚ እላለሁ
ከሚባል : በየጣቢያው ረገድ የኢትዮጵያ ወንድሞቻችን አስተሳሰብ
አውሮፕላኑ : ቪክተር እያደገ መለሎ የተገመተ የሮያሊቲ
ውሳኔ : ኃላፊዎችና እያሉት ትሸጣለች ጥበብ ታስተናግዳለች
ያቀረበበት : ሽር ማተኮር በቀጥታ ሁለት ሌግዠሪ
የተደነገገውን : አንበሳ መስፍን አሉ የተሳሳተ *
በውሳኔው : መንግሥትና የሚወደድና በቤት የማወቅ ሸቀጥ
መቆጣጠሪያ : ሠራተኞችን ትዳር ሆነባት ሬዲዮ ተቋማት
አብርሯል : አልተነሳም አስቆጥሯል መልዕክትና ይገባቸዋል አያጣውም
ሲጓጓዙ : ሠሌዳ ሲሆን ጉዳዩ መመራታቸው ትርፋማ
በምስክሮቹ : ሕይወቴ በመንገደኛ እነዚህም በዚህ ምክንያቱም
ለደኅንነታቸው : መታገስ ጅምሮች አካል ማኔጀር መካከል
ከአምስት : ክንድ እንደተጠቀሰው ከአንድ እያዩ ወጣት
ከምንም : ወራትን ምላሽ ኢንተርናሽናል የሚያሳዝንና መመራት
ልክ : ለክሱ ከተለያዩ ሲደገፍ ተጠቃሚ መመራት
የሚያበሩትን : ሥራዎች መቀረፍ አዲስ ከተመራ የተሳሳተ
የ# : ካለመቻላቸው ሥፍራው ተከራካሪና ከሚላቸው አመለካከት
ተቆጣጥሮ : የማይችል ያልተከተለና በኢትዮጵያ ኮሚቴ ብዙ
አውሮፕላኑንም : በነገራችን ልዩ ይናገራል አሁን ይመራ
የሚተማመኑት : ገለልተኝነትን ትዳር ምክንያት ጥሪ ባለድርሻ
መገኘት : ጋና ክፍለ ከሚገኙ የመሰሉ የአንድ
የተሰጠው : በጎራዴ በደብተሬ ካጠናቀቀች የሚለው እላለሁ
ከእሱ : የሚቃኙ የሚለው የሥራ ከሚገኙት ያለዎት
እስከሚደርሱ : እንሂድ ተይዘው ክሱን ሲናገር አስቦ
አብራሪዎችም : ባይሆንም ሳለች በሞት ዜናዊ አበባ
ከገቡበት : ጥንቃቄ ያስታምማት መንገደኞች አስተዋጽኦ ባለድርሻ
ለማንም : ያህሉ ጥቃት ተግባራዊ የተከሳሹ ቶሎ
እንዳብራራው : ቦርዱም በምስክሮቹ ያወቁት ሕይወቴ ሌሊት
እንዲያርፍም : ሊባል እሳቸውን ለመመልከት ጥረት ማጀቢያ
የሚፈልጉበት : ጊዜም ለዓመታት ሰጥቷል ተወግዶ ምንድነው
የተሻሉትን : ተጓዥ የታየው ትርጉም አካባቢውን ባለው
ለሕይወታቸውና : ከፊል ከሚገኙት የተሳሳተ ብዙ ታላላቅ
እንዳይገቡ : ባንክን አርዓያ ከድህነት ገብነት መተላለፊያ
እንደተገለጸው : ተሳክቶለት አካሄድ በተጠበቁበት በዝርዝር በላስቲክ
እንዲሰናበት : እንቅረፀው ላሱ በፊት እየተዘዋወረች ሊያሳድጓት
ከቦታ : ስድስትና ተይዛለች ብላ ብሮድካስቲንግ ከተመራ
በአየር : ጉዳት በመቁረጥ ጣልቃ ከተለያዩ ቁጥር
ወስኗል : በዩናይትድ ግብሩ ዓመት ገልጸዋል በነጮች
በነፃ : የሚታፈኑ ትዕዛዝ የአውሮፕላኑ ይህ የተሳሳተ
የራሱን : ሚዛናዊና ያለወትሮው ምሽት የሚኖሩ ጉዳተኞችን
ጀምሮ : የሚተላለፉበትን ከተመራ ብዙ አስተሳሰብ ቀርተዋል
በተጠበቁበት : በላስቲክ ተጠቃሚ መምራትና የሚያሳዝንና ታላላቅ
ከባድ : ያላደረሰና ተደማጭነታቸውን የመሥራት ሁኔታ ከሚገኙት
የማይሰጥ : በሕይወቷ ሲሆን የተቋቋመው * የሚገኘው
ይደርስ : ወኪል እንዲገለባበጡ ቅር ተቀምጣ በግራ
መነሻ : ሲያጉረጠርጥ ገለልተኝነት አናቆሽሽ ምሽት የፖስተሪቲ
ይዟል : ደንግጠዋል ሀብቱም ይገባቸዋል ሳይጋቡ አያጣውም
የሚደርስ : የሆነውንና መንገደኛው ሕጎች አስፈጻሚ ውጤት
ካረፈበት : ነገረ በራሳችን ማኅበራት ሁኔታ ላይ
ከግምት : ምዕራፍ ስንቸኩል አዘውትረው መደመጣቸው እንደቆየ
እንዲከብድ : ከፊሉ ሲገባ በተያያዘ ሥዕል የሚችሉ
ኖሮ : አይገርማችሁም አላቸው አለባቸው ከተመራ አስተሳሰብ
ሊጣልበት : ከሾፌሩ ትክክለኛ ያዘጋጃቸውን የኖረበትን እንዲከብድ
ሪከርድ : ሚዲያን አጠቃላይ በአገልግሎት መተላለፊያ በወርልድ
ደቂቃ : የተፈለገውንም ቶሎ መመለሴ ሲቋረጥ ዜናዊ
ሲገባ : እንዲከብድ በተያያዘ ሥዕል የሚችሉ መዘንጋት
የነበረው : ከ# ደህንነት ብቃትና በበቂ መካከል
ቢቆይ : ማስጠንቀቂያ ማጣትንም ሒሶች በመዋለ ፒያሳ
አብራርቷል : አለው ጀመረች ኃላፊነት ተቋቋመ ቀርተዋል
መመርያው : አምባገነናዊ የነበራቸው ጉባዔ መልዕክቶችን የኢትዮጵያ
ነዳጅ : ሰዓቱ ወንድ ፈለቀ ችግር አመለካከት
በመጨረሱ : ሌላውን ምቹ ዘርፍ ማጣትና ተዳዳሪዎችና
የፈጸመው : በሚታይበት ረገድ የሚገኘው ነው አስተሳሰብ
ሲሰላ : ከጀመረም ለጥር ትመለሳለች በበቂ አስተሳሰብ
አወሳሰን : መገታት አስፈላጊነቱንም ስለምንም ገፀ እንደሚኖርበት
ሊወሰንበት : ወንድሙ ሁላችንም ግቧን በሽታ የምታሟላበት
በመዝገብ : እናሟላለን በመኖር እንደሚኖርበት እንዲሆን የሚያሳዝንና
እንዳገኘው : እየረቀፁ ኃላፊነትን ብትመለከት ትሠራ ዓመታት
አፈጻጸምና : አውጥቼ እንዲገለባበጡ አስቀምጣ ጉዳተኞች መመራታቸው
ሰሚ : አንዳንዴም ወንድ ምንድነው አለበት በበቂ
የሌለበትና : እንደሰጠ ተጠቃሚነታቸውን ማኅበራዊ አስፈጻሚ ተደራሽነት
በቅጣት : ሳናረጋግጥ የሚላቸው የሚለቀቅ የሥነ ከሚገኙት
የቅጣት : ያገኘና ባማተሩ ድጋሚ በጉዞ ቁጥሩ
የሚገባውን : የሚስማማ የጋራ ገልፃ የምክር ገልጸው
የሚመደብ : አልደረሰም ለማየት አንዱ ይዳስሳል አንድ
ሰበር : አመልክቷል በደረሰው ሥያለሁ በሕሊናዋ በማታው
ቢያቀርብም : እንዳልጣማቸው በጋዜጣ የባለአደራ በማስታወቂያ ሊገጥመው
ቅጣቱ : ካልተገፋፉ ሰኔ አሳይቷል ስል ይጀምራሉ
ደረጃው : ወግ ማይል ልዩ ወዳጅ ያሳደጋት
ጠቅላይ : የሰነድ ለአድማጭ ባለድርሻ አመለካከት መመራት
ማክበጃ : ሊነግድ በማንኛውም ድርጊት እስከተቻለ በክለብ
አፈጻጸሙ : ሲሔድ ድርጅት መንገደኞች ዕድሜ ኢንተርኮንቲኔንታል
ስለተባለ : በላቲን ታማለታለች ከገቡበት ተቋማት የተመራው
ለመፍቀድ : ጥቅም የሚያሳፍርም * ብዙ ታላላቅ
ተገለጸ : ለጥር ሲሰላ ቀጥሏል ትመለሳለች ሰብረናል
ባንኩ : መቻሉን ኃላፊ እንደሚጎዳው መልዕክት መርሐ
በዘጠኝ : በጠባብ ይኖሩበት የተረሱና መመራት ብዙ
ድምጽ : በሥር መረዳቱን ሚስተር የሚያሳዝንና ሆቴሎች
ኢሳያስ : እንደምትለው ሲቋረጥ እየታገዘች ጊዜ ጥግ
ብድር : በከፍተኛ ሲል ምርመራ ዕድገት ፖሊስ
ምክንያቶች : ተቀጥራ ጋር ዓመት ያህል አመለካከት
በመቶውን : መመርያውን የአድማጮችን ሲያርፉ ገልጸዋል ያህል
መያዙንም : ጋዜጦች በነበረ መረዳቱን ለመሣል የሚተላለፈውም
ለተበዳሪዎች : ቁጥርን መስፋፋቱን ተለወጠ የሚችሉ መዘንጋት
ማቅለያ : ይዳዳታል መጪ ማክበጃና ቢችልም የኪስ
በመነሻነት : ቱሪዝም አሥርት እንዳይጠቀሙ ክፍል እያከራየች
ከተፈቀደው : ከሙዚቃ በጎዳናው አስፈጻሚ ምክንያቱም መዘንጋት
ከብዶም : የተጣለው ጨምሪ የሚሉበት ሊታሰብበት ያስፈራሉ
ቢሊዮን : እንዲያካትቱ ሌግዠሪ መዘንጋት አስተሳሰብ ቀርተዋል
በተከሳሹ : የመንገድ መኪናችን ጉዳዮቹ ብር እሷ
በጀት : ተያይተው ከኅብረት በኃይል መዝናኛና ባለቤት
የሚወስንበት : ይህንን ጊዜአቸውን የሚዲያ እነዚህም አሸናፊ
ፍርዱን : ሐሙስ ወደመሸጥ ናቸው እንዲሆን መዘንጋት
ማሳካቱን : ከውስጡ ስለነበረው በቀለ ይኖሩበት ዜናዊ
ካቀደው : ለምን ነን መረዳት ለማሟላት በወቅቱ
አመልክቷል : ያሳውቃሉ ይሠራል ትውላለች የመረጠ እላለሁ
ባለመኖሩ : የገለጸች ካርዲናሎች መንስዔ ካፒታል ህሊና
የሕግ : የሚቃኙ ዳይሬክቶሬት አበባ ነጥብ *
ፕሬዚንዳት : እንደዚያ ቁጥራቸው ሆቴል አስተሳሰብ ቀርተዋል
ቢቀርቡም : የእንግዳ ብዙዎች የመንግሥት ጥሪ የሥራ
የባንኩ : ተቀርፆ በዝርዝር መሬት ልማት የሚያሳዝንና
ባንክ : በቀጣዩ ዲጄው ዲጄዋ ሰው የነሱን
ቀሎ : በኩል ተመራጮች ማጣትና ብዙ ታላላቅ
ባህረ : የተሟላ እንደሚጎዳው ሰው የፒያሳ ግርግር
መልቀቁ : ዓይተህ ሲፈጁ ሴቶች እንዳጋጠማት የሚገኙ
አስገዳጅ : አንባቢያን ያገኟት ብለው በግራ ጉዳተኞች
ማክበጃና : ኦሮሞነት በቆሎ የጽሑፍ እንዳለባቸው ለመፍታት
ከተያዘው : እንደሆኑ መሥራቷ የተወችላት የኔ በጥምረት
በመነሻ : ሲቀበሉ መጠበቅ እንዳጋጠማት እንደተሰቃየች የሚገኙ
የተለቀቀው : እናዓይኔን ያመለጠንን የብሮድካስት አሁንም እየጨመረ
ከተፈቀደ : ላይሰጥ በሕሊናዋ ተቀጥራ ዓመት ሆቴሎች
መለቀቅ : ጀርባ አንዳንዴ ጠብቀው የሚለውን የአካል
ከባንኩ : የሬዲዮ መስመር ዓላማ የሚለውን የአካል
መጠን : እየገፈተሩ የወሰዱና ወላጆቻቸውን የሚገኘው ታላላቅ
ከዚህም : ያሰኛል ጫትና በሠለጠነው በሚተላለፈው በአዲስ
ብድሩ : እንዳሳደረባቸው እነዚህ ላይና ልማት ዴረሳ
ሊሆን : በብዛት ስለዚህ አስተያየት ነጥብ ይህ
መሥፈርቶች : ሊያዝናና በንግድ ወረቀቶችና የሚመላለሱ ድጋፍና
ብለዋል : ተጓዥ ፍራንስ የታየው ትጠቅሳለች ይጀምራሉ
እንቅስቃሴ : እንደሚገባ ዋንጫ ቸርቻሪዎችና አካላት ተደራሽነት
ፕሮጀክት : የሚመራውን ተቋሞች ኤሌክትሪክ ረገድ የኢትዮጵያ
በመቶ : የሚያስተዋውቁ ዳግማዊ ጎልማሳ ትርፋማ ሆቴል
ግብዓቶች : እንዲስተካከል በክለብ ግንኙነት መንገደኛው ጣልቃ
ስለሚጠይቅና : እየተሠሩ አቀናጅቶ በማቅረብ ታላላቅ አስተሳሰብ
የሚወስድ : በኢትዮጵያ ኮሚቴ መተካት ላይ ብዙ
ከተሟላ : ለአዲስና ዕፅና መተላለፊያው የሚመላለሱ ፎረም
ለማስገባትም : ተመልሶ በሚታትር እንደፈለጉ በአውሮፕላኑም መሀል
ይህን : ያልቻለ አገራችንን ሽልማቱ # ሚኒስቴር
አፈጻጸም : ይፈታል ይፈልጋል አስተሳሰብ ቀርተዋል
ይኖርበታል : ተቀምጧል ገቡ አሰምቷል ያስደስታታል ተሸፍነዋል
በፕሮጀክቱ : የቆመ አስፈላጊነቱንም ስለምንም እንደሌለበት ከሚመለከታቸው
ስላለበት : ስነጋገር ሰብሳቢዎችና እየታየ ቢሆን በሚል
የብድር : ሀቆችን ሳይተጓጎል መንገደኛው ሊስትሮዎች ማኔጀር
የፈቀደው : ተቀጥረው በዛቻ የሙዚቃ ማኔጀር በወርልድ
የሚለቀቅ : ቴክኖሎጂ በቅጣት ብዙኃን መመራት ብዙ
ማስገባት : አዋጅ መተላለፊያ የማስተባበር በኢትዮጵያውያን አስተያየት
የቻለው : ከማል አፄ ብትመረቅም መምራትና የሚል
ይዘገያል : ይከለክላል ተብሏል ይጠብቃቸዋል በዛ የለበትም
ሊያንስ : የደብዳቤና ኤሌክትሪክ እንዲያካትቱ ከሚመለከታቸው መዘንጋት
ተበዳሪ : በጠቅላላው ኩራት ላይም የዩናይትድ ከተፈለገ
ለኢንቨስትመንቱ : ተሞክሯቸውን መርጠው አቀናጅቶ ተቋም ታላላቅ
ተገልጿል : ይቸገራሉ እንሁን አለኝ አሰምቷል ይጀምራሉ
ለመልቀቅ : በድፍረት ወደተባለ የጎዳናዋ በዚህ ታላላቅ
በኋላም : በአሥር ክፍል ስልኳን ሲሠሩ አስተሳሰብ
የሚገቡዋቸው : አሠራሩ በሕሊናዋ ተቀጥራ ችግር ሌግዠሪ
የሚያስፈልጉትን : በመጨረሱ ምቹ ማጣትና ብዙ ታላላቅ
ተበዳሪዎች : በመንበረ ሲባል አንዳንዴም ፈለቀ ሽልማቱ
ተግባራዊ : ጥቃት ያለህ ስላልነበራቸው ሕጎች ውጤት
በትክክል : በተጨማሪም ጥሪ ባለድርሻ በአገር መቀረፍ
ዕቅድ : ዋነኞቹ ባንክ ሲቋረጥ አጠገቧ የበኩሉን
ከተፈቀደለት : እየገፈተሩ ኢትዮጵያ ባለድርሻ በአገር *
በባንኩ : ለማንኛውም በእኛም አስገዳጅ ከተፈቀደው ይላል
ፖሊሲ : መቀጮ እንዲባልላቸው ባለሁበት ገልፃ ወንድሞቻችን
ለኢንዱስትሪ : ወ/ሮ ያደጉ ታነሳና በሌሎችም ጠብቀው
ከውጭ : ፖሊሱም በሬዲዮ እሷ ባነጋገርናት በብርሃኑ
መረጋገጥ : ሰባት አመለካከት የተሳሳተ መመራት አስተሳሰብ
ተብሏል : አጎነበሱ ይዘገያል ይታያል ይጠብቃቸዋል በዛ
የተፈቀደለት : የፖርቱጋልና አሠራሩ ዉድከት ሌሊት ያሳለፈችውን
መሆናቸው : መስፋፋቱን ቁሳቁሶች ታመራና ጊዜ የኢትዮጵያ
በአብዛኛው : እየኖሩ ሊገጥመው በተለያየ ተስፋ ማምጣት
ሊያሟሉ : ውስጥም የውሳኔዎች ጋቢና ሳይወጠሩና አስፈላጊነቱንም
ታውቋል : ያሳያል አስታውቋል ይወስዱታል ሰብረናል አዲስ
የኢትዮጵያውያን : ሳይጋቡ ዓመት በነጮች በበቂ አስተሳሰብ
በተካሄደው : ያለበት በልጥጠው ለማካሄድ የሚደርስ የሆነውንና
የውጪዎቹ : ተደራሽነት የማድረግ ላይ የሚያሳዝንና አስተሳሰብ
ኩባንያዎች : አገር ክፍተት ለማድረግ ባለሙያዎች ሳያገኙ
የተፈቀደ : እየጠየቁ ትልቅ ኮሚቴ መካከል መመራት
ፕሮሰሲንግም : ያላደረሰና ገጽታ ሁኔታ ከሚገኙት ብቃትና
የውጭ : ሥራውን ሀገረ የአፈና ዝቅተኛ ቀን
ካፒታል : የሀብታም ልንይዘው ሳልሞት አገሮች ዝግጅትን
አረጋግጠዋል : ነች ከተቀበለኝ ሆነባት አለባቸው ቀርተዋል
ቀደም : የአፈና በንግድ በማድረግ የሚያመች ደግሞ
ከፍተኛውን : ግባ ሞላ ቢጤዎች በጥምረት ሆቴል
ሲወስዱ : ፈቅደው የሚኖሩ ወንድሞቻችን የሚችሉ ብዙ
የሚወስዱት : እየተደረገ ድንጋይ ተረፈ ሚኒስቴርና ነው
ድርሻ : በሚል ከተማ ኃላፊነት የሚዲያና የተሳሳተ
ስድስት : ከሥፍራው የለመዱ ያውም ባለቤት ትታው
አሁንም : የዘገበ የምናቤን ድረስ አስቀድመው የሴት
ዘርፎች : የሚያደርግ ተጠቃሚ ከሚገኙት መመራት የሚገኘው
ከቀድሞው : ሊሸጥ የፓርቲው ሕፃናት እንደነገሯት በጀርመን
ኅዳር : አልቻለችም ሰብረናል የለበትም አለባቸው አስተሳሰብ
የተሰማሩ : በፖለቲካ ይደረግልን ዝግጅቷ አድሰው ተምራ
ባይገልጹም : የተጻፉትና የኅትመትና ገለጻም ኃይል ድጋፍና
ጨርቅ : ወያላውና ከመርካት ይገኛል ከፍርድ ቆጨኝ
ከተፈቀደላቸው : ታዋቂነትን አግሮ ኮርፖሬት ዋነኛ የሚያሳዝንና
ኩባንያዎችና : ራሳቸውን ተቀባይነቱ ሰዓት ተጠያቂነት የሚኖሩ
ለጨርቃ : ስር የነበሩና ያሉ የለሽ ደህንነት
ካሉት : የሚገኙት የሚመጡ ያለዎት የወጣው ላይ
ባለአክሲዮኖች : እንደተሰጣቸው አነብናቢነት የሚወደድና ዲጄዎች አስቀምጣ
በጨርቃ : አንደበት ወቅት ፈለቀ የተነሳ ዜናዊ
ኢንዱስትሪ : መለያ በጥንቃቄ በአውሮፕላኑ አብላጫውን ቀን
ያልተለየ : ባይባል የተንቀሳቃሽ የተሳሳተ * መመራት
ዓመቱም : ፍረዱኝ በመጓጓት የንጉሡ መመሥረቱ እየታገዘች
የባንኩን : እስራትና መልካም የጨካኝነት ከተያዘው በደብተሬ
ከሦስት : ከሆነ ከቤት የዘረጋቻውን ምን ኢትዮጵያውያን
አግሮ : ከተፈቀደላቸው ግቧን ዋነኛ የሚያሳዝንና መመራት
ዛሬ : ንጽህናና ለመፈጸም እንዳለባቸው ችግሩን ተጠቃሚነትና
ጠቅላላ : አድራሻቸው የዛሬ የግንዛቤ ግልጽ ሲመጡ
ጉባዔ : በመጡበት መመርያው የኢትዮጵያ በቶሎ ሁኔታ
መረጃውን : ቦታቸውን እንዳይታይባቸው እየፈጠሩ ለማቆየት ለመጋበዝ
የአዋሽ : ፖሊሱም ከውጭ በጀት በአዲስ ከምትኖርበት
ችሏል : ይሆናል ነው አስተሳሰብ ቀርተዋል
በበጀት : ተተኪ እነዚህም አሸናፊ አቶ በበቂ
ይህም : የእውነቴን በአፍሪካም እርግጥ የአዋሽ እሷ
እነሱም : ኪሎ ምንድነው አለበት እንዳሉ ሆቴሎች
ባሉት : ጓደኞቻችንን ጫት በመጓጓት ካነጋገርናቸው በዲጄ
በአገሪቱ : ሊቀመንበር እንደዚያ እንዲካሄድ ተሰማና ማታ
የአገር : ጥቂት ሚኒስቴር አስፈጻሚ ኢንተርናሽናል ቀርተዋል
ምክር : ብሮችን ተሥለው ጥር በበቂ ላይ
የምርጫ : ተመስጋኝ መንገደኛው ሊሆኑ ስለዚህ ጉዳይ
ኢንሹራንስ : የኢትዮጵያን የተሻሉ ኃይል ኢትዮጵያ ትርፋማ
ክርክር : ቢያቀነቅንም ለመገናኛ ወላጆቻቸውን መልኩ ቀን
የተሻረውን : እግረኛ ፔንሲልቫኒያ መተዳደሪያ ከተዋወቀችው ትርፋማ
ከኅብረት : በአካል በጀት ስለተነጠቀች ሳይሆን ከሚገኙት
እንደደረሰ : መሆኑን ተወካዮችን ማኅበራት በቶሎ ችግር
ዘጠነኛ : ከተዋወቀችው ታነሳና ቢኖሩም የማኅበራዊና በጥምረት
ያተረፈ : ጋብ ዳግማዊ ጎልማሳ ዓመት ገልጸዋል
ከሚገኙ : ከአገራዊ እኔስ መገኘት ከወረቀቱ የመረጃ
ለማካሄድ : ፈንታ የኮፒራይት ስፖንሰር የተቀመጠችው ገልጸዋል
ቦርድ : እንዲሰጥባቸውና የሚተላለፈውም እንዲያካትቱ ተደራሽነት መዘንጋት
በተሰጠ : የሚገልጹ ትርጉም ሦስት የተነሳ ኢትዮጵያውያን
ጊዜያዊ : ጉድለትን ባለአደራ ከምትደረድራቸው ሸቀጥ የማስተባበር
ቤቱን : እያናገረ ሊፈጠር በማስተዋወቅ ለማስደመጥ ያደጉ
ሀብቱም : አያጣውም ቀርተዋል
የፍርድ : እንደተቀበለኝ ለልጇ አኳያ ዜናዊ የተረሱና
ቦርዱ : ቲሸርት የምዕራቡ ጀምረውት ሊገጥመው ገንዘብ
በፍርድ : በጽሕፈት ሰበር ክሱን ቤተሰቦቿን ገልጸዋል
ከፍተኛው : ያቆምነው የሚጀምር የመጣ ማን ሥላ
ከታክስ : የሚሞላበት ሲጋራ ታዳሚን የተሰነጣጠቁ በላስቲክ
የሚካሄድበት : ዮሴፍ የሚመላለሱ ከሚገኙት መመራት ብዙ
ድጋሚ : ዓላማ ወንድሞቻችን ብዙ ቀርተዋል
ንግድና : ነጋዴ ቶማስ ስላስቸገረ ድምጽ ሚስተር
የባለአደራ : ተቋማቱ ጉዳተኞች መካከል ኢንተርናሽናል ነው
አዋቀረየአዲስ : ዓ.ም. ከተመራ የሚገኘው አስተሳሰብ ቀርተዋል
አነጋጋሪ : ሲቀረው ቢተገብሩት ተኩል ኢትዮጵያውያን *
ባንኮች : የኳታር ቋጥረው ለማወዳደር እውቅና ተረፈ
ሆኗል : ይለቃሉ በሸገር ታስተናግዳለች ትሥላለች የተመረኮዘ
የንግድ : መበተን የብድር መተላለፊያው ሸቀጣ ማኔጀር
ጉባዔው : ሥነ የሕይወት የምክክር ረገድ ተጠቃሚነትና
ቆረጠ : አስታወቀ ገልጿል ብሏል ታስተናግዳለች ተሸፍነዋል
ኩባንያ : በእስያም #ኛ በኋላ ደረጃ ያሉትን
መርጧል : ጉዞ በቁጥር ከእያንዳንዱ አልቻለችም ሥዕሎቿ
ንግድ : የሚተላለፈው መረዳት ለማሟላት በወቅቱ በቶሎ
በነበረ : ለመሣል የሚነግዱ እንዲያካትቱ ተደራሽ ተደራሽነት
ባለአደራ : ጀርባ የሚለውንና ኮሚቴውን በኢትዮጵያውያን የተረሱና
ተብሎ : በሊቀመንበርነት ተከሳሹን እንደሆኑ መሥራቷ በጥምረት
ይመረጣሉ : ስኩዌር ዘመን ውይይት እየሠራሁ ቢመለስም
በአቶ : ያትታሉ የፍልስፍናው ሳይጋቡ ሁሉም ብሮድካስቲንግ
ለዚህም : ትላልቅ በመቶውን ግብሮች በጎዳናው ገልጸዋል
ታኅሳስ : ቀርተውበታል ታይተዋል ይካሄዳል ተለያዩ አይደሉም
የተመረጠውንና : ከተፎካካሪዎች ወደቆሙት የሚገዙ በኢትዮጵያ ዓ.ም.
የሚተካ : ለመውሰድ ተፈጻሚነት ማምጣት መመራት ነው
ተችሏል : ያስቸግራል እየተካሄደ አልቻለችም ተናግረዋል ሰብረናል
እንዲቆይ : የተውጣጡ የአየር እንዳለባቸው ተጠቃሚነትና ላይ
ግልጽ : የመንገዱ ተዘጋጅቶ ቤተ ጠብቀው ኮሚቴውን
ይታወሳል : ተፈጥሯል ተቋቁመው ይቻላል ትገልጻለች ፎቶ
እንዴት : እንቃጠል ጉልበት እያስወጣው ኢኮኖሚያዊ ኤም
ጠቅላላው : ጉድለትን ጊዜያዊ ኢንዱስትሪ በአውሮፕላኑ ሸቀጥ
ይካሄዳል : ቀርተውበታል አቅርበዋል አላቸው አስተሳሰብ ቀርተዋል
በቀረበው : ሲናገር በአገር ከፍተኛ በዚህ እላለሁ
ዴሞክራሲያዊና : ዕቃ መረጃውን ለመሣል እንዲሆን የሚያሳዝንና
በሚጠራው : የጠራው ሰዓት ረገድ ሌግዠሪ ማምጣት
ገነቲ : ካሳ እነዚህ መረበሽ ውጪ በእርጅና
እያነጋገረ : በደንብ አናሳ ንፁኾች በቀኝ እጥፍ
ሊካሄድ : አትምጡብኝ ስላልቻለች ተምራ ኮፍያዋ በበቂ
እነዚህን : ሲያስመካው የተገረመው የሚመለከት አንዱ ምስለ
ሊያካሂድ : አማራጭና ዙሪያ የሕግ መስፍን ፍቅር
በሆነ : የሚገርመኝ ግርግር ሆቴል * አስተሳሰብ
ምክንያቱ : እግቡ አቦ እንደሌለበት ስለዚህ ያሉትን
መስጠቱ : ያላገናዘበ ሚና የምታሟላበት ቢኖሩም የሚያሳዝንና
አመራሮች : ጆከሪ እንደሌለበት ሚዲያ መዘንጋት ነው
ተመራጮች : ደክሞ ተቆጥሮ ቀሎ ሌሎች ያደጉ
የሚመራውን : የሰባት ጉዳት የበረራ ያስተዋወቁ ከመሆኑ
ማዋቀሩንም : ዘለፋ አበረታች አላት በሙያው ድርጅት
እንዲካሄድ : መንፈሳዊና የተረዳሁት ማክበጃና የማኅበራዊና እንዳለባቸው
በመሻሩ : በየፌርማታው ስንገባ ከሚያዘወትሩ ደረጃ ሆቴል
ይጠበቃል : ያሻል ትመለከታለች የሚገኘው አስተሳሰብ ቀርተዋል
እንጂ : ያውስ እንደሚታየኝ ብዬ የትራንስፖርት እንዳለ
ከተሻረው : ውስን ማጫሽወርቅ ሴት ኢትዮጵያ *
ውሳኔዎችን : ሽጭልን የሳንባ ቤቱ በጥምረት ሆቴል
ፕሬዚዳንትነት : ቫሉታ ዳር ማኅበራት በቶሎ ሁኔታ
ታግዶ : በሌለበት አሉ ኢትዮጵያ በምትኩ *
በዘጠነኛው : ከንቲባ መምጣታቸውን ከባለቤቷ ባነጋገርናት በጎዳናው
ኤልያስ : ከሕገ ለጣላችሁት በደልኳችሁ የተለመዱ ብቃትና
ቤቶችን : በቀላሉ ቀድሞ የሚያሳዝንና ታላላቅ ቀርተዋል
በንግድ : ሕዝብ በማድረግ ዝቅተኛ ዲስክ ድጋፍና
የሚካሄደው : የጠራው የወንጀል አዋሕደው የሚመሩት ተደራሽነት
ይህንን : ማስቲካውን የፍጥነት የሚወስንበት ፒያሳን እነዚህም
በጊዜያዊ : ያላገናዘበ እየተመለከተች አስተሳሰብ ቀርተዋል
እንደሞላ : እንደምሳሌ የሙዚቃ በኮፒ ከሚዲያው ማኔጀር
መጠየቁ : ተናግሮ ያሉትን ይህ * ታላላቅ
ሺሕ : በእውነት ነዋሪዎችን መርሐ ጉዳተኞችን ያሉትን
እያሉት : በማቅረብ የሚመሩት ማምጣት የሚያሳዝንና የሚገኘው
መባሉ : የምታገኝበት ዓይኔ ብቻ መመራት የሚገኘው
ቀመር : ከአዳዲስ የሚሰራጩ መንገደኛው ባጠቃላይ በጥምረት
ከጠቅላላ : ፊት ብሮድካስቲንግ ታላላቅ ሆቴሎች አስተሳሰብ
ምልዓተ : የሚያስቸግር በዲጄ ሲመለከቱና እየታገዘች ዜናዊ
ተቆጥሮ : ደክሞ ተመራጮች ጊዜያዊ ሸቀጥ የማስተባበር
አሠራር : እየተባለ ሊያጋጥም መረበሽ ዓይነቱ ያለዎት
ይሠራ : ጉዞዬ የሚሏቸው የባህር ቦታ ወይም
የሚሆኑ : የበቃው ታገኛለች ስላልቻለች ታስተናግዳለች ምንድነው
በዚሁ : ወራትን እና አሻግሮ መመራታቸው ውጤት
እንደተፈረደለት : ከሥፍራው ተለይተው ወደዚህ በጀት እፎይታ
በኩል : ለእናንተ ድምዳሜን ቀሎ ትኩረታቸው አሉታዊ
አባላቱ : ማሞ የምትመጣው ቁጥር ለአካል ለማቃለል
የሰፈረውን : በወዳደቁ በረሃብ ዓመት ሌግዠሪ ዕድሉን
ያልተከተለና : ተቆጣጥሮ በውስጧ አስተኝታ ብዙ ቀርተዋል
አዋጅ : ማስገባት አገላለጽ በማለት ተጠቃሚነትና ውስጥ
እየተካሄደ : ቢን ተችሏል ካፒታል ሶሪ ቆም
ደንብ : በጋዜጣ እና የምወደድን ድንጋይ የሚተላለፈውም
አባላት : ፋንታሁን በቅድሚያ ጥቂት ክትትል ተጠቃሚነታቸውን
በማስታወቁ : ብቻ በኢንተርናሽናል በወርልድ ወንድሞቻችን መመራት
ግድፈት : ሽብርተኝነትና መሥራት ፒያሳ ዓላማ በምትኩ
የሚፃረር : አስመሰላችሁት መቅደላን ጀመር ካረፈበት ዳይሬክተር
እየተባለ : አሠራር ሊያጋጥም እጁን ያለዎት የሚችሉ
ከተገኙ : ኤፍ ሲማር ለልጇ ይደጉማት አኳያ
በውክልና : በተለያየ ፎቶግራፋቸውን ሆኖም የሚመላለሱ ፎረም
ማቋቋሚያ : እንዳደረጉላቸው ቲንኪንግ በሌላው ከመለመን ከተዋወቀችው
የጠቅላላ : የቆምንበትን እንደተመኘ መቅረፅ መረበሽ የሚያጣላቸው
ሕግን : አብያተ የፖስተሪቲ የሚያጣላቸው ተመልሳ ኮሚቴ
ሞላ : ብንጀመርም ቢጤዎች ግንባታ በወርልድ የወጣው
ጉባዔውን : የሚሄደውን ወረቀቶቹ ብቃትና መካከል ሆቴሎች
በማያሟላ : ንድፈ ኃላፊነት ገልጸው ባሳተፈ መመራት
የሚባለው : አለማዳመጥ ሰው ጉዳተኞች ማምጣት የወጣው
እንዲስተካከል : ግብዓቶች በመገረም ስላልፈለገ የምትመጣው ኤሌክትሪክ
ትክክል : በባለሥልጣናት ተባባሪ ቡርሽ ፕሮፌሰር ዳይሬክተር
ጉጉት : ገና ከሆነ ድባብ መሆናቸውን የዘረጋቻውን
የሚያሳስቡ : ማጠራቀሚያ ችሎታ የሚገኘው ታላላቅ አስተሳሰብ
አንድነት : ፎረም ውስጥ ወንድሞቻችን ያሉትን መካከል
እምነት : በዝቶም ሊያስቸግር እንደሄደ መዘንጋት ታላላቅ
የሚያካሂደው : ንብረት በብዙኃኑ ዓይነቱ ወንድሞቻችን ብዙ
ወጣ : አደረጃጀት ትዕዛዙንና በብዙኃኑ በማለት በምትኩ
መኖሩንም : ማሳተም ሊታሰብበት እየፈራ ስንታየሁ መዘንጋት
የነበራቸው : መመርያው በየጣቢያው ተበራክተዋል ወጣት ጥር
የጠራው : በሚጠራው በማቅረብ ተደራሽነት ማምጣት እንዲሆን
ከተፈለገ : የያዘበት መላምት የሚተማመኑት በመለወጡ ለሥዕሎቿ
ይጠቁማሉ : ያቆምነው ያባነነኝ ወድጃለሁ ከሁለተኛው ታስተናግዳለች
ዴሞክራሲያዊ : ጥቅሶቻቸው እሱ እንደቆየ እንዲሆኑ ይኸው
ማድረጉን : መላምት ከተፈለገ ከፍተኛውን መሬት ሸቀጥ
አባል : ቀስቅሷል ሌሎችን ቢችልም እሷም ተዳዳሪዎች
የሚያመለክተው : ባይኖርም እንድትማር ረገድ ዓላማ በኢትዮጵያውያን
እንደሚካሄድ : ጥብቅ እንደሚወሰዱ ማስተር መርሐ ታዳጊዎች
ውስን : ከተሻረው መመደቡን ውጤታማ ሴት ኢትዮጵያ
የጽሕፈት : በሕግ ሌላም የለበትም ነጥብ አስተሳሰብ
ይላሉ : እንዳይሰማ ደፍሮ ስኬት ያገኟት በመንገደኛ
ሰነድ : ባህልን መሆናቸው ውስጥ ውጤት ወንድሞቻችን
ከምርጫው : ሰባ የሚያቀርቡት ባለፈ ድንጋይ ውጤት
የምርጫው : አቆላልፎ ሊጣልበት ሥራዎቿን ታመራና ሁሉም
ምርጫውን : በመሆኑም በተያያዘ ከሙዚቃ አንዳንዶች ወዳጅ
የአባላት : ቢበዛም ከፊሉ ትምህርቷን ሚዲያ ረገድ
ወገኖች : ክፍተቶች ግርግር ጉዳይ የሚዲያና በወርልድ
መያዝ : ሥራዎቿን ታመራና ቸርቻሪዎችና የኢትዮጵያ ታላላቅ
ተያይዞ : በነበረ ማቅረብ በመንገደኛ እንዳለው ናቸው
በቅጽል : ሙዚቃዎችን የአየር ግራፊክስ ልጅ ለመውሰድ
ያድርግ : መሠራቱ በዓለ ከቀረበ ውይይት እየሠራሁ
ጠብቆ : አይዳስሱም ሲመጡ መንገደኛው ከምትደረድራቸው የግል
እየተጠበቀ : ማካሄዳቸው ሠራሽ የተመለከተ የተመቸ ሊሆኑ
በእንጥልጥል : ሊያስቸግር በኢንተርናሽናል እንዲሆን ነው አስተሳሰብ
ትኩረት : የት የሚያጣላቸው ያሉት የሚቃኙ ከሚዲያው
ከነበረው : በሬዲዮም ፍላጎት ጉዳይ የሚያስችል እንዲሆን
በጥንቃቄ : ሽፋን ኢንዱስትሪ አብላጫውን የመገናኛ በኢትዮጵያውያን
ለማቆየት : የድጋፍ የሚቆጠሩ የሚመሩት ማምጣት የሚችሉ
ቁጥርን : ለተበዳሪዎች ጣቢያዎችንም ኃይል ረገድ ዓላማ
ምንጮች : መቻሉን ኃላፊ መልዕክት እንደሚያይ በቀላሉ
ቴዎድሮስ : ሳምንት እንደ ብታገግምም ለመሣል መምራትና
የኢትዮጵያን : በሌሎችም ብዙኃን ትርፋማ የተረሱና መመራት
የጨካኝነት : የእስራት መጥፎ የፀደቀውን መመለሴ ኮሚቴውን
እውነታ : ጣሉልኝ መልዕክት እንዳጋጠማት ሁሉም ታላላቅ
ከልጅነት : ንጉሡም ኪሎ በነጮች አለበት ነገር
ይኖራሉ : ያለሥራ ለምንድነው አይደለም በዲጄነት ፎቶ
ባህሪይ : ኤክስፐርቶችም ሙዚቃውን ዕፅና ዲጄዋ ለመቀበል
አጥኝዎች : የሚያስጎበኘን በቆሻሻ ክልል የምታሳይበት ብርና
አሉን : ጥቅምት ትውላለች ይጀምራሉ ተሸፍነዋል በበቂ
ይኖራሉና : ከወረቀቱ ባለድርሻ በአገር ይህ እላለሁ
እምነታቸውን : ታናሽ በድርጅቱ ኃይሉ የሚያደርግ ብዙኃን
የሰውን : የጠቀሰው በጎዳናው በመንግሥትና እንዳሉ ምክንያቱም
እነሆ : በሌላ ባነጋገርናት ቆም እንደሚገባና ምክንያቱም
የታወቀ : በሰላም ትልቋ የብር ሙዚቃዎች የምወደድን
የእኩይ : በግምት እርሳሱን ጀምበር ማኅበራት የማድረግ
ምሁራን : ፖስተር ምንጮች መቻሉን እንደሚጎዳው ሴቶች
መፍትሔ : ዕቃ አካላት ለመፍታት እንዲሆን ነው
የዚህ : ቀጥሎ ግን ሆቴሎች አስተሳሰብ ቀርተዋል
ከአፄ : ተጠቃሚነትና ውስጥ እንዳሉ ብዙ ታላላቅ
የአሁኑ : እየለመነች ያህል የተነሳ አለበት አበባ
ስማቸው : በመብታቸው ሥዕል ሁሉም ለአካል ረገድ
ጽሑፍ : በፌስታል እናንተ ተቃዋሚ የሳንባ የሚገልጹ
ይፈጽሙ : መሳይ የሚናገሩ መጨመር እያዩ መርጠው
እርግጥ : የእውነቴን አ መነሻው ግብዓት ለሥዕሎቿ
የተገለጸው : የተዛባ ከሕዝቡ ሆኖ አበባ እንዳሉ
የሚጠይቁ : መኖር እኩለለሊት አስቀምጣ ጉዳተኞች መመራታቸው
የኖረበትን : የአፈጻጸም ተደራሽነት ማምጣት የሚችሉ ታላላቅ
በሠለጠነው : ቀጥሎም ተከሳሹ ወዳጅ በአዲስ ምክንያቱም
አዕምሮ : ከሚገኙት መመራት ብዙ ታላላቅ ቀርተዋል
በመመርመር : ማኅበራዊ የኢትዮጵያ አካል በኢትዮጵያውያን ሳያገኙ
ሥልጠና : ለይቅርታ እጥፍ ዓላማ ኮሚቴ ከተመራ
መላምት : ዕፅ ልጅ ኃላፊነት ገልጸው የሚዲያና
ሊቃውንቶች : ሕጋዊ ጋብ ሙያዊ ብቃትና በበቂ
ምጡቅ : በማሰራጨት የሆነ ከፊል ከዕለት እንደወትሮዋ
ተላብሰው : ኦሮሞነት መለኪያ የኪስ መርጠው በኢትዮጵያውያን
አገናኘው : አይገርማችሁም እንገነዘባለን ኖሮ አላቸው አለባቸው
ካሳ : ገነቲ የሚቃኙ እነዚህም የተሳሳተ የሚያሳዝንና
የሚሰጡ : የምትመጣው ቁጥር ለአካል በቶሎ የሚችሉ
በእኛም : የገቢዎችና ልጄ በጎዳናው ምክንያቱም መዘንጋት
ትምህርቱን : ተሰብስቤ ቦርዱን በዝርዝር በላስቲክ ልማት
እውን : ማንኛውም ሆኖ ምክንያቱም መዘንጋት ብዙ
ዕይታ : እንደሚደረግ የሥር ስለዚህ የኢትዮጵያ አስተያየት
በማጥናትና : የቅዳሜ መንስዔ የሚሰራጩ ትላለች ገልጸዋል
ምርምር : ኳስ ሊያሳውቅ ኤዲት ማኔጀር ያለዎት
መቅደላ : ረቡዕ የፌዴራል ሳይሆን ዜናዊ የተረሱና
ፍላጎታቸውንና : ሚካኤልን ጥንታዊ የቦርድ መምረጥ የተለየ
መይሳው : አመሐ ወረቀቶቹ ተቀብላ አካባቢውን የተመረኮዘ
የሳይኮሎጂ : ተገኝተን ከአቶ የሚመጡ የሚዲያና ከሚገኙት
ዕድገት : ነገርስ እንደጨርስኩ በሳምንት በወርልድ ያሉትን
ዓለም : ያየ ሒደት ዴረሳ መምራትና አበባ
አቅርቤያለሁ : ተሰምቷል አሉን ትመኛለች ተሸፍነዋል ሲሠሩ
አንባቢዎች : ከሰፈረላቸው እሷም የምትመጣው ቁጥር ዓይነቱ
ለችግሩ : ሐሳቡን ተወካዮችን ችግር በበቂ የሚያሳዝንና
ዕውቀትና : ትርፋማ ታላላቅ አስተሳሰብ ቀርተዋል
በታች : አቁሙ የቤት ብዬ ተከሳሹ ምልከታ
ዘመናይ : በሕግና እስረኞቹ መዘንጋት ታላላቅ ሆቴሎች
የምናቤን : አጠንክሮ የሴት የኢኮኖሚ ጉዳይ የሚያሳፍርም
ጥልቅ : ተረኞች ሌላም ጅምሮች ኮሚቴ የሥራ
እስረኞች : እስረኞቹ እንዲሁም መዘንጋት ታላላቅ ሆቴሎች
ተዋግተው : በህንድ ምርጥ የሚገዙ ደግሞ ሆቴሎች
ከቆሙበት : አይደለችም ብታገግምም ግድግዳና መካከል ኢንተርናሽናል
ተውኔቱ : ይላል ሥራው እንዳሉ ምክንያቱም ታላላቅ
አገራችን : ሰፊና የተጀመረ ፒያሳ ከሚገኙት የተሳሳተ
ከመሞታቸው : ራዲያተሩ ሌላም ስለዚህ ኮሚቴ ይህ
በገሃድ : ንገሩኝ የተከሳሹ ተከሳሹን በሞት ዜናዊ
የነበሩና : ስለእግዚአብሔር ለጨርቃ አስተሳሰብ ቀርተዋል
ተይዘው : እስከሚደርሱ ክሱን አስቦ የምሥራች መሥሪያ
ከቀኑ : ምርቶችን በመገናኛ በበቂ አመለካከት ሆቴሎች
ከእንግሊዝ : አጠባበቁዋ የሚተላለፉበትን ቀርተዋል
ርቀት : የጠቀሰው ስፖንሰር ብቻውን በመንግሥትና የሚመሩት
ሲኮበልሉ : ፓርቲዎች የሚታየው ክትትል ተጠቃሚ በምትኩ
ከሳቸው : እንዲመለከቱት ለማቃለል ይህ አስተሳሰብ ቀርተዋል
አስጠርተው : የሰባት ወስደው የሚመራውን መንገደኞች ከተመራ
ጃግሬዎቻቸውን : ለመቅረፍ ሁለቱን ለተበዳሪዎች አካላት የኢትዮጵያ
እንዲያመጧቸው : * መመራት የሚገኘው እላለሁ ታላላቅ
እንዲህ : በመጓጓት በምትኩ ዓይነቱ የተረሱና አበባ
አከባቢ : ያደለው የማስትሬት ከባህር ከክለብ ውጤት
ቆመዋል : የለበትም የሚል መመራት ቀርተዋል
አፄው : ከፊልም አምናችሁ ቀለም ኪሎ የጎዳና
የመጡ : ይሰፈርልኝ መቅረት ከሚሞት ሳለች የተነሳ
በአስቸኳይ : ትኩረት ሌላም ኮሚቴ ማኔጀር የተሳሳተ
ማዶ : እስከ ታላላቅ ሆቴሎች አስተሳሰብ ቀርተዋል
ለሃይማኖት : በእስያ እንቅረፀው በዝርዝር የሚያሳዩ በላስቲክ
በግምት : የእኩይ ጀምበር ክትትል # የሠራተኛና
ጠፍተው : የለኝ ቆም በነጮች ሆቴል በበቂ
ቤተ : ፀረ የመንገዱ ግራፊክስ በሌሎችም በጥምረት
መንግሥት : አመጣሽ የማስተባበር አኳያ የተረሱና ብዙ
ሥፍራ : ኮሚቴውን እንደሚኖርበት ደግሞ አዋርድ ሆቴሎች
ለፖለቲካና : ፎቶ ስልኳን ቤቱ ምንድነው አለበት
ተኩል : የዘለቀ ለመኖር ኢትዮጵያውያን * ታላላቅ
አዘዙ : ያክላል ለምናለች ነበር ወሰኑ አትመስልም
እየኖሩ : እስከሚያመጣ ያንዣበበት አዛውንቶችና የቅጣት የማይቀይራቸው
ተልከው : ከአንዳንድ ስለሆነ ማኔጀር ወንድሞቻችን ያሉትን
ለዓመታት : የሚፈልጉበት ትምህርት ይዘው የሚመሩት አካላት
ሆነ : የሠራተኛና አስፈጻሚ ኢንተርናሽናል ነው አስተሳሰብ
ነጮች : ኃላፊነትን በተቃራኒው ቅርፆች መማር መዘንጋት
የአፄ : ለጎን ተስኗት ብዙ ታላላቅ ቀርተዋል
ይሠሩ : ማስወገድና እጥፍ ሊሆኑ በኢትዮጵያ አካል
ከመጡ : በመደረጉ ባለሙያዎች ቀርተዋል
ከባህር : ይመስል እና ድንጋይ አቅም ነው
ወታደሮች : ዩሮ በመሆኑም ብቸኛ አጠገቧ ድንጋይ
ጋሻ : የተጠየቀው ኮሌጅ አምስቱ ገዝተው ባለሥልጣን
የአሥር : እየተራመድኩ # የሠራተኛና አለበት ያሉትን
በጀግንነት : እየተከተሉ ከተሻረው የማይሰጥ ማጫሽወርቅ አየር
የሚታይበት : ለማን በጎራዴ በመዝገብ ግብር እንዲሆን
ገደላማ : ኦሬንታል ሐቅን የማስቲካ ለችግሩ ተወካዮችን
ወር : ተውኔታዊ መላምት ሌሎች ዕፅና ሆኜ
ለስለላ : የሚተላለፈው ሚኒስቴር መቀረፍ አዲስ አመለካከት
ቦታው : ተጠናክሮ ሐሳቦችን ግንባታ የሚዲያና የወጣው
ያስፈራሉ : ይጽፋል ዲጄዋን ዘይትና የሚቃኙ እጥፍ
ይቅርታ : ኅብረት አካላት በኢንተርናሽናል እንዲሆን መዘንጋት
ተፈተን : ዝግጁ አስረድተው መጨመሩ ወላጆቻቸውን የሚገኘው
አምስቱ : አካባቢን የማኅበራዊና ውጤት መካከል መመራት
በጠፍ : ትችቶች ስልኳን ደረጃ አስተሳሰብ ቀርተዋል
በደልኳችሁ : ቲኦሎጂ የሚወተውት ኤልያስ መብራት ከተመራ
አገልጋዮች : እንደምሳሌ በኮፒ የሚነግዱ እንዲያካትቱ አካላት
እየፈራ : አገሮችና ሊያደርስ ጥሩ ተዳዳሪዎች ከሚመለከታቸው
እስረኛ : ሁሉን የነፍሴ ብሎት ሁሉንም መስፍን
አጠፋሁ : ወይ ተናግረዋል አለባቸው እላለሁ ነው
ንግግር : ውጤትም ፈጥሮ ሲደገፍ ባለሥልጣን ይህ
ልስማው : እንሰጣለን ይቀናቸዋል ተይዛለች ይታወሳል ታኅሳስ
በቁጣ : ባለሁበት ክስ ከቤት ሳያገኙ ኢትዮጵያውያን
ነን : ለመሳል በወቅቱ በላይ ጥቂት ሁኔታ
ንጉሡ : ሄዶ የደብዳቤና የምትለዋ ክትትል ናቸው
እስቲ : የገቢዎችና አድልኦ በሬዲዮ ይደበድባት ምክንያቱም
ንጉሡም : ከልጅነት ኪሎ አለበት ነገር ሆቴሎች
ለይቅርታ : ሥልጠና እጥፍ ዳይሬክቶሬት ዓላማ ብዙ
ጎራዴ : በፈጠረህ ያስቆጠረችው ግርግር ደረጃ ሆቴል
ጃንሆይን : ላይና ግድግዳና ወንድ ተጠቃሚ ሽልማቱ
አነጋገር : የሳንሱር የጀመረች አፄ እንዳትሥል ስትሞካክር
አሏቸው : ይዘገያል ይታያል በቀኝ የለበትም ቀርተዋል
በእጃቸው : ካጠፋ ነገደና ጊዜ ቸርቻሪዎችና ይመራ
ጌታዬ : የደቡብ የምሥራቅ እንዳይሰማ ሠራተኞችን በማድረግና
ወዲያው : ለማጫወት ቅባ ተመልሳ ከተመራ ታላላቅ
በጨረቃ : የመሳሰሉትና ነጋዴዎች በእንጨት ቤታቸው ትምህርት
በሚያስፈራና : ይዞ ልማታዊ ረዥም የማገት የሚኖሩ
ላያቸው : አደባባይ ዕቃ ባይቀርም የምትመርጠው በስፖንሰር
ይደረግልን : ምስክሮቹን ዝግጅቷ የተነሳ አበባ ነጥብ
እየቸረ : የመኝታ ስናሾፍ ቀረብ እየዘከረ ገቢ
ያስደነግጣሉ : አለ አላቸው አስተሳሰብ ቀርተዋል
ድንጋጤ : ቫሉታ ጉብኝት የአገር ግብዓቶች ለማግኘት
ዓይናቸውን : በብርሃኑ ነገር ታላላቅ ሆቴሎች ነው
ናችሁ : ካጡ በሌሎችም የኢኮኖሚ በጥምረት ደረጃ
በሚፈጥር : ሥር ተደራሽ የማድረግ በወርልድ ወንድሞቻችን
አደግድጎ : ሚዲያዎችን ሲሮጥ ባንክ ሲመጣ አፍ
ግርማዊ : በሰዓታት ሰፊ ጣልቃ ይመራ የሚችሉ
ቀረቡ : አስረድተዋል አስቆጥሯል ያመቻቹላታል አትመስልም ፎቶግራፋቸውን
አብራችሁ : መስፍንበዚህ የስም በኪነ ለማቃለል መካከል
ወገኖቼ : እንደሚታየው ወጣት ረገድ እንዳለባቸው ከተመራ
በማስቀየማችን : እንደጨርስኩ በወርልድ የሚያሳዝንና ብዙ ታላላቅ
በትዕዛዛቸው : በዩናይትድ ወስኗል ከሱ ኪሎ ገልጸዋል
ሲለምን : ገልጸዋል ሲሠሩ አቀናጅቶ አስተሳሰብ ቀርተዋል
አንደኛው : ጎብኝዎች አካባቢያቸውንና ሚና ግብሮችም መረበሽ
ችግራችሁን : ይዳስስ የሚሰጧትም የሚያሳፍርም * መመራት
አምናችሁ : ዓመታት ኪሎ የጎዳና አብዛኞቹ በነጮች
የቤተ : ስፖንሰሮችን አንዳንዶች ደግሞ እነዚህም የሚችሉ
ጥፋተኞች : ጠበቃ ሊሞላት ከተመራ ቀርተዋል
አንበሳ : ልባቸው ሽብርተኝነትና መገንዘብ ሙዚቃ ውጪ
ለስለስ : መተላለፊያው የሚመላለሱ የሚመሩት ሽልማቱ መመራት
ለምንድነው : የሚዘምቱት ይኖራሉ ይካተታሉ የሠራተኛ ቤቱ
ሌሎቹም : ኢትዮጵያ * እላለሁ ነው አስተሳሰብ
ከጠላቶቼ : ከሰባት እስረኞቹም አፄ ግድግዳና ደህንነት
በወሬ : ያወቁት ሠራተኞችን ስለተገነዘቡ ዋነኛ የመረጃ
አንገቱን : እስኪዘልቅ ኩባንያ ሊወሰንበት ከተዋወቀችው ቅርፆቹን
ተቆጥተው : ተምመው ገለልተኝነትን እንብርት ተዘጋጅቶ መንግሥት
እስረኞቹ : ዘመናይ ሸማቾችን ታመራና መዘንጋት ታላላቅ
አቀርቅሮ : ጋይድ የተረዳሁት ድሬዎች ኃላፊነት ጥግ
የጠፋችሁት : እንደማይቀርም ሀብታሟ የሚያስቸግራቸው ዲጄዋን እግዚአብሔር
ባማተሩ : ካልሆነው የቅጣት ሊስትሮዎች ከምትደረድራቸው መተላለፊያ
መንግሥቴ : በጫማ የለብለብና ዘላቂ የጠቅላላ ሚና
ንገሩኝ : አማራጭና በገሃድ ተከሳሹን አገልግሎት የሚቃኙ
ተክለው : አንዲት ቢጎላ ዘርፍ ልጅ በያዘችው
የባህር : ጉዞዬ ይሠራ ሠሌዳ በኋላ ከጀመረች
ሁለቱን : የኢትዮጵያ መዘንጋት ታላላቅ ሆቴሎች አስተሳሰብ
አጎነበሱ : ተብሏል ገባች አሰብ ቤቱ አስተሳሰብ
እጅና : ወደተባለ ሲደገፍ የተቋቋመው ይህ *
የማደርገው : አስገንዝበዋል ተመለሰች ፎቶ ቤቱ ምንድነው
እየገፈተሩ : መጠን የሚገኘው ታላላቅ ሆቴሎች አስተሳሰብ
ሦስቱን : ብሔራዊ ላያቸው ሌሊት ቀድሞ በስፖንሰር
በልጥጠው : አይዳስሱም መንገደኛው በአሥር ክፍል አስተሳሰብ
ወርውርልኝ : ቻይና ይነበባል ተወርዋሪ ሊቀርብ ፊት
የንጉሡ : የማይገደውን እየታገዘች እኩለለሊት ጠብቀው ዜናዊ
ተረኞች : ጥልቅ በመገናኛ ባለድርሻ ይህ አመለካከት
ደንግጠዋል : ነበሩት ይዟል ይገባቸዋል አያጣውም አቅርበዋል
ተወርዋሪ : በወዳደቁ በረሃብ የሚገዙ ፊት የሥራ
ይመለከቱ : ዘገባዎች ትሠራ ችሎታ አዲስ አመለካከት
ገደሉ : የሚያወዳድሩት ይለምኑ በኢትዮጵያ መተካት ሌግዠሪ
ፍርደኞች : ልጆች ለመጋበዝ በጀርመን የሚለውንና ኮሚቴውን
በነጭ : ሐሳብ ከሚሞት እንዲተባበሯት ሽልማቱ የሠራተኛና
የሚሏቸው : ሮጦ በኋላ የሠራችውን ደረጃ የሚያሳዝንና
ወደቆሙት : የተመረጠውንና የሚሠሩ የሥራ በኢትዮጵያውያን ከሚገኙት
ይመስል : ከባህር ቢያተኩሩ ዲጄነትን አቅም ተደራሽ
እናንተ : አልገናኝ ጽሑፍ የሳንባ ተወግዶ መመራት
ተራ : ዕትሞች ከአንድ በአሥር ሊስትሮዎች እየሠራሁ
በጣም : እየተነገረ ያስፈራሉ ዲጄዋን እጥፍ መሀል
እስረኞቹም : ከጠላቶቼ እነዚህ አፄ በአዲስ ሳለች
ለመፍጠር : ያለማንም ብቻውን ቤቷ በማቅረብ ተግባር
ነቅነቅ : ብዙኀን እርሳስ ሠዓሊት ፎረም ውስጥ
ወስደው : እየገነጠለ በሚችለው ባለሁበት ግራፊክስ ጥሪ
ያለወትሮው : ያጠናከረው አግራሞት የራሱን ለመቀበል ስለሆነ
ወረወሯቸው : ያተኩራሉ ይዳስሳል ክፍተት ባለሙያዎች ቀርተዋል
በተመለከቱት : በእንግሊዝኛና ሳምንት እንደሆነ ሲቋረጥ መምራትና
ይመስላል : ምክትል በመቁረጥ ቤታቸው የሚገኘውን ቁጥር
በሚያስፈራራ : ጫትና በኢንተርፕራይዙ የኤፍኤም የቅርብ ቴዎድሮስን
ድምፅ : አላብሰውታል ጥር አላቸው አስተሳሰብ ቀርተዋል
በተራ : ጆሯቸው ይህንኑ በመከታተል የኮፒራይት አክስቷ
ቁረጥና : ሆነና የማንነት በድርጅቱ የተረዳሁት የማኅበራዊና
ትዕይንቱ : ሲከሰት የራሱ ቅባ የሚዲያና የአካል
በሚያሳዩት : ካሜሮናዊው እንበልጽግ ዕዳ ካስቀመጠው አስቸጋሪ
እንደተጠናቀቀ : የአምስት ይህ ከተመራ መመራት አስተሳሰብ
ሲያደርጉ : ሕይወቷን ከጥቂት የምትመጣው ጀምበር መመራታቸው
ጀመር : እየተጣለ ኢንተርፕራይዝን ለአማተሮች አንጋፋዎችን ተዳዳሪዎች
የድንጋጤና : በተካነበት ሊፈታ የሚነግዱ እንዳሉ መዘንጋት
በመደዳ : ሲያዩ ስላለ ሸቀጣ ማኔጀር ሌግዠሪ
ውሰድልኝ : ካሬ የመሪነት ትሸጣለች ዜናዊ ትርፋማ
ፍርድና : የተሻሉ ከተዋወቀችው ካጡ በሌሎችም ውጤት
የቆሙትን : በሚገኘው እንቅስቃሴም እዚህ አገልግሎትን ሚክስ
ንሳ : ጌታው ከሱ ከምትኖርበት የሚዲያ የተመራው
በጎራዴ : የሚታይበት እውቅና በደብተሬ የሚለው እንዲሆን
በቆሙት : የትውልድ መንግሥታዊው ንግግር ውረድና ባሕሪያት
ስንቴ : ለልጇ ሳይሆን የተረሱና ባለው መመራት
መጀመርያ : የሚደፈቅበት በመግለጽ የሰው መጻሕፍት በግል
ከፊታቸው : ስንገባ ወ/ሮ ድልደላ በጀርመን መውጫ
ያደረጉት : ግዛት ተቋሞች እየሣልኩ የመስተንግዶና ጥር
በኩራት : የሆኑ እንዲወስድ አልነበረኝም ያላቸውን ብቃትና
አንገታቸውን : ከራሳቸው ወደተዘጋጀልን ዝግጅቱ ቀለም ለሦስት
እግራቸውን : በእንግሊዝ ብርቅ ሲሏት ድጋፍ የአካል
ቆርጠው : ከተመረጡ ቢተኮስ እና ውስጥ በኢንተርናሽናል
ቀጥሎም : በሠለጠነው በአዲስ ሥራው ብለው ምክንያቱም
የመረበሽ : የሚመላለሱ ፎረም ማኅበራዊ ወንድሞቻችን ከተመራ
ከተፈጸመ : ዓይነቱ ሆኖ አበባ ላይ የተሳሳተ
እንዳይል : በሚኔፖሊስ የነበሩበትን እንዲሳተፍ ለሥዕል ግብር
ካልሆነ : እንዳይጨምር ፍርድ የሚያወያዩ የሚቀሩ እጥፍ
ደብዳቤያቸውና : ዕትም የምትወደውን በጎዳናው ከዚህ የሚዲያ
መልዕክቶች : ተጠቃሚነትና ብዙ ታላላቅ አስተሳሰብ ቀርተዋል
የልዑካን : ሴትና ከመጣው ገለልተኝነት የታወከ ማኅበራዊ
ከመልዕክቱ : ይልቅ ቦርዱም በዚህ አቶ ነገር
እያከናወኑዋቸው : ከሙያዊ ካልሲና የድሬን ለቆሙለት ለአካል
ታድገዋል : ዲግሪ እየተዘዋወርኩ ሳያገኙ ችሎታ የሚያሳፍርም
ለወዳጆቻቸውም : እይታዋንና ሥላ ጅምሮች ባለድርሻ አዲስ
ለላኳቸው : በደልኳችሁ ለአማተሮች የሚያመች በስተመጨረሻ ድጋፍና
የመሠረተ : የጥሪ በጉብኝታቸው የአዲስ ስልኳን ሕንፃ
የደብዳቤና : ከጤፍ ንጉሡ በመገረም ውጣ እንደነበር
እልቅና : በማስገባት ምስለ ማኔጀር አስተሳሰብ ቀርተዋል
ለመፈጸም : ተደራሽ ተደራሽነት የማድረግ ማምጣት ላይ
በሰላይነት : በሶሲዮሎጂ ብትሆኑም የሆነውንና ፍላጎቷ መንገደኛው
ለአንድ : ስንቱ አትሰፍርልኝ እየከፍትኩት ይችላል ዲጄዎች
አትሉም : ይነገራል ተበራክተዋል ገባች አትመስልም ዕድሜ
ለፈለጉት : የተጠየቀው ከተገመተው ይኖራሉና በልምድ ፍሬያማ
ተደርጎባቸዋል : ካዘጋጁት ተቀጠረ ታስከፍላለች ታስተናግዳለች የተመረኮዘ
የቃል : መካከል የተሳሳተ መመራት ብዙ ሆቴሎች
በጦርነት : ምናለ ለዓመታት በመዋለ አያጣውም የሚመሩት
መልዕክቶቻቸው : ከጠቅላላ የሚገቡዋቸው ተደማጭነታቸውን የለሽ ፊት
ባጫ : አልፎንስ በዚህም በረጅሙ እኔም ማስቲካዋን
ቡድን : የሚያጣሩበት ያሉበት የአገራችንን ሠራተኞችን የማዘጋጀት
ወራሪዎች : ሁለቱ አሜሪካ ታዳጊዎች በተለያየ ቢኖሩም
ምርመራ : በመቅሰም የእፍኝ ለምናለች በአገር የወጣው
በትራንስፖርት : መስተዳድርን ነዳጅ የአእምሮ የሚለውንና አመለካከት
የተጻጻፏቸው : ያጉረመርማሉ እየዳሰሰ ኢንሹራንስ የኢኮኖሚ በጥምረት
ለመጠበቅ : በክሶቹ ብርቅ ሲሏት ከጎኗ ቢጤዎች
ግዳጅ : በማስታወቂያ ዉድከት የኢትዮጵያ ችግር አስተሳሰብ
አገራቸውን : ኢትዮጵያዊ የከሸፈ በሚል ኤዲት ኃላፊነት
ድርሽ : የበኩሏን ኃላፊነቶች ከሚያጫውቱ ምርጫው በኢትዮጵያውያን
መሆኗን : የመቀጠሉ ተጨማሪ መቻሉን ከሚያቀርቡ መሀል
ያስተላልፉ : እየረቀፁ ችሎታ ኢትዮጵያውያን አዲስ አመለካከት
ኤምባሲዎች : ሊስትሮዎች ከምትደረድራቸው ወንድሞቻችን ይህ አስተሳሰብ
ተፈትሸዋል : ሥላ ሰብረናል አመለካከት እላለሁ አስተሳሰብ
የጋዜጠኞች : ኩራት ከኅብረት ባለቤት ሳይሆን ትርፋማ
መቅደላን : የመረጠ የተመራው ይህ የተሳሳተ *
ሰሞኑን : ደደብ ዘቅዘቅ ይኖሩበት እየታገዘች የሚቃኙ
አገሪቱ : አፍንጫችሁን ዩኒቨርሲቲ # ሚኒስቴር መመራት
እንዲወሰዱ : ምንጫቸው የሚከፈትበት መሆኑ ምክንያትም በቀኝ
ማረፊያቸው : ሰባተኛ ስለእመብርሃን ክፍተቶች በሳምንት የሚዲያና
ተውኔታዊ : ለሥዕሎቿ ያሳደጓት ከሚገኙት ብቃትና መመራት
በተጠቆሙት : ቅዳጅ በኋላ የሚያስችል ደረጃ አዋርድ
ካሁን : ከቫይረሱ ለማድረስም ሥዕሎች እንዲያካትቱ ይኸው
አስቸጋሪ : የሚጠልፈው አስፈላጊ የአምስት የመረጃ ከፍተኛ
ትዕይንት : የሰነድ ለአድማጭ ያደጉ ቢመለስም አመለካከት
የሚያሳስብ : ዝግጅትን ዲጄዎችን ድጋፍና በኢትዮጵያውያን ወንድሞቻችን
ለመሞት : ከእንቅልፏ አምስት አብዛኞቹ ትርፋማ ባለው
የተላኩበትን : ሕግጋት ከተማን አነስተኛ ስለሆነ መርሐ
በጥበባዊ : ማሳያ * መመራት ብዙ ታላላቅ
በቀር : ካላስቀደማችሁኝ በቅጽ ሌሎቹም ምርጫው በሸራ
ዋናው : መነሻው በአዲስ አብዛኞቹ አቶ ባለው
ነጥዬ : ከዕውቀትና የሚጋርጥ ጉዳት ጥንቃቄ ምኞት
አገልግሎትን : የደረሳቸው እንደሚቃወም የቆሙትን ከሚዲያው ማኅበራዊ
በመንገዱ : በጭፍን እንደሚጓዙበት ሁሉም አቀናጅቶ ዳይሬክቶሬት
ሒደትንና : ዋነኞቹ የሚጠበቅባቸውን የበኩሉን ይመራ የሚችሉ
አንዱን : የምክር ብታገኘም ማምጣት ቀርተዋል
ዘመናዊ : ትዕይንቱን ጥንታዊ በመካከለኛው በማቆሸሽና እንዳለበትም
የሚመለከት : ቅባ መረጃ ብዙ አስተሳሰብ ቀርተዋል
ቀርቦ : አዞ ከቤት ሊያሳድጓት የሚያሳፍርም ነጥብ
የሚያሳይ : ረዳት ታሪክን ድንጋዩ ማኅበራዊ የሚያሳዝንና
በኢንተርፕራይዝ : የሚወስድ ዲጂዎቹ እንዲሁም ማንኛውም ላይ
አግኝተናል : በእጅ ቅጽል አስቆጥሯል ያመቻቹላታል አያጣውም
የፍጥነት : አስቀድመው ሲመለከቱና ፒያሳን ዘወትር ዓይነቱ
አስኪያጅ : ባለመጣል መቅረት ስላልቻለች ሙሉ ሲሠሩ
በመገኘት : ወደተባለ የሚገኘውን ሲደገፍ አስተዋጽኦ የሚችሉ
ተዘጋጅቶ : የመንገዱ ለማስደመጥ ድጋፍ ጠብቀው የአካል
የጉዞ : በተሰጠ የሚገልጹ የተቋቋመው * መመራት
ተቋማትን : መስተዋት ምስክሮቹን እንደጀመረች የሌላት የሥራ
እየተደረገ : ምንድንነው የሚመሩት አካላት የሚያስችል የማድረግ
ኢንተርፕራይዝን : አካባቢዎች እያበሩ እየተስፋፋ ካስቀመጠው ጀመር
ድሬዳዋ : በድሬዎች ሊሆኑ የሚለውን ባለሙያዎች ተጠቃሚነትና
የኢንተርፕራይዙን : ሽፋንና እንዲኖረው ምን ውጤት ያሉትን
ጽሕፈት : ፍቅራቸው ኢንተርናሽናል ነው ቀርተዋል
ቀኝ : ዓላማ አካላት አንድ ከሚገኙት ወንድሞቻችን
ጽዳትና : ከመርካት ቆጨኝ ወደዚህ ሙሉ ገልጸዋል
አዳማ : ወደነበሩበት የጥፋተኝነት ዘርዝሯል ዩኒቨርሲቲ #
የትራንስፖርት : ዝግጅት ጠብቀው የሚኖሩ ዳይሬክቶሬት የሚዲያና
ይዞታ : ነጥቦች ሰባት ባለመሆን አመለካከት አስተሳሰብ
ከመስጠት : ሠራተኞችን መድረክ በሕፃናት እንደቆየ ይኸው
ዕድል : ሲመዘን እኩለለሊት የሚቃኙ ግርግር ጉዳይ
አስኪያጅዋ : ታላላቅ አስተሳሰብ ቀርተዋል
የሰባት : አስጠርተው የሚመራውን መንገደኞች ብሮድካስቲንግ ከተመራ
የሆነውን : በባዶ ሒደትንና የሚጠበቅባቸውን ዉድከት ሰው
አጠቃላይ : የሚጠልፈው ካስቀመጠው ለአማተሮች አጠራቅማ የተመራው
ሰፋ : በተዘዋዋሪ የምወደድን አቅም ጉዳተኞችን የማድረግ
ቡድኑ : ፍጥነት የማመንና ነቅነቅ እስከሚያልፍ ነፃነት
ለመመልከትም : ማሳወቅና እላለሁ ነው አስተሳሰብ ቀርተዋል
ማብራሪያ : ይናገራል ገብነት ሚኒስቴርና ይመራ ነው
የሚያስቃኝ : ብቻ በኢንተርናሽናል በወርልድ መመራት እላለሁ
ወድጃለሁ : የመጣችው ታስተናግዳለች ተሸፍነዋል ደረጃ አስተሳሰብ
ፕሮጀክቶች : ለማድረስ ዲጄዋን ሥራዎቿን የሚገኘው ታላላቅ
ጥረትን : ሊወድቅ እስረኞቹ እስረኞች ፖለቲካዊ እሷም
በኢንተርፕራይዙ : ዳይፐሩን እያሉ የማስቲካውን በሚያስፈራራ ታዳሚን
ግራና : የሚጥል ስለእግዚአብሔር ያለ መልዕክትና ተለቀው
ከሥራ : ሐያቱ ቲሸርቱን ፈረንሳይ ሳይሰጥ መመራታቸው
ለመመልከት : ሊጤን ዕድል ቢቃኙ ያሉት ተቋማቱ
ውበት : ሥልጣንን ብትሉ ብዙ ታላላቅ ቀርተዋል
ከተመለከታቸው : ያቃተው ክፍያዬ አሠራሩ ጋር ተወካዮችን
ቆሻሻ : ቢሉም ፈቃድ ቢጤዎች በጥምረት ውጤት
ፌስታሎችና : ጎዳና ሚኒስቴር አለባቸው አዲስ ከተመራ
ግቡ : መረጃዎችን ጥዑመ የግል በኢትዮጵያውያን ወንድሞቻችን
የሆነ : አዳማዎችን ምጡቅ በተደጋጋሚ ፖለቲካዊ ቅር
በማስዋብ : ሲከሰት መንገድ መሀል የአካል ከተመራ
እንደሚጓዙበት : በልጃቸው ምናልባት የተመለከትንላት እያላቸው ሁሉም
የተመቸ : የፀዱ መዝለቁን እየተጠበቀ ተማሪ ሊሞላት
ከመንገዱ : ሕንፃዎች ሸማቾችን መዘንጋት ብዙ ታላላቅ
የተገመተ : ማገዙንም ከ# የተንቀሳቃሽ ባሳተፈ የሚያሳፍርም
እየተጣሉ : ለደካማ ሁሉም ዳይሬክቶሬት አካል ወንድሞቻችን
በእንዝላልነት : የምንመለከተው የአካል ምክንያቱም ብዙ ታላላቅ
ቢሆን : እየታየ ባለሙያዎች የሚያሳፍርም ከተመራ ቀርተዋል
አሳሳቢ : አቶ ነገር ላይ ምክንያቱም የሚገኘው
ዓይነ : እያለ ብዙኃን ዓላማ በኢትዮጵያውያን ከተመራ
የተባለው : ውስጥና መለሎ የተገመተ መካከል የተሳሳተ
መያዣ : ተልዕኮውም በስተመጨረሻ ከጥቂት ወንድ ጅምሮች
መልካም : ጳጳሳትና የጨካኝነት የባንኩን በደብተሬ የምትመርጠው
በቆሻሻ : ከባንኮች አጥኝዎች መንገድ ከምትደረድራቸው ጊዜ
አለው : አብራርቷል ጀመረች ቀርተዋል
መምጣቱ : የሕዝቡ የተለቀቀው ፍርድ በውስጣችን ኢትዮጵያውያን
ሊያጠፉ : በክሶቹ ማዕከል ክፍል በማቅረብ የአካል
የታሸገ : ጭፍን በሆነው አየር ለመቀበል ምሽት
ሊኖረው : በብዛት ስፍራ የሚያረጋግጥ ችሎታ ኢትዮጵያውያን
ተጠቃሚዎች : ላይገረም በመነሻ ክፍል እንደወትሮዋ ሲሠሩ
አልቀረም : አይታወቅም ትመኛለች አካባቢውን ቤቱ ተወግዶ
ምናልባትም : በሽንጣም ጠባብ ገልጸው ወንድሞቻችን ከተመራ
ውኃ : መጽሔቶች በወርልድ ያሉትን ይህ ብዙ
በእርግጥም : በረጅሙ የዘመናዊነት አላፊ በሚጋጩበት ማንኛውም
የመንገዱን : የኔቢጤው እንደነበር ለመሣል ሲደገፍ ሁሉም
የራሱ : ሲከሰት በጥንቃቄ ኢንዱስትሪ እንዳለባቸው የሚዲያና
የሚችለውን : የሚወተውት ምርጫና ከታመቀው ብቃትና ከተመራ
ባልዘመኑ : እየወደድናቸው እንዳለባቸው ባለሥልጣን በወርልድ ብዙ
ውብት : ሊለን ተጨባጭነት ሰው ብቻ ውስጥ
እየተስተዋለ : ክርክሩን ለልመና ሊሆኑ መዘንጋት ብዙ
አይቻልም : ፈጥሯል አታቃጥለኝ ይገባቸዋል ነው አስተሳሰብ
የመንገዱ : ፀረ ግልጽ ገዝተው መንገደኛው ቢኖሩም
ፕላስቲክች : ሰብሳቢ እጇ ሰዎች ማኅበራት የሥራ
ሥጋት : ክፍተት ባለሙያዎች አንድ የሚያሳፍርም ወንድሞቻችን
ለዓይን : ባልታየ ሥነ ቀኝ መስመር የአምስት
ማራኪ : ታክሲና ያፈሳል ከብረት ያደረጉበትን ጀመር
ቁሶች : ሽብርተኝነትና አካባቢዎችም ሰላምና የሚካሄድበት ውጪ
ታቅዷል : ይጠርጋል ቀይሯል በክለቦችና ጥቂት አስተሳሰብ
ረዥም : ይዞ አስቀምጣ ጉዳተኞች መመራታቸው መካከል
ሊያደርጉት : ግዴታ ኢትዮጵያውያን የሚያሳፍርም ነጥብ እንዲሆን
ለዚህ : እንደያዘ የምታገኝበት በእርጅና ከወረቀቱ ተጠቃሚ
የተያያዘ : በሊብራሊዝም የሌለበት ተጥሎባቸዋል ሁሉም በዚህ
ባዕድ : ሰዓት የሚለውን በኢትዮጵያውያን ወንድሞቻችን ነጥብ
እየተጣለ : ጀመር ተቆጥሮ ተማሪ ድርጅት ሊሆኑ
ጋርደን : ድምጽ መረዳቱን ለመሣል የሚያሳዝንና አስተሳሰብ
በሚሰጥበት : አዕምሮ ኃላፊነት የማኅበራዊና የመገናኛ ውስጥ
ሲሉ : ስሜቱን በኢትዮጵያውያን ሳያገኙ ከተመራ ብዙ
መዘመን : ተሳፋሪ እንዳሉት የተመለከትኩትና ዘመድ ድንጋይ
መታየቱ : ማሻሻያ ዋንጫ የሚችሉት ረገድ የኢትዮጵያ
ሊይዝ : ስላለ ዓላማ አንድ ወንድሞቻችን ብዙ
እንዳለበትም : ግን ሆቴሎች አስተሳሰብ ቀርተዋል
መንስዔ : ሙስናን በማጥናትና የሚሰራጩ አካባቢ በኢትዮጵያውያን
የዘመናዊነት : በእርግጥም ዲጄነት ልጄ በመንገደኛ ማንኛውም
ያልቻሉ : የመንገዱ ፈቃድ ለማስደመጥ ሲመጡ የአካል
የሚወሰን : ዲጄዋን በነበረችበት ሲደገፍ ለአካል እንደሚኖርበት
እያስወጣው : አለመቻላቸው ባሕሪያት መሣል የሚያሳፍርም *
ተማጽነዋል : ወሰኑ ያመቻቹላታል ዕድሜ ቀርተዋል
የሚላቸው : በቅጣት በረዳት ከሚገኙት የተሳሳተ ብዙ
ገለጻም : የሚፈቀድለት ንብረት ተዳዳሪዎችና ኃይል ድጋፍና
ጭምር : ምክንያቱን በንጽሕና እንደሚለመድ የኢኮኖሚ ናቸው
ተጨማሪ : የዘገበ የብሮድካስት ዘመቻ ኃላፊ ዳይሬክቶሬት
መገለጫ : አቅማቸው ያሉትን ይህ የሚያሳዝንና ብዙ
ያልተጠበቀ : የሠራተኛና ነው አስተሳሰብ ቀርተዋል
ያልተገባ : ትንሽ ይዘው ተጠቃሚነትና አስፈጻሚ እንዳሉ
እንዳይኖረው : ሳትሆን በመነሻ የሚደርስ በሙሉ መጠበቅ
እየፈጠሩ : አትሌት ተደበላልቋል መረጃውን ለአድማጮች በየጣቢያው
ኢንተርፕራይዙም : መቼም ንጽህና ወዳጅ ብለው ምክንያቱም
እዚያም : ገለልተኝነትን ተዘጋጅቶ ሌሎች ድጋፍ ከጎኗ
ለመሸሽ : ቀርተዋል
ከተጣለ : ያገኟት ተቋም ችግር እነዚህም የሚችሉ
የልመና : በሚኔሶታ ይደጉማት የተረሱና ኢንተርናሽናል መመራት
የሚወረወረው : የሚመጡ የሚዲያና ጉዳተኞች የወጣው ወንድሞቻችን
መሽከርከር : የሚመራውን አበሻ ብቻ ኤሌክትሪክ እንዳለባቸው
እዚህም : ቱሪስት ሌላ ለመቀበል ምሽት ጉዳተኞችን
ተሽከርካሪዎች : ፈቅደው በድሬ እጥፍ ወንድሞቻችን ነጥብ
ተገልጋዮች : እንዲኖርም ይሁን ዉድከት ቀድሞ የበኩሉን
ወጪ : እንኑር የሚጋርጥ የኔቢጤው የሚሸጥ ተጠቃሚ
መንገዳቸው : ኢንስፔክተር ምክንያት ተሸፍነዋል ጥግ ባለድርሻ
ሊገጥማቸው : ቢቃኙ ምኒልክ ፎረም ናቸው አስተያየት
እያደረገ : ባሕሪው የማኅበራዊና የሚያስችል ውስጥ ውጤት
ለማጽዳት : ምክንያት ገልጸው ከተመራ መመራት ቀርተዋል
እየሆነ : ሊኖረው በብዛት መሥራቷ የሚገኙ ችሎታ
በሆነው : የታሸገ ለመገናኛ የሚመላለሱ ፎረም ባሳተፈ
ለመስጠት : እንዲነሱ ኒልን ቢቃኙ ዜናዎች ናቸው
እንደዋዛ : እኛም ይደበድባት ብለው ምክንያቱም ብዙ
አሳዛኝ : እየታየ ማስፈለጋቸው እየሆኑ ክፍተት ከፍተኛ
ግድ : እያገዘፉ ሳይቀሩ ያላገናዘበ በክለቦችና እየተመለከተች
መገታት : አወሳሰን መሥራት ፒያሳ በኢትዮጵያ ረገድ
ማሳዘኑ : መቀረፍ ሳያገኙ አዲስ አመለካከት ታላላቅ
አክለዋል : ያባነነኝ ይጠቁማሉ አለሳልሶ መልኩ ባለድርሻ
የሚማርክ : ይዘዋወር የምትቆጠር ጠይቀናት ትሥል ነጋሽ
ኢንተርፕራይዙ : ካልሲና የሚሰጡ ከተለያዩ ሲደገፍ ጀምበር
ጎዳናዎች : ሚውዚክ ፖለቲካዊ ወረቀት ተዳዳሪዎች ጉዳይ
እሰራለሁ : ማጠራቀሚያ ሲሠሩ በውስጣችን በበቂ አስተሳሰብ
ድሬ : አመለካከት አስተሳሰብ ቀርተዋል
ድርጊቱ : በቤተ ሀብታም በመጀመሪያው ይደበድባት ዳግማዊ
የራሴን : ስትነቃ ጎዳና ታወሳለች የመስተንግዶና #
መኪናችን : እሷ በብርሃኑ ነገር ምክንያቱም ታላላቅ
ዘቅዘቅ : እየታገዘች የማኅበራዊና ዜናዊ መካከል መመራት
የሁላችንንም : መዝገቡ ሦስት ባለው አመለካከት የተሳሳተ
በመልካም : መኪናው አቶ ትርፋማ ነገር ምክንያቱም
አላጣንም : ያውቃሉ ታወቀ ከጥር የሚለየው ገባች
መዓዛዋ : ንገሩኝ ይኖሩበት ዜናዊ የተረሱና አበባ
ለዓይናችንም : እባክሽ የማይሰጥ በሕይወቷ ኢትዮጵያውያን *
የከተማዋ : የሚነሳ በገቢ ሐሳቧን ኮሚቴ ኢትዮጵያውያን
የተቀበለችን : ለበለጠ ጥያቄዎችን ያሳደጓት የሥራ የተነሳ
እንብርት : ተምመው ጀምረው ትኩረታቸው ባለድርሻ መቀረፍ
አይነግቡ : መኖራቸውስ ዋናው ጊዜአቸውን ከምትኖርበት በተለይ
የምንመለከተው : በእንዝላልነት ወላጆቻቸውን መልኩ የአካል ትርፋማ
የተነገረንን : በእሳት ከ#ዎቹ አወጋገድ አጠገብ በጽኑ
ጉዞዋችንን : ገንዘቡን ኢንተርፕራይዙም በተከሳሹ የመሆን አቶ
ከተማዋ : ሽር ባለው የተሳሳተ ብዙ ታላላቅ
ዙሪያ : በተስተካከለና ለመከላከልም ነፃ ባለ አኳያ
እየገጠመ : ለሥዕሎቿ ከተማ ኃላፊነት የሚዲያና የወጣው
የተመለከትንላት : እያሉት በማቅረብ የሚመሩት ይመራ የሚገኘው
የተባለውን : ኤክስፐርቶች ማዕረግና እኔ ሳያገኙ ችሎታ
ማርኮ : የኔቢጤ ያደረጉ ማግኘት ችሎታ በበቂ
ንጽህና : ኢንተርፕራይዙም የቅርብ ስትለምን ወዳጅ ብለው
አናቆሽሽ : ተባበሩኝ የፖስተሪቲ ማኔጀር ወንድሞቻችን ብዙ
ደረሰን : የለውም ተማጽነዋል አቅርበዋል ቀርተዋል
ብርቅ : ድጋፍ የአካል በኢትዮጵያውያን የተመራው ብዙ
የሚገልጽ : የኔቢጤ በበቂ የሚገኘው ታላላቅ ሆቴሎች
ዘመናዊነትን : ትራፊኮችንና ሆነብኝና እንዲከብድ አዳዲስና ለመሣል
እስኪዘልቅ : ቅዳጅ በኋላ ደረጃ ሆቴል ያሉትን
መዓዛ : የተለያየ መተካት የሚዲያ ችሎታ ግን
ለመቅረፍ : ተሞክሯቸውን ሲሏት ሁሉም የኢትዮጵያ ተቋም
ጀንበር : በቤተ እንደዋዛ ስኬፕ የሚዲያ ምክንያቱም
ይዘን : ካለን ሁሉም እንዳለባቸው ላይ ብዙ
እንዳለች : በእሳት ሳይቀሩ ክፍል በኋላ ቆም
አደረግን : ይቀናል ዘፈኖች የሠራተኛ ሌግዠሪ ቀርተዋል
የደረሰው : ያደረገ በራሳችን ምኞት ማኅበራት የተመራው
ለአፍንጫችን : ሰውዬው ባነጋገርናት ገልጸዋል አስተሳሰብ ቀርተዋል
አለመሆኑንም : እንደማይጠይቅ ዘመናዊነታችን ከሦስት ከሆነ ምን
እያለን : ገጽታ ጉዳዩ መመራታቸው ሁኔታ ከሚገኙት
አፍንጫችን : ልታደርገው ስም ከዕለት ዘወትር ፕሮግራም
መንገዳችንን : ካለሁት ስለተባለ አስተዋጽኦ የተመራው ከሚገኙት
ሁላችንንም : የሚወስድ በኢትዮጵያ ዓላማ ኮሚቴ ብዙ
የሚገመትባቸው : ጊዜያት ሳትሆን የፀደቀውን አስፈላጊነቱንም ሕፃናት
የድሬ : ይዘነጋና እየገፈተሩ ክርክር አሉታዊ ወላጆቻቸውን
ለድሬ : በመገናኘት የሕገ የከተማን እንደሚያስቸግር መሪዎችን
ቀርቶ : የተነሳ ዜናዊ የተረሱና ባለው ሆቴሎች
የተመለከትኩት : ከሐሳብ እንዳለበት ይደበድባት ምስለ የመሥራት
ለውስጥ : ፖለቲካዊ ተዳዳሪዎች አንድ ወንድሞቻችን ብዙ
የሚደረገውን : ሚዲያ አካላት ማኔጀር መዘንጋት ሆቴሎች
ሥፍራዎችዋ : እንዲያካትቱ መዘንጋት አስተሳሰብ ቀርተዋል
ማሰኘቱ : አስተኝታው ጎን ናቸው ያሉትን የሚያሳዝንና
ብዬ : በመለወጡ ግብዓት በብርሃኑ ሳይሆን የሚዲያና
የውስጥ : ከድህነት የታወቀ የሚወስዱት የምወደድን ድንጋይ
የቻልኩትን : ሙዚቃው ድንጋይ ወንድሞቻችን ቀርተዋል
እንግዳ : በዘጠኝ በጠባብ ወቅት አድሰው የዕርዳታ
የድሬን : ሰፊ ለአካል የሚገኘው ታላላቅ ሆቴሎች
የተመለከትኩትና : አጠገቤ እህል ታደሰ እንዳሉ ኢንተርናሽናል
ጽዳት : ሬት አነስተኛ አነጋግሬ ሰነድ ያስተዋወቁ
መንገዶች : ሸማቾችን ዓላማ የሚለውን ተጠቃሚነትና የተመራው
ሳይተጓጎል : ሀቆችን የብድር መጠነኛ ውጤት ማምጣት
አይቀርም : የሚሸጥ ጉዞው ሁሉንም ማታ ለሁለት
አጀብ : የአውሮፕላኑን ከተለያዩ ተጠቃሚ ሚኒስቴር አለባቸው
ለመጀመሪያ : በኢኮኖሚ ሌላ መኖር እየታገዘች ድንጋይ
ንፁኾች : ከጊምቢ ሠራሽ እንዳልዘነጋሁ አናሳ ኩባንያዎች
ቃኘሁ : ተቆጥሯል አይመለከትም ትናገራለች አትመስልም ተቋቋመ
የገበያ : በሌላ ይደበድባት የሚዲያ አቶ ምክንያቱም
ሲነፃፀር : በማስገባት አይደሉም ተስፋ አቅርበዋል ተደራሽነት
ያስገርማል : ነበራቸው የሚጎዳና ይቻላል ተለያዩ አላቸው
ይሆኑ : ይኖሩበት ባለድርሻ የሥራ ዜናዊ ብቃትና
በመጀመሪያው : ካለፈው ለሦስት ሲያርፉ በተለይ የሚዲያ
ድሬን : ልጆችም የሚመለከታቸው ወጥቶና ስለእመብርሃን በድሬዎች
ስላስገረመኝ : እስከሚያመጣ መስፋፋት ሞላ ቅባ መስመር
እየተዘዋወርኩ : ታድገዋል ታሰፍራቸዋለች ክፍተት ባለሙያዎች ሌግዠሪ
ያገኘና : የቅጣት በስቱዲዮ ከዕለት ገልጸው በኢትዮጵያውያን
ሕዝብ : አቅጣጫውን ድጋፍና የሚለውን አንድ ወንድሞቻችን
የሚገኝባቸውና : የአእምሮ አንዳንዴም ፈለቀ ምንድነው አመለካከት
አግራሞት : ያለወትሮው በኢኮኖሚ እኩለለሊት ጉዳተኞችን ውስጥ
በመጓጓት : እንዲህ ዓመቱም ካነጋገርናቸው በዲጄ በምትኩ
አልገምትም : ይበዛል መለሰልኝ ይሻላል ትሸጣለች አያጣውም
ተመልክቶ : ይህንኑ ማክበጃ ቁሳቁስ ተጠቃሚነታቸውን የኢትዮጵያ
የሚደረገው : ከአባቱ ይጫወት የሕዝቡ ጆን የጀመረው
ላይገረም : በመነሻ መጠበቅ እንደወትሮዋ በኋላ የሚገኙ
ይችላሉ : ነግረውናል ተፈጥሯል በዲጄነት ፎቶ ቤቱ
ሊመነጭባቸው : ተከሳሽ ክፍል ወይም በነጮች በበቂ
መንገዶችዋስ : ጉስቁልና ቅባ አንድ ወንድሞቻችን ብዙ
በድሬ : ተሽከርካሪዎች መስፋፋቱን ወንድሞቻችን የሚችሉ ከተመራ
እንዳይታይባቸው : መረጃውን በቅርብ እና ቸርቻሪዎችና ረገድ
የእኔ : ሽልማቱንም ሁለንተናዊ ጋና ተነስታ መሥሪያ
የመቀጠሉ : መሆኗን ከመሆኑ የፒያሳ መሀል ሁሉም
ባህል : በፖለቲካዊ የሚያመች ከጎኗ የሚለውንና ማስፋፊያ
በሠራተኞቹ : ሴቶች የግል የሚለውን የኢትዮጵያ አካል
የቆየ : ዮሴፍ ይኖሩበት አኳያ የተረሱና ብዙ
ያጸዳሉ : ታትመውለታል ይጽዱ ገዛች ሰብረናል በውስጣችን
ጠንካራ : ባረባው የሮማው ለማቃናት ምርጥ ያተረፈ
ነጋዴዎችና : ወጥታ የተቀመጠችው ተጠቃሚነትና እንዳሉ ምክንያቱም
የመንገድ : በተከሳሹ ጉዳዮቹ ለሷና ከባለቤቷ ከዚህ
አቧራ : ትለዋለች ከሱ የሚዲያ እነዚህም ግን
ነግረውኛል : ጽፈዋል ገጠመው ገዛች አልቻለችም አስተሳሰብ
አስተዳደር : ትንኝ በእስልምና የሚያንፀባርቁ እንኳን የማኅበራዊ
ሳይቀሩ : በሙያው ወይም ደረጃ በበቂ አስተሳሰብ
የከተማው : ጀምረውት ሙያ አመለካከት አስተሳሰብ ቀርተዋል
ያለበት : በተካሄደው ስፖንሰር አክስቷ ወይም ምንድነው
ላካፍል : ይቀናል ከሚባል ተበራክተዋል ወጣት አልቆዩም
አጠባበቁዋ : አቀናጅቶ ተደራሽነት አስተሳሰብ ቀርተዋል
ላየ : በተለይም መረጃዎችን ዝግጅትን ግራፊክስ በኢትዮጵያውያን
ያዳበሩት : ለፖለቲካና ፎቶ አቅርበዋል የሚያስችል አስተሳሰብ
ከዚሁ : በነገራችን በሰጠው ተጠያቂነት ጉዳተኞችን አዋርድ
ይመቻችሁ : ሙስናን የምንለውን ከአዳዲስ የሚሰራጩ ቀለምና
ስለመሆኑም : አሮን እየዳጎሰ የሚያጫውታቸውን ለልመና ክፍተት
የከተማዋን : ተፈጥሯዊ የቆየ ዕፅና ሆኜ ባለ
ነዋሪዎች : ክንድ ማቅረቢያ ይዘው ችግሩን የኢትዮጵያ
በማርከፍከፍ : በተጨባጭ በዛሬው የተገመቱት አልገናኝ ከሚያሰማው
አየሃት : አስታኮ ሜትሮፖሊታንን ፎቶግራፋቸውን አስተሳሰብ ቀርተዋል
ተገንዝቤያለሁ : ሰጥቷል ይገባቸዋል አያጣውም አቅርበዋል የሚመሩት
ልምድ : እየተጉላሉ የዛሬን የሚኮረኩሩ ጎልማሳ በበቂ
መዝለቁን : የምለው የተመቸ እያነጋገረ እጥፍ ክፍተት
ሊባሉ : ጳጳስ ሐሙስ ዜናዎች እንዲሆን የሚያሳዝንና
ይህንኑ : ተመልክቶ ማክበጃ ሥር ተጠቃሚነታቸውን ተደራሽነት
ለማሳያ : ድርጊትም መንግሥቱ ምሁራን በሕፃናት የመሥራት
ካረፍንበት : ይደጉማት አንዳንዴም ፈለቀ ዴረሳ ኢንተርናሽናል
አቦ : ምክንያቱ ዝግጅቷ ወደመሸጥ ፍላጎት ዘንድ
ይቀናል : ላካፍል አደረግን አትሉም ከሚባል በየጣቢያው
የገጠመኝን : እንዲቀዩ እንደሚቻልና መንገድ መሀል የመገናኛ
ድሬዎች : ኃላፊነት የማኅበራዊና ዳይሬክቶሬት ዓላማ ባለሥልጣን
የተረዳሁት : መንፈሳዊና እንዲካሄድ የማኅበራዊና የሚዲያና ውስጥ
ልምዳቸውን : የማስተርስ የምወደድን ቅዳጅ መጠነኛ ድንጋዩ
ቦታቸውን : መረጃውን ለአድማጮች አስፈላጊነቱንም ለመጋበዝ ገፀ
በድሬዎች : እንደተጀመረ ክርክሩን ድሬዳዋ ለልመና ሊሆኑ
አካባቢም : ይግባኝ ላጠና በዛቻ ልመና ሲይዝ
የሰደደ : አነጋጋሪ ከአዲስ የመጣ ኢትዮጵያውያን የሚገኘው
የሚከላከሉበትን : ቢባልም ያላገናዘበ አቁማ ወደተባለ የጎዳናዋ
ቢባል : ፖለቲካዊ ስኬት ክፍተቶች የሚቃኙ ማኔጀር
ከሚያጸዳው : አድሚንስትሬሽን ክፍል ሲሠሩ ኮሚቴውን በበቂ
ተመስጋኝ : የምርጫ እስከተቻለ የሥልጣኔ የጽሑፍ ለየምሥራች
ይገባል : አያዳግታቸውም መንገዱን ዜናዎች በሕይወት ግርግር
አካባቢያቸውንና : ይፋ አንደኛው አገልጋዮች በፕሮጀክቱ ስለምንም
አነጋግሬ : በማስተዋወቅ የአካል በኢትዮጵያውያን ታላላቅ ቀርተዋል
ከቆሻሻ : ለማን የሚታይበት እንዲወጡ እንዲሆን የሚያሳዝንና
ከሚገልጽቸው : ሲያርፉ ቆም ገልጸዋል ደግሞ የሚዲያ
ነዋሪዎችን : ሸቀጥ የግል ጉዳተኞችን ወንድሞቻችን ብዙ
ቢለኝም : ማቅረባቸውን ያልወገነና ያውካል ሁሉም ያለዎት
ማስቲካዋን : በብርሃኑ ነገር ምክንያቱም ብዙ ታላላቅ
የማስቲካ : ለኢትዮጵያና ላይና በምትማርበት ልማት ሁኔታ
ይጠርጋል : ይስማማበታል ሰጥቷል ይገባቸዋል አያጣውም አይደሉም
ከውስጡ : አንደበት ፖሊስ መረጣ ኢትዮጵያ ዜናዊ
እየከፍትኩት : ከገባ ያልተከተለና ካፒታል የማዘጋጀት ገልጸው
ዓይን : እስኪያልቁ ከተዋወቀችው በመንግሥትና ውጤት ምንድነው
ማስቲካውን : ይህንን የሚወስንበት አድማጭ በረሃብ የሚዲያ
ወደዚህ : ይገኛል በመከታተል ገልጸዋል ኃላፊነትና አቀናጅቶ
ማስቲካ : የሚነግዱ ተቋማቱ መመራታቸው ውጤት በወርልድ
የሚጣለውን : በስተመጨረሻ ተቀምጣ ከጥቂት በዚህ አብዛኞቹ
በዚያች : ዕውቁ አቪዬሽን የተከሳሹን እርግዝናዋ ብለው
ትዕዛዝ : ስም ወንድሞቻችን ይህ ብዙ ታላላቅ
ቀረብ : ተመስገን ጅምሮች ብቃትና መካከል ከተመራ
አውጥቼ : አፈጻጸምና አስቀምጣ መመራታቸው የተሳሳተ የሚያሳዝንና
ሽፋን : እንዲቀዩ በጥንቃቄ ከፊል የመገናኛ በኢትዮጵያውያን
ሶፍት : የማይፈታ በቅጣት ከሚገኙት መመራት ታላላቅ
የሚሸጥ : አይቀርም ጉዞው ከሚዲያው ዳይሬክቶሬት ማኔጀር
ከአንዱ : በቤተሰብ ቤቷን የጎዳናዋ ነገር ምክንያቱም
ጠየቀኩት : ፈጸምኩ ዋለች ነበር ቤቱ ቀርተዋል
ካልሲና : ሰጪ ሃምሳ ኢንተርፕራይዙ ጣልቃ ከተለያዩ
ሆነብኝና : ዘመናዊነትን አዳዲስና ባለፈ እንዲሆን መዘንጋት
ከተቀበለኝ : ችግሮችን ካረፈ ለማሟላት አለባቸው አዲስ
ባኬት : ሁነኛ ቤቱ ሁኔታ ኢትዮጵያውያን መመራት
ከፍቼ : የግጥም የሦስት ከሚያዘወትሩ የሚያመች ጎልማሳ
ዛፍ : አብዮት ሰባት አመለካከት አስተሳሰብ ቀርተዋል
እንደተቀበለኝ : የፍርድ ዲጄዎቹ ለልጇ አቶ ትርፋማ
ተይዛለች : አላቸው ከተመራ ቀርተዋል
ወጣቱ : ፅኑ በወጣ የዘገበ ዘመቻ መሆኑ
አነስተኛ : የምርጫ መርሐ እርሳስ የግል ማኅበራዊ
የወጣቱ : ከመጀመሩ አስቀምጣ ጉዳተኞች የሚችሉ የሚገኘው
ጥላ : በተለያየ ችግሩን የማድረግ ቀርተዋል
እዚያው : ከጥቅሞቹም ማንና ንሳ የሚወስንበት ራፐር
ሶፍትና : ማረፉን ከኅብረት የመንግሥት መመራት እላለሁ
የማስቲካውን : ይህንንም ተቋም ችግር ሁኔታ ሆቴሎች
አልተነሳም : ታኅሣሥ ስለነበረም አብርሯል ይመረኮዛል በዲጄነት
የሥራው : ፍልስፍናና ከታሸገበት የአዲስ ጥሪ ተጠቃሚ
የዛፍ : የወርልድ መርሆዎችና አዳዲስና የጽዳት እንደሌለበት
ፈጸምኩ : ጠየቀኩት ነበር ቀርተዋል
ብለን : በይሉኝታ ከሐሳብ ሲያርፉ በተለይ ሳይሆን
አርከፍክፎበታል : የተቀጠረው መለሰልኝ መጥቷል ዋለች ተሸፍነዋል
ሲጋራ : ተወካዮችን ችግር መምራትና የሚያሳዝንና አስተሳሰብ
አጠገብ : ፔንሲልቫኒያ ፈጣን አምሐ በማመንጨት በጎራዴ
በንጽሕና : መቅረፅ ማጀቢያ አስተኝታው የኢኮኖሚ የሚያሳፍርም
ግር : ነባራዊ ይጫወት ሰዓቱ ገልጾ መልኩ
ባልደረባዬ : እንደሚሆን ማስተር ተዳዳሪዎች ማኔጀር ወንድሞቻችን
እንደጨርስኩ : በሳምንት በወርልድ ወንድሞቻችን ያሉትን ብዙ
ገዛነው : ነበረብኝ ተሸፍነዋል እላለሁ አስተሳሰብ ቀርተዋል
የመሳሰሉትን : የታወቁ ያሉትን እላለሁ ነው አስተሳሰብ
ተቀበለኝ : ሞልተዋል ይቻላል የተሣለውን ሚኒስቴር ቀርተዋል
ጫማም : የወርልድ ሥርጭት ቢቃኙ እርሳስ ፍላጎት
የወጣቱን : ባለአክሲዮኖች ሥራ ከእጅ ወላጆቻቸውን የሚገኘው
የተቆጣጠራት : ይደጉማት የተመረኮዘ ደግሞ ዜናዊ ሆቴሎች
በአነስተኛ : ግቧን የመሰሉ የምታሟላበት ከወረቀቱ ሕጎች
እስክጨርስ : ሄዶ የቆሙትን ንጉሡ በሱዳን የሚያደርግ
ምክንያቱን : ሊያስረዱን ይበጅ ጭምር ጉዳይ በጥምረት
ሆነን : ድሬ ምርቶችን ሥላ ትሠራ ባለድርሻ
አንጣው : አስተሳሰብ ቀርተዋል
ለምን : ካቀደው መረዳት ብሮድካስቲንግ ቀርተዋል
ያልተለመደ : የሳንሱር ሳልደክም ዳግማዊ ዓመቷ ነገር
ከታሸገበት : መሠረትም ወቅት ከምሽቱ ሥዕሎቿ ጥሪ
ዙሪያዋን : መጠን የተፈጠረውን መስማቷን እያከራየች ወላጆቻቸውን
ለመከላከልም : ዙሪያ ነፃ አኳያ አሸናፊ ከሚገኙት
ሳጥን : የሚጠየፍና ለባለሀብቱ ገደማ ብዙኃን መመራት
ካለሁት : መንገዳችንን ከገቡበት ጥንቃቄ እየተዘዋወረች ማኅበራት
ጫት : ይደጉማት ዜናዊ የተረሱና አበባ እንዳሉ
በርካታ : የምዕራባውያን ከቴክኖሎጂ ዓለም እንደሆነ መምራትና
ያሉባት : የጤንነት ቁጥራቸው ከትምህርት ባሕሪው ውጤት
ይታወቃል : የሚቀበሉት አጠፋሁ ከሠራች ሰብረናል የሚል
ከሚጠቀሱት : በሚታትር ቀፍድደው ጥግ ኢትዮጵያ በአገር
ጫትና : በመሠረቱ በሠለጠነው ይላል የቅርብ ወዳጅ
የፍቅር : እንዲደረግለት ጎን የሚያስችል እንዲሆን መዘንጋት
ገረባ : ኩባንያዎች ባለሙያዎች ከተመራ ቀርተዋል
አኖረው : ተበራክተዋል ይሰጧታል ጀመረች ድንጋይ ነው
ስለመሆንዋ : አፋቸው ሐሳብ ደግሞ ሆቴሎች አስተሳሰብ
አካባቢን : አምስቱ በምትኩ የተረሱና መካከል ብዙ
ካስቀመጠው : አጠቃላይ መርምሮ መጨመር ለአማተሮች ከበዋት
ልዩነቱ : ቆጠራ ማስፋፊያ ታላላቅ ሆቴሎች አስተሳሰብ
እዚህ : የቆሙትን እውቅና ውጤት በኢንተርናሽናል የሚያሳዝንና
በማቆሸሽና : ከተሞችን ለአድማጭ አመለካከት ሆቴሎች አስተሳሰብ
መገለጫዋም : እውነት ማሳያ ኢትዮጵያውያን የሚያሳፍርም ነጥብ
ተምሳሌትም : ሥዕሎች ትልቅ ማኔጀር ላይ የተሳሳተ
እናነጻጽር : በሌሎች ሽጭልን የሳንባ ቤቱ የሚል
የፀዱ : የተመቸ ብትመለከት ሊሞላት የተመራው ከተመራ
ማጠራቀሚያ : የሚያሳስቡ በሸገር በውስጣችን ችሎታ በበቂ
በማመንጨት : ፈጣን አጠገብ ጽሑፍ ከተዋወቀችው ክፍል
የተቀበለኝን : ሜሮን ሳይወጠሩና ሳይሰጥ ቀኑን እንደሆነ
ጣሳ : ብርሃነየሱስ ማፅናቱ የራሳቸው ከማጽዳት አብራሪ
በአንዳንድ : በሌላ አቶ አለበት መምራትና መመራት
መንደሮችን : ማስፈራራት ልጆቻቸውን ለሰኞ ጣሉልኝ በሠራተኞቹ
ከተሞች : ነበርም ክርክር ከሚሞት ባለድርሻ ከሚገኙት
እኔ : ይዳስስ የምትቆጠር ሁሉ ብሮድካስቲንግ ሳያገኙ
የጫት : በቦርዱ ማስተር መርሐ ሊሆኑ ጉዳይ
ምንና : በሚያሳዝን የደረሰበት በሕግ ኑሮ የአምስት
የምድር : ብሮድካስት ጥብቅ ይዳስሳል ባለሙያዎች ወንድሞቻችን
ቆሻሻን : በተጨባጭ አልገናኝ እናንተ እንዲታይ ተወግዶ
ብትሉ : የበረራ ቅባ ኃላፊነት ባለሥልጣን ብዙ
ከሁሉም : ሎሬት በላስቲክ ወንድ መምራትና በበቂ
ከጎኑ : አጠገቧ ከሚመለከታቸው እንዳሉ መዘንጋት ሆቴሎች
የድሬዎች : ተከሳሹ በአዲስ አብዛኞቹ ምክንያቱም ታላላቅ
እንዳትጥለው : ጉርምስና ፖለቲካዊ ለልመና እንዲሁም ተደራሽነት
ሳትሆን : የቀበሌና እንዳይኖረው እንዳደረገላቸው ለሥዕል እንዳጋጠማት
የሚገኝባትና : ለማቃናት ስለመሆንዋ ምርቶችን ለአድማጭ ሐሳብ
ልንመሰክርላት : ሊባል እሳቸውን መሥራቷ በሕይወት እንደሌለበት
የሰማይና : ፍርደኞቹ እንደሌለበት ውጤት እንዲሆን መመራት
የአገራችን : ናቸው ውስጥ በወርልድ ያሉትን እንዲሆን
በጎ : አድራሻቸው አስፈጻሚ በዚህ ታላላቅ አስተሳሰብ
ተግብረውታል : ያሳጣል ተፈትሸዋል በግል ሰብረናል እላለሁ
ቢተገብሩት : በመሆንም አነጋጋሪ አቅርቦ ችሎታ ኢትዮጵያውያን
ከተሞችም : ሥርዓቱና የመጡ ተቀጥራ ሲሠሩ ተወካዮችን
የኮብል : የገለጸች ኦስተን ባለሁበት በቁጣ በኢትዮጵያውያን
ንፁህ : እየተዘዋወረች በቶሎ ነጥብ መካከል ከተመራ
እንደምሳሌ : እንደሞላ በኮፒ ለሥዕል ናቸው ማኔጀር
በከተማቸው : የለብለብና ናቸው ውጤት ታላላቅ ሆቴሎች
የከተሞች : ሆቴሉን በውሳኔው ሠሌዳ ጉዳተኞች ደረጃ
መውሰድ : ሊያስረዱን የሚያህላቸው ምክንያቱን ጉዳይ በጥምረት
በማካፈል : ልዩ መረበሽ ከባለቤቷ ሕፃናት የሚቃኙ
ላስታውስ : ሲጣጣሩ ፎረም ነጥብ መካከል ብዙ
ነበረች : ያብራራል ይሰጧታል ትመለከታለች ቀርተዋል
እዚያ : በድጋሚ ለማበረታታት ቤት ተጠቃሚነታቸውን የሚመሩት
እንዲኖረን : እንደሆነ የሚያሳዝንና መመራት ሆቴሎች አስተሳሰብ
ዘላቂ : የኳታር እንዲሰማቸው ተለወጠ መርጠው ባለሥልጣን
ኃላፊነቱን : ብትሉ የበረራ ሲሏት የተመራው ከተመራ
እያንዳንዱ : ተሳቃ ጉዳተኞች የወጣው ላይ መካከል
ስቶን : ከባንኮች አብረውት የሚገነባ ተለወጠ ከጎኗ
የሠለጠነ : ስትይዝ በመከተል ባደረገበት በመቻሏ ቁጥር
ጀምረውት : የከተማው የሰነድ ዕፅና ሊስትሮዎች ከምትደረድራቸው
ያሰኛል : የለመኑትን ከዚህም ያምናል በአዲስ ነገር
ማስረጽ : አስበን በእርሱ ሥራቸውን ብር ክፍተቶች
ነች : አረጋግጠዋል ያመቻቻል መረጃ አለባቸው ቀርተዋል
የተወሰነ : የፍልስፍናና የቦርዱን በላይ የአንድ ሲደገፍ
ዘየን : ከአዳዲስ የሚሰራጩ ባጠቃላይ በካርቶን ከምትደረድራቸው
ለሌላው : ሸምድዶ በወረርሽኙ ያወጣላቸው ቤቢ ሬዲዮ
አዳማዎችን : የሆነ ስላለ ፖለቲካዊ ቅር ሁሉም
በመገንዘብ : በተጨባጭ ያውም ስለመሸ የመፍጠር በመለወጡ
የምትቆጠር : ወክዬአቸው ሳያገኙ ችሎታ ከተመራ ታላላቅ
ጽዱ : መሪዎች ሀቆችን ጠብቆ እንደሰጠ በካርቶን
የአኗኗር : ባለሥልጣን የተቋቋመው መመራታቸው በወርልድ ላይ
በኮብል : ያልተጠበቀ የታወቁ መሥሪያ የሠራተኛና ከሚገኙት
ሊታሰብበት : ስንታየሁ መዘንጋት ታላላቅ አስተሳሰብ ቀርተዋል
የታየው : ቆይቷል በቁጥር ባለው አዲስ *
ከተማን : ሕግጋት የተላኩበትን የጽሑፍ ለየምሥራች ጉዳተኞችን
ያደረጉበትን : በሕይወቷ ጠብቀው የኢኮኖሚ መተካት ደረጃ
ወገን : ማድረግና የመንገዱ ምቹ የሚለውን የአካል
ለሌሎች : ማስተዋወቅና ሁለት ሦስት ተቀምጣ በስሱ
ምናለ : ተወስኖባቸዋል ይገባቸዋል የሚገባው ትመለከታለች ይሆናል
ልንገነዘብ : ለመመረጥ ጠበቃው ይለያል በብዛት እጥፍ
ከማለት : የጎላ ለኢንቨስትመንቱ ተደማጭነታቸውን የመረጃ ተወካዮችን
የከተማን : ሊስትሮዎች እርሳስ ወንድሞቻችን ብዙ አስተሳሰብ
እኔስ : ከሚገኙ ጠቅላላ ትርጉም መተላለፊያው ጥሪ
ሲከሰት : በማስዋብ መንገድ መስመር ዓላማ የሚዲያና
መጥረጊያ : መምጣት ተመራጭ ባይገፋም ቤት የኢኮኖሚ
አድርጌያለሁ : አረዳድ ያችኛዋ በተዛባ ይጀምራሉ መሆን
ቢያንስ : #ዎቹ በእነዚሁ የኤፍኤም በሬዲዮ የተማረችውና
መውደቅ : ቴክኒካዊ ቆጥረው በጠዋት ሊጣልበት እንደጀመረች
የቆሻሻ : ከታች ለእኛ በሚጋጩበት ተጠያቂነት ይመራ
ከማጽዳት : መልክ ለመንግሥት ያዋሉ ቢኖሩም አመለካከት
ዜጋ : የመናገር የመሥራት ኮሚቴ ከተመራ የተሳሳተ
የትም : የያዟቸው ይገባል እንደሚሆኑ በኢንተርናሽናል እንዲሆን
የሚጠይቅ : ያደንቁታል ከጀመሩ ይጠብቃቸዋል ተለያዩ ጥር
አይደለችም : ግድግዳና ከጥቂት ለፊት ጀምበር መመራታቸው
እያበላሸ : እንደተናገረው ብታገኘም የመገናኛ ከተመራ ቀርተዋል
የሚወተውት : የማይሠራውን የሚችለውን በደልኳችሁ ያላስረዳ ጥበባዊ
የሁሉንም : ያፈሳል በገጠሩም ከነዚህ አሁን ማንኛውም
ይጣላል : አቅርቧል ወሰኑ ቀርተዋል
ሲባል : ወዳጅዋ አንዳንዴም ሽልማቱ ምንድነው ዜናዊ
እንዳይሆን : እያቀያየርን ለመፍታት ይመራ ውጤት የሚችሉ
ውጡ : የማይነጣጠል በሕግ የአምስት መንግሥቱና ተፈጻሚነት
አወጋገድ : በእሳት ያስቀርባል የሥነ ቤት ቆም
የምንለውን : ስትዘዋወሩ ይመቻችሁ ተሞክሮ የሚሰራጩ የሚያመች
የሌለበት : የተያያዘ ተስኗት በሕገ ተጠቃሚነትና ብዙ
ለማስወገድ : ቀፍድደው የተሻረውን የሚያልፉበትን ዘይትና ቤት
ማለት : ፕሬዚዳንትነትን በሚገኝ ሞዴል እየረገጠ ጥላ
ባለመሆን : ባላጡ ይዞታ ተራ ጥፋተኞች የማዘጋጀት
ባትችሉ : ለሊብራል እንዲቆይ በመጠኑ ተሥለው የሚያስችል
ሁኑ : ሲሠሩ በነጮች በበቂ ታላላቅ ሆቴሎች
ቢጀመር : ማስጨበጫዎች የአየር ቅባ የማኅበራዊና ከተመራ
አልደረሰም : የሚመደብ ያተኩራሉ ይዳስሳል ወሰኑ ዕድሜ
እንዲመነጭ : ይለኛል ምናልባት እንደሚጓዙበት ከጀመረች ግርግሩ
እንደፈለገ : ያየህ ኧረ መያዝ ሥራዎቿን እንደሚኖርበት
እንደሚኖው : አገሮችና ጩታ ለጉባዔው ለተበዳሪዎች በማድረግ
ከራስ : መቀለጃ ዕለት ፍላጎት ከሚዲያው እንዲሆን
ከድሬዎች : መንግሥትንና ቃል እስረኛ ሌሎችን ዝግጅት
ማሰብ : ይበር እግዚአብሔር ማንኛውም በዚህ ሆቴሎች
የሚፈለገው : በምን አንዳንዴ በካርቶን ክፍል ቢጤዎች
የለም : ከማቅረብ ኃላፊዎችና በጠዋት ውሳኔ ትመለሳለች
ጠንከራ : መጨረሻ እየዳጎሰ አንዱ ትላለች ይደበድባት
ያስፈልጋል : ተቀጥተዋል ስታስረዳ በማታው አንዳንዴም ምንድነው
ማጽዳት : የመንግሥት ተፈጻሚነት አለበት አመለካከት መመራት
እንገነዘባለን : የሚያውቁት አገናኘው ይገልጻል ሰብረናል አላቸው
እንድትሆን : ክፍለ ለዚህ እንዲሆኑ የመረጠ መሥሪያ
ተባባሪ : በሙያው በበቂ አዲስ አስተሳሰብ ቀርተዋል
የሚጀምር : የመጣ እያጠራቀመች ትሠራ ችሎታ ኢትዮጵያውያን
ለመገንዘብ : የተስማሙበት ሊሞላት የተወሰኑ መቀረፍ ሳያገኙ
ይዛችሁ : ተዓማኒነትን ሰዎቹ የፒያሳ ኤሌክትሪክ የሚያስችል
እንችላለን : ይከብደኛል ቀርተዋል
አይመለከትም : እንዲሁ ቃኘሁ ትታወቃለች ተቋቋመ ቀርተዋል
ተነሳሽነት : ዘገባ ተመስጋኝ ድንጋይ አቅም ጉዳተኞችን
ኅብረተሰቡ : በመሆኑ በሰዓታት ሥዕል ጊዜ ሁሉም
መጣያ : ግብሩ በሙያው በበቂ ሆቴሎች አስተሳሰብ
ግንዛቤ : አሰብ ኃላፊነት የመገናኛ ማኔጀር የሚያሳፍርም
የማይባሉ : ፌቴክ ከሚባሉ ተወርዋሪ ተቆጣጥሮ ሰዎች
ደጋግሞ : ኮሚቴ ችሎታ ይህ አመለካከት ከተመራ
የተሰማሩትን : ይመስል ከባህር እንደሚያስቸግር በነበረበት ተደራሽ
እንዲኖረው : እንደምሳሌ የሙዚቃ የሚነግዱ ናቸው የሚያስችል
በመሆናቸው : ሽፋኖች ልምዳቸውን ለስለስ የሚመሩት ውጤት
ማስጨበጫዎች : ኃላፊነት ቢጤዎች ግንባታ በወርልድ መመራት
ማስተማር : ለልመና ሊሆኑ ባለሙያዎች አስተያየት መዘንጋት
ያሻል : ይጠበቃል በሸገር ትለማመዳለች ተለያዩ ትሥላለች
ቦታዎች : ጎረምሳ ከሙያ ደረጃ ያሉትን ይህ
መቅጣት : ማስገቢያ በሰዎች የፖስተሪቲ ሥዕል ኤሌክትሪክ
እሻለሁ : የቆለሉት ትመኛለች ትወጣለች ተናግረዋል ደረጃ
ባለፈው : ቀናት በመነሳት ከእጅ ተናግረዋል ለፊት
ማስጨበጫ : ይዛችኋል ሌላም ኮሚቴ ማኔጀር የለበትም
ከተከለሉ : እንዲተባበሯት ወንድ የመንግሥት ምን የሥራ
ያለን : ይመቻችሁ በካርቶን ኮሚቴውን በጥምረት ደረጃ
ውጭ : በማስታወቁ ኮርፖሬት አዘውትረው ውጣ በኢንተርናሽናል
በግንዛቤ : በጨርቃ አገልግሎት ታሪክን ዜናዊ አበባ
እጅግ : ባለድርሻ አዲስ ይህ ከተመራ የተሳሳተ
አልመለስ : መካከልም ከሚያቀርቡ መሀል የኢትዮጵያ ከተመራ
የአካባቢ : ተዳዳሪዎችና ድጋፍና የሚያሳፍርም ወንድሞቻችን ከተመራ
ለቆሻሻ : አለማየት መቀበል ካለን ጥብቅ ጎልቶ
ደካማ : የበላይነት አቀርቅሮ ብር በሳምንት የሚዲያና
አውጥቶ : ለማወዳደር እስከ ችግሩን ታላላቅ አስተሳሰብ
ሕግጋት : የተላኩበትን አጋሮቹ የጽሑፍ ጉዳተኞችን ወንድሞቻችን
ከተሞችን : በማቆሸሽና የሚያመች መስማማት ባለድርሻ አመለካከት
ማድረግና : ወገን ከሙያ የግል ኃይል ድጋፍና
መጠየቅ : በዋናነት የሙስና የዳቦ የቻልኩትን ድጋሚ
ንጹህ : በአመለካከት እያጠማዘዘ ወደምትሠራበት ከጊዜ ካስረከቧት
አናሳ : ጨለቅለቃ ንፁኾች የሚሰጧትም ለማድረግ የሚያሳፍርም
እየተሠሩ : ሙቱ ሊሞዚን የማይመረምር ስለሚጠይቅና አቀናጅቶ
እንዳይጥል : በሚኔፖሊስ ስፖንሰር ስለምንም አዋርድ እንዲሆን
አወጋገድና : የሰጠው ቢነሳም ማሳካቱን በቀለ ያሳደጓት
የግንዛቤ : ተዘጋጅቶ ተመራጮች ለማስደመጥ በተጨማሪም ሲሏት
የሚሉበት : መሥርቶ ከብዶም ገቢም እንዲሁም አንድ
ለመታደግ : ከመድረሱ ያደረገና ልመና በኋላ ቤቱ
ግባ : ከፍተኛውን በቂ ቢጤዎች የኢኮኖሚ ግንባታ
በምክርና : አድልኦ ብሎ ስትለምን ሳይሆን አብዛኞቹ
ከተሞቹን : በንቃት ዲጄዋ እንዳትሥል የተረሱና መካከል
ገጠመኜን : ያህል አብዛኞቹ ሆቴሎች ነው አስተሳሰብ
የመጀመሪያው : የጠበቀ እንደሚላቸው ወገኖቼ አስደርጎ ወጣት
ሽፋኖች : ውጤት በወርልድ አስተሳሰብ ቀርተዋል
ያለባችሁ : እንዲቀይር የሚወሰዱ ባጠቃላይ እርሳስ ከሚዲያው
ተሽከርካሪ : የሠርግ የሚመላለሱ ፎረም ወንድሞቻችን መመራት
ከተማዋን : ተሽከርካሪዎች የሚለውን ወንድሞቻችን ይህ ከተመራ
የጀመረው : ገልጾ የተለየ ግን ባለው *
ጋይድ : አቀርቅሮ ኃላፊነት የሚዲያና የሚያሳፍርም የተሳሳተ
ብትሆኑም : የብድር ሊስትሮዎች ሠዓሊት የሚመላለሱ ስለዚህ
ማረፊያ : የሐሳብና ሥርዓቱ ዝግጅት ሲደገፍ ጀምበር
ሲል : ግለሰብ የሚሰብክና አፍንጫ ግብዓት ሴት
የሚያስጎበኘን : አጥኝዎች እንደሚካሄድ አብራሪ አብላጫውን መንገዱን
ቀጠለና : በተስተካከለና ከተፈጸመ ባለ ማሳያ ዓይነቱ
ጥብቅ : እንደሚካሄድ መርሐ የግል የሠራተኛ ፕሮግራም
ወደተዘጋጀልን : ቢመጥቅ ለማቃናት አንገታቸውን ከሚሞት የሥራ
ከሚባሉ : ቴክኖሎጂ የማይባሉ ከኅብረት መቅረት ዩኒቨርሲቲ
ክልክል : ገለልተኝነትን የማስተባበር ባለው ብዙ ታላላቅ
ብትገኙ : ምናለ ስታስረዳ በማታው ካጠናቀቀች ነው
የተከለከለ : ካሟላ የተገረመው በቀኝ ምስለ ከተመራ
ፈጽሞ : የላዛሪስት የልመና ያድርግ የአእምሮ አንዳንዴም
ለጣላችሁት : በቤት በተለያዩ የማወቅ እንደወትሮዋ የተወሰኑ
ስትዘዋወሩ : የምንለውን ከሌሎች የሚሰራጩ ከሚያዘወትሩ የሚያመች
ይዛችኋል : ማስጨበጫ ሌላም ኮሚቴ የለበትም ይህ
እንደደረስን : የአምባገነን የሐሰት ምንም የሚያደርግ ከሚገኙት
አስቀድሜ : አረጋግጠው እንደማይቀርም እየሆነ የሚያወያዩ በብዛት
ትከፍላላችሁ : ነጥብ እንዲሆን ኢንተርናሽናል ቀርተዋል
ሽፋንና : መከናወን ከመሞታቸው ተከራካሪና የተወችላት ተምራ
በየትኛውም : የተጻፉ በመተላለፍ ዘጠኝ ሐሳቧን ገቢ
ምርጥ : በአሁኑ ላይሰጥ ብልጭ መሆን ሆቴሎች
ስታጨሱ : ዘመናዊነታችን እንዳጋጠማት እንደሄደ እንዲተባበሯት እንደሚኖርበት
ማስቲካና : መካከል ኢንተርናሽናል ሆቴሎች ነው አስተሳሰብ
ደህና : አንዳንዱን የሚገነዘቡ ልንገነዘብ ይኖረዋል ኢኮኖሚያዊ
ስንገባ : ከፊታቸው ወ/ሮ ከሚያጫውቱ አይዳስሱም አንዳንዴ
ባልተገባ : የተሰነጣጠቁ ስልኳን የመንግሥት ተወካዮችን ከተመራ
ከዓለማችን : ተያያዥ በእስያም ከሚላቸው ሠዓሊ በኋላ
አንድዋ : በመለወጡ ግብዓት ባለው የተሳሳተ መመራት
ማጨሻ : ያለምንም እንደጀመረች የተነሳ ዜናዊ መካከል
ልንግራችሁ : የነበሩና በማናቸውም ትመኛለች ደህንነት አስተሳሰብ
ማጨስ : አስሮ የሚቃኙ ጀምበር ከሚገኙት ያለዎት
እንግዶች : የምትመገበው ወደ ወንድ ችግር መምራትና
ሲንጋፖር : በ#ኛው ከውጭ በሬዲዮ ለሷና ከወለደች
በሲንጋፖር : ስፖንሰሮችን እነዚህም የሚችሉ ብዙ ታላላቅ
ካደረጋችሁ : የሚመሩት ውጤት በወርልድ ቀርተዋል
ለሲጋራ : ለትራፊክና ደብዳቤያቸውና በጎዳናው ተስፋ ተቋም
ማሳሰቢያ : መትረየስ ምክንያትም ለማድረግ ባለሙያዎች አንድ
ከዚያም : ጊዜአቸውን እሷ በብርሃኑ እነዚህም ያለዎት
መጣችሁ : ጨምሮ ጥበባዊ የመሣልና ደህንነት ባሳተፈ
ወደሆነችው : ውጫዊ የእያንዳንዱን ዝግጅቶች ዲጄዋ እንደሆነ
ተጉዤ : እንደሚቃወም ለመረዳት ትከታተል ሲሔድ መንገደኞች
ከወዲሁ : ሁልጊዜም ከእሳቸው ምክንያቱም ብዙ ታላላቅ
ዶላር : የሴፕ በዩናይትድ በትዕዛዛቸው የብዙኃኑን ተወካዮችን
መሠረተ : ዝግጅቷ ሁለት የሌላት ከሚመለከታቸው የተነሳ
የሲንጋፖሩ : ሀብታም ከወዲሁ በፍጥነት ምክንያቱም ታላላቅ
ወጥቶ : እንደሚላቸው አስደርጎ አትመስልም ትባላለች አላቸው
ጎብኝዎች : ማቅረባቸውን ያላቸው ተመልሳ በሕገ ሁሉም
ዘመናዊነታችን : አለመሆኑንም ጉጉት ስፍራ እግዚአብሔር እንዳጋጠማት
ሕጎችም : አለን ማለፍ መዝለፍ ያዋሉ ዳይሬክቶሬት
የማስፈጸም : ማስጨበጫ እየዘከረ ሌላም የሠራተኛ የለበትም
በቅድሚያ : አባላት እንደሚሆኑ እንደነበር ክትትል የኢትዮጵያ
አቅሙ : መመርያው መልዕክቶችን አስፈላጊ በወቅቱ የኢትዮጵያ
አግዘዋታል : ቀይሯል አይደሉም ቀርተዋል
ከነዋሪዎችዋ : የተባሉት ለመቀበል እንደምትለው ፍቅር እየታገዘች
እናዳብር : ያክላል ያስደምጣል አልቆዩም ነው አስተሳሰብ
ልማቶችም : ሲለምን የሚሠሩ አክስቷ ገልጸዋል አቀናጅቶ
እንደተናገረው : እንዲነሳ እያበላሸ በመሆኑ ብታገኘም ታመራና
ይቆይና : በእንግሊዝ ሲኖሩ ተጠቃሚነታቸውን በማቅረብ የሚለውን
የሚቆጠሩ : በልጥጠው በመከታተል በሙሉ ክፍል ውጤት
አስታወሰን : ቆረጠ የተሰማ ታስተናግዳለች ተናግረዋል የሚል
ዋጋ : ያልኩት የሱ በፊት * የሚገኘው
አስችሏታል : ትገልጻለች ቀርተዋል
ማስፈለጋቸው : እየታየ አናሳ ክፍተት ለማድረግ ባለሙያዎች
ንጽህናዋ : እሷ በብርሃኑ ከጎኗ የሚዲያ አቶ
ከሁለት : ቀጥሎ የሮማው በስተመጨረሻ ሕይወቷ በተለይ
ይጽዱ : ይቀላቀላል አሳይቷል ያጸዳሉ ተማፀነች ኮፍያዋ
መሆኑንም : ሲላት ሊኖረው ስፍራ ሸማቾችን መሀል
እናሳይ : ሳይጨምር አስፍረዋል ያቀብላል ቤቱ ባሳተፈ
ባለመጣል : አስኪያጅ ሙሉ ሲሠሩ በበቂ አስተሳሰብ
በየዓመቱ : ጀምረው ያማከሉ ድጋፍ አክስቷ የተወሰኑ
የደከመ : ለማቃናት ትሠራ የተመራው ግን ከሚገኙት
የሚያስገነዝበን : በመጓጓት እንዲህ በስልክ በዲጄ የተረሱና
እንድታስተናግድ : ከጊምቢ ኮሚቴ ሳያገኙ ችሎታ ነጥብ
ሕጉ : ከሲመተ አፄ መመራታቸው ምክንያቱም ታላላቅ
ጨምሮ : መጣችሁ የመሣልና የመረጃ እንዲሆኑ ደህንነት
ልምዱን : ተብለው በጥምረት ውጤት ዜናዊ የተረሱና
በመተባበር : አዕምሮ ከሚገኙት መመራት የሚገኘው ታላላቅ
እየታየ : ማረጋገጥ ማስፈለጋቸው ቢሆን አገር ባለሙያዎች
በሚሊዮኖች : ሳይተጓጎል ውጤት ማምጣት በወርልድ ያሉትን
የመፍጠር : በመገንዘብ ከውስጡ በመለወጡ በተጨማሪም በአንድ
አስጎብኝ : ይለን የሙስና ከሄደ ለስለስ ግብዓቶች
የመነጨ : የምክር ብታገኘም ከተመራ ቀርተዋል
አካባቢያችንን : መሆኗን መፈጸሙን ከሚያቀርቡ ለመሣል መሀል
ካለን : ማቅረባቸውን ኤመርሰን ጎልቶ ሚና ለሥዕል
ንጽህናና : አያቶቼ ዛሬ አገሮች አስተሳሰብ ቀርተዋል
ለመድረስ : አገር ማን ለማድረግ የመገናኛ ኢትዮጵያውያን
ተባበሩኝ : አናቆሽሽ የፖስተሪቲ ተዳዳሪዎች ዓላማ ብዙ
ሃምሳ : ካልሲና በነጭ ጣልቃ ለአካል አስተዋጽኦ
እያጠማዘዘ : ይህንንም ንጹህ የማስቲካውን ከተጣለ ተቋም
መነሳት : መቼስ እንደመታች ሊያሳድጓት ኢትዮጵያውያን ከሚገኙት
የኔቢጤ : የሚገልጽ ማርኮ ያደረጉ ማግኘት ጎልማሳ
ስላሳዘነኝ : ሰባት ጽሑፎች ሰነዶች አመለካከት አስተሳሰብ
ጎበዝ : የማይቀርቡት ተፈጽሞባቸዋል የሚገዙ ገልጸው የሥራ
እየተጣራና : ሲያነበንብ የአፍሪካ የቡፌ በጭቃ ወደምትሠራበት
አድርጉልኝ : እውን ሌላው እንዲሁም ሆኖ የሚችሉ
ነበረብኝ : ዋለች ተሸፍነዋል ተናግረዋል የሚል እላለሁ
ስለእመብርሃን : ጣቢያዎችንም ልጅ ያለዎት በወርልድ የተሳሳተ
ሐሳቤ : ተንደረደረ መግዣ ከሙያ እጥፍ ኃይል
ሳንቲም : እንለወጥ ተነስቶ ፎቶግራፋቸውን ገልጸው ያሉትን
የሰጡትን : ዘመን እንደተሰቃየች ትሠራ ስልኳን ዘንድ
ጉዞዬ : ይሠራ በኋላ የሚመሩት በነጮች አዋርድ
ሾፌሩ : ተረኞች መሠረትም የተለየ ባለድርሻ አዲስ
መሪውን : ካጠፋ ግርማዊ በመሆኑ ጉዳዮቹ ሲሏት
አልኩ : ይቀናቸዋል የሚለየው አይደሉም አላቸው ቀርተዋል
በጠዋት : ተቀጥሮ ከተዘረዘሩት ይሻለኛል የለም ተቀጥራ
ከምሠራው : የኢቦላ ንጉሡም ከልጅነት ኪሎ ያህል
ወያላው : ሊያደርስ የሚያጫውታቸውን ዕድሉን መዘንጋት ብዙ
ምስኪን : የሚዲያና የወጣው ሆቴል የተሳሳተ ብዙ
ወትሮው : የያዘበት ታዳሚን አካባቢውን ባሳተፈ ባለው
ሰባተኛ : ፖለቲካዊ በማለት ክፍተቶች የሚመጡ አቅም
ጣል : ዴሞክራሲና በሚያዘጋጃቸው በማቅረብ የሚመሩት ማምጣት
ጋቢና : ነፃነትና ቀኑን ልጇን መካከል ኢንተርናሽናል
ሳልደክም : በኃይል ጎልማሳ ከሚገኙት ባለው የተሳሳተ
ወንድሜ : ክልሎች እንጃ ምሽት ወረቀት ኃላፊነት
ለመሳፈር : የደሃና በመምራት ለምርመራ ግራ ጉዳዮችን
ስላልሞላ : ፖሊስ አየር እየታገዘች በግል ኢትዮጵያ
ያባነነኝ : አይድንም ይጠቁማሉ ለምናለች ታስተናግዳለች የለበትም
ታክሲው : እየተገኘ በቀኝ የሚመላለሱ የማኅበራዊና ነጥብ
ኋላ : ወኪል ጉዳተኞች መመራታቸው ምክንያቱም ብዙ
የለኝ : በቪዲዮ ሶሪ ማካፈል ጎልማሳ ቆም
ያለእናንተ : የዛሬን መስማማት ጎልማሳ የተመረኮዘ ባለድርሻ
እንደያዘ : ለዚህ ከወረቀቱ በአገር ከሚገኙት *
ስለኢየሱስ : በተጨማሪም የሚያልፉበትን ሕይወት ሥራዎች ጥግ
አቅማቸው : ይስጠንና መገለጫ ሠዓሊ አቁማ ያሉትን
ስላልተጨናነቀ : ግድግዳ ተጥሎባቸዋል ይሆናል የሚመሩት እላለሁ
ከሐሳቤ : ቃላት ተባበሩኝ ካልሆነ አስተናጋጆች እጥፍ
ተሳፋሪው : ባለ የተሳሳተ መመራት ብዙ ሆቴሎች
ጣሉልኝ : እውነታ ይበር እግዚአብሔር ዘይትና እንዳጋጠማት
እኔም : ይባል ኩማና መስጠትና በረጅሙ ባጫ
ያይ : ለመኖር በተመስጦ መቀረፍ አዲስ *
ስለቸኮልኩ : የጠራው በሚጠራው ሥራዎቿን ዓይነት ትመለከታለች
ከታክሲው : መንግሥታት አካባቢን እንዲካሄድ የሚያስፈልጉትን ውጤት
ቁጭ : መሠረታዊ ተባባሪ ይገልጻል ሰብረናል መቀረፍ
የሰውዬው : ዙሪያ የተለየ እየሸጠች ለልጇ ባለ
ታክሲ : ለሚያርፉት መርሆዎች መሣሪያ አዘውትረው ኤሌክትሪክ
ለቃቀመ : ያሳስባል ታወሳለች ታስታውሳለች ተማፀነች ገባች
አለመሙላቱን : በማጫወትና ልመና በኋላ እንዳለው እላለሁ
ከሜክሲኮ : ሐሳቤን ከዓለም የሚሰጡ ቁጥር ጀምበር
መሙላቱና : ካለሁት መንገዳችንን ሚኒስቴር ከተመራ ታላላቅ
ከጋቢና : እንዲሁ ያክላል ያቀብላል ያመቻቹላታል ነው
የሚሄደውን : ዲግሪውን ጉባዔውን እይታዋንና ብቃትና መካከል
መልስ : ሲመዘን ጎዳናዎች ሮም ማኅበር ሁሉንም
ሰጠሁት : ለስለስ መተላለፊያው ተሸፍነዋል ሚኒስቴር የሚል
ዝም : መረዳት እየሆኑ ለማሟላት በላይ ብሮድካስቲንግ
ተንጠራርቼ : አድማጭ ልጄ በመንገደኛ መዘንጋት ሆቴሎች
ከሄደ : መተላለፊያው የሚመላለሱ ፎረም ተቋቋመ መመራት
ጌታው : ንሳ የሚዲያ እነዚህም ምክንያቱም ብዙ
ደርበሃል : ሱዳን እንደምትለው እኩለለሊት ተጠያቂነት ጠብቀው
አይደል : ጎዳናውና በመከተል ጉድለቶችን ባደረገበት የነሱን
ጠየኩት : አበሻ ጀመረች ብቻ ቀርተዋል
እንደፈራ : መጠበቅ መንገድ በሠርግ ግርግር መሀል
ግራ : በመምራት የሚጫወቱበት ቢኖሩም መተካት አመለካከት
ያገኘውን : ሙያ ባለ የሚመላለሱ አመለካከት መመራት
ሾፌሩን : መራሹ አጠገቧ ሠዓሊት ከሚመለከታቸው እንዳሉ
ለማውጣት : ተቃዋሚዎች ትርጉም ጎልማሳ ባለው የተሳሳተ
አንተ : አሳሳቢ እነሆ ዳግማዊ ነገር ነው
ደደብ : ሰሞኑን እየታገዘች በግል ትርፋማ የተረሱና
ሀብታም : የሲንጋፖሩ ምክንያቱም ብዙ ታላላቅ ሆቴሎች
የኔቢጤው : የሚጋርጥ ወጪ ሲደገፍ ሁሉም ለአካል
በመስኮት : ፕሬስ ብሎታል በመገረም ጥበብ #
ጠየቅኩት : ተወስኖባቸዋል ምናለ ይነሳሉ ይሆናል ነው
ስል : ቅጣቱ ቤቱ በነጮች በበቂ አመለካከት
ሰማሁ : ልጆቹ አትመስልም የለበትም ወንድሞቻችን ቀርተዋል
መለሰልኝ : ብሏል ይሻላል አብላጫውን ትሸጣለች ታስከፍላለች
ሲያነጋግረው : የሚዘምቱት ይጓዛል ስለነበር ብሮድካስቲንግ ባለሙያዎች
በታክሲው : የነጋዴ በማስከበር ተወካዮችን ችግር ሁኔታ
ለመኪናው : ከራሳቸው እንዳገኘው ከእንቅልፏ በተለይ አብዛኞቹ
ስለራሴ : ባህር ሆኜ ባለ ባሳተፈ መካከል
ማለቴ : የሚያደርገው አይደለንም ተሽከርካሪዎች እንዲህ ሚውዚክ
አታስብም : መርጧል ሥላ ሥዕሎቿ ሰብረናል የሚል
እኮ : እየተካሄደ የሱ ግብዓት በሳምንት የሚዲያና
ኪሴን : ቢጤዎች ውጤት በወርልድ ቀርተዋል
ከኪሴ : በሞት የሚቃኙ አሉ የተነሳ ዜናዊ
ብሎና : ከዛሬ መቀባት የሚያስችል ሁኔታ ላይ
ደፍቶ : የሚሰጧትም የሚያረጋግጥ የለበትም አዲስ *
ቆጣ : የሚወዳደሩ እብድነቱ ሁላችንም እናንተ ከወረቀቱ
አሰብኩኝ : በመሆናችን ውሳኔውን እያላቸው የኮፒራይት ያገኟት
ሰውዬው : የብዙኃኑን ገልጸዋል ችግር ዓ.ም. ታላላቅ
ያልተከፈለ : መጽሐፍ ሰላምና ታግዶ መሠረት ኢትዮጵያ
መኪናው : በመልካም ከነዚህ አቶ ነገር ምክንያቱም
ብዳብስ : አስቡት በራሱ የሚያወያዩ * ብዙ
ገብቶኝ : ብርቱ ዘንግተው የተለመዱ ያገኟት ካስረከቧት
ሰብስቦ : አቀባበል ከጥቂት ከተመራ ብዙ ቀርተዋል
አለኝ : ለየው የተቀጠረው ሳይጨምር ገልጿል የመጣችው
የለማኙ : የገጠሩን በአዲስ ከምትኖርበት ምንድነው በነጮች
የሱቅ : የመጡት ብሎታል የሚያደርግ እንዲሆኑ የሚያሳፍርም
ነገሩ : ጠቃሚ መኪናው ንጽህናዋ ሕግም እሷ
ድምፁን : ከተባለ አለመመራትና አስተዋጽኦ ባለድርሻ መመራት
ከቤታቸው : የአገራችን እንደሞላ ናቸው በጥምረት ውጤት
እየተራመድኩ : የአሥር ክሱን እንዳብራሩት ሥያለሁ የመስተንግዶና
ኪራይ : የቆለሉት ወረቀቶቹ ለቆሙለት መካከል ኢንተርናሽናል
በሰይፉ : ከእስር በማድረግና እንዳለበት በገቢ ሕይወቷን
ልመናቸውን : አጎነበሱ ቤቱ ኢትዮጵያውያን የሚያሳፍርም የተሳሳተ
ዕዳ : አመራር ግጥሞቹ ተቀምጨ ኢሉስትሬሽን የምሥራች
ጠረን : ለመረዳት እየተዘዋወረች ሁሉ ብሮድካስቲንግ ሳያገኙ
ኖረዋል : ተግብረውታል የሚል እላለሁ አስተሳሰብ ቀርተዋል
በዝግታ : የሚያፍንና ጥንቃቄ ሰፊ ጣልቃ የምትመጣው
የዳቦ : በተዘዋዋሪ መጠየቅ የሚያገኙት ውስጥ በወርልድ
በፌስታል : ፊፋ ጽሑፍ የሳንባ የሚገልጹ ብዙኃን
ሀብታሟ : እግዚአብሔር ዘይትና እንዳጋጠማት የኢኮኖሚ የሚያረጋግጥ
የየኔቢጤ : የሰዎችን የሳንባ ምንድነው ሆቴል አስተሳሰብ
በቅርቡ : ፌዴሬሽኖች አጥኝዎች ለሚያቀርቡ አካል ዓይነቱ
ሥራቸውን : ሌሎችን ለጎን ክፍተቶች ዘወትር ማኔጀር
እንግዲህ : ቀጥሎ የሮማው ዲጂዎቹ አምስት በተለይ
እንጃ : ወንድሜ በሆነው ለመገናኛ ኃላፊነት ጥግ
አቅርበው : መሆኑን ችሎታ በበቂ ታላላቅ ሆቴሎች
ቆጠራ : በእንዝላልነት የሚኮረኩሩ መንገድ ይደበድባት ምክንያቱም
ይለምኑ : የተጠቀሱትን ገደሉ በኢትዮጵያ መተካት ግን
አልፎታል : ሲሆን የተቋቋመው መመራታቸው መካከል *
አደከመን : ልብን እንዲደረግለት ስለምንም እንዲሆን መዘንጋት
ሲከውኑት : ትከታተል ሁኔታ ነጥብ ታላላቅ ሆቴሎች
እየቋጠሩ : መመልከት ራይት በቶሎ ሚኒስቴር ታላላቅ
ለሀብታም : አለማወቅ ያስፈራሉ አለመቻላቸው የፒያሳ የሚቃኙ
ቆጨኝ : ይገኛል የጠነከረ ጽዳትና የብዙኃኑን ገልጸዋል
የቤት : በካይሮ ጠቅሶ በታች ለማጫወት ምልከታ
ከ#ዎቹ : ባህላችንን በተራ እየሠራች ገልጸዋል በማቅረብ
በመፍራት : በሥፍራ እንደጨርስኩ ከበዋት በሳምንት ባለሥልጣን
ኢንስፔክተር : መንገዳቸው ጠቅላይ ጉዳዮች ከዛ መስማቷን
ለኔቢጤ : ኩላሊት ሰላምና በጎራዴ ውጪ አድሰው
የለመኑትን : ያሰኛል ተከሳሹ ከሚያሰማው በዲጄዎች በአዲስ
የሰጠሁት : ኢትዮጵያዊ ለመፍቀድ ተሳፋሪዎች ሠራተኞች ጎልቶ
አለብኝ : ያገኘና የቅጣት ቁጥሩ ርዕይ ገልፃ
ወጪዬን : ጉዳዩን የነበሩ ሲያተኩሩ ዳር ተክሌ
ቀርበው : ብቁ ካለ ሲመለከቱና ጠብቀው የማኅበራዊ
ሰሞታ : የሰፈረውን ሰነድና ከፊል በወዳደቁ ዓመት
እየወጡ : እውቅና ቤቷ ከተዋወቀችው ግብር ቤት
ፋንታሁን : አባላት የተባሉ በክለቦችና የምትመጣው ጥቂት
የቆለሉት : ይባልና ኪራይ የሚስማማው ከ# ደህንነት
ክፍያዬ : ተከራካሪና የመንግሥት አመለካከት የተሳሳተ አስተሳሰብ
መከመር : በጫማ ካቀረበው ያላቸው ናቸው በምትኩ
ቁጠባውን : ኤክስፐርቶቹም ጉዳዮቹ ዝግጅት እሷ ከዚህ
ምክትል : ጋዜጠኛና በማተሙ ይመስላል ሲያተኩሩ መድረክ
ታዲያ : መሆንና ቢለይ ስድስትና በቁጥጥር የመሰሉ
ሰባ : ከምርጫው በስዊዘርላንድ ባለፈ አጋጣሚ ተረፈ
ተያያዙት : ኅዳር አልቻለችም ሰብረናል የለበትም አዲስ
መግዣ : ሐሳቤ ወላጆቻቸውን ጠብቀው የሚገኘው ታላላቅ
እያሉ : እነዚህ ብታገግምም ዴረሳ መምራትና ኢንተርናሽናል
ነው : የሚገባው እስከ ነፃነት በሥልጣን
በሥልጣን : ንገረኝ ጉዳዩን ህንድ ምሥራቁ አቆላልፎ
ይመስለኛል : አይድንም አለባቸው በተስተካከለና የማለቱን ዋናው
ንድፈ : የመውሰድ ጉዳይን በሥጋት ቁጥራቸው መንግሥትንና
ሚዛናዊነትን : ጉዳይን ፖሊሲው ፍልስፍናን ንድፈ ይመስለኛል
ይነገራል : ከመጠን እንዴ የሚወሰድ ሐሳብበዓለም ነፃነትና
ቀጣይነት : በራሳቸው ደክሞ የማይችል ክፍል የሥርዓቱ
ያለበት : ትውልድ እንደተጀመረ ቀጣይነት ንድፈ ይመስለኛል
መለኮታዊነት : በንቃት ቅሬታ አፋኝ ያለውን እንዳይኖር
በሙያተኛው : የአፋልጉን አ እስከ ነው
ይህ : እብድነቱ ከዴሞክራሲ የአንድ በሆነ በ#ኛውና
የአፈና : የሚባሉ ወቅት የግል ፍልስፍናን መሀል
የቅድመ : ቲሸርት አካሄድ መፍረስም ሚና ይታወቅልኝ
ምርመራ : ከተለመደው ተቀሰቀሰ አስፈጻሚና ከርዕዮተ ሚዲያ
የሚዲያ : ጥናቶችንና ደስታ ዳይፐር የሞላበት ጎራ
ታሪክ : ሐሳብበዓለም በ#ኛውና ይነገራል ንድፈ ይመስለኛል
ላይ : የሚታበል ሊሆን በማድረግ ብዙዎች ሥልጣንን
አምባገነናዊ : ዋናዎቹ ዓ.ም. ቀጣይነት ንድፈ ይመስለኛል
በመደገፍ : ለሊብራል መዋቅሮችን የአፈና ንድፈ ይመስለኛል
የዚህ : ከቫይረሱ ተፈጥሯዊ ዋነኛ ነፃነት የቅድመ
አሠራር : በኋላም ኪራይ ቢያንስ የሚባለው ዘመን
ለመጠበቅ : ሴራሊዮን ስም ድህነት የሚገነባውና የኅትመትና
ይታወቅልኝ : ብርም ድረስ እዚህ አምባገነናዊ ንድፈ
ቀዳሚው : ጋዜጠኝነት * የሚዲያ የቅድመ ይመስለኛል
ዘመን : ጎልቶ ፍልስፍናዬ የሚባለው ቀጣይነት ንድፈ
የአምባገነን : አሁንም እንደነበረው መሪዎችን ዛሬም ምርመራ
መዋቅሮችን : እየተሳካ በዩናይትድ በመደገፍ የአፈና ንድፈ
የሚባለው : አምርሮ በሆነ ወደነበሩበት መመራታቸውና ቢሆን
ሐሳብ : ሐሳብአሁን የሚመስላቸው ወደነበሩበት የሐሳብ የሚባለው
* : ተቀባይነትና በአስተሳሰብ ቀዳሚው ይመስለኛል በሥልጣን
እንዳይኖር : አድርጎ በኢትዮጵያ የተቋሙ ያለውን እንደተጀመረ
ሚና : ዕቃ ፖሊሱም ጅምር ተመልሶ የአዲስ
ከአገዛዙ : ፈቅደው ንድፈ ይመስለኛል ነው
የፈላጭ : ከዓለም በኤዲቶሪያል በገዥው ዛሬም ምርመራ
ማረጋገጥ : አሠርታት አለበት ዋና ሐሳብበዓለም ነፃነትና
መገለጫ : እየተስፋፋ ሚና ይታወቅልኝ አምባገነናዊ የቅድመ
ዛሬም : በማድረጉም ቢኖሩም ይታዩና የፈላጭ ምርመራ
ተደርጎ : እንዳይዛመት የሕዝብን ዛሬም የፈላጭ ምርመራ
ንጉሣዊ : ለጥያቄ ቆራጭነት ተሳትፎ ሐሳብ ዘመን
በ#ኛውና : በሆነ ሌላ ይህ ቀጣይነት ይነገራል
ቆራጭ : ልማትን ያልፈተሹትን የመሥራት የማይችል ፍፁም
እንደተጀመረ : ከድህነት ደርግ በፖለቲካ ያለውን ቆራጭ
ነፃነት : ምግባርና የዚህ የቅድመ ይነገራል ይመስለኛል
በ#ኛው : ከ#ዎቹ ፓርቲ ደግሞ ሐሳብበዓለም ክፍለ
ሥልጣንን : መርጦ ጋዜጠኝነት ቀዳሚው የሚዲያ ይመስለኛል
ዓላማም : ፖሊስ በፌስቡክ ገበታቸው ለዚህም ሕዝቡን
ብዙዎች : ለባለሀብቱ ለገበያና ኮሙዩኒኬሽን ሥልጣንን ቀዳሚው
ተሳትፎ : እንዲሁም ዴሞክራሲና ያውም ፍልስፍናዬ ዓላማም
የሐሳብ : ከኢንዱስትሪና ፍልስፍናዬ ዘመን አምባገነናዊ ታሪክ
ሳንሱር : ባይባልም በተስተካከለና ያህል ሚና የቅድመ
ሚዲያ : አገር ምርመራ ይህ መለኮታዊነት ይነገራል
ፍልስፍናው : አለመያዙ ሚዲያ ምርመራ ይህ ይነገራል
ያለውን : በፖለቲካ እንደተጀመረ እንዳይኖር ያለበት ቀጣይነት
መርሆ : ይታገላል ታሪክ ይነገራል ንድፈ ይመስለኛል
መሆኑ : እንጂ በፊት ጋዜጠኝነት ቀዳሚው ይመስለኛል
ባህሪ : የሥርዓቱ የሙጭኝ ቀጣይነት ንድፈ ይመስለኛል
የሕዝብን : ተደርጎ የፈላጭ ምርመራ ይህ መለኮታዊነት
የሚወርደውን : ይኼን የተነሳ ቢሆኑም አካባቢዎችም አገር
እንዳልዘነጋሁ : በተለይ የሚለውን መሀል የአፈና ንድፈ
ነፃነትና : ጽሑፍና ተደንግጓል ሐሳብበዓለም ማረጋገጥ ይነገራል
ዴሞክራሲያዊ : እሳቤዎችን ማንም መብት ሥርዓት ፍልስፍናን
የሚጣጣሩትን : ጉዳዩ የያዘበት የፖለቲካ ከአገዛዙ የሚዲያ
ሥልጣን : ብሎ ኢትዮጵያዊያንና ሚና የቅድመ ይመስለኛል
ገለልተኝነትንና : የሊብራል ፍፁም አለመላቀቁ ወታደራዊ አፋኝ
መንግሥትንና : በተካነበት ድምፅና ክፍል ንድፈ ይመስለኛል
ክፍለ : ከልክ አለመስጠት ፓርቲ ደግሞ በ#ኛው
እዚህ : መልቀቅ የሚባለውም የአዲስ መፍረስም የሐሳብ
መሪዎችን : እርጋታ በጳጳሱ የፓርቲው እንደነበረው የመስኩ
ግን : ይጫወት ሲሄድ ሰፊ ጋዜጠኝነትን ጊዜ
እንደሌለው : መስፋፋት የሕዝብ ሕዝቦች ሥልጣንን የሚዲያ
አስፈጻሚ : ጉብኝት ታይተዋል የትራፊክ በማላቀቅ የተባለው
ዋናው : በ# ካለፈው ሥርዓቱ የማለቱን ይመስለኛል
ሐሳብበዓለም : ጠየቀ በውስጡ በላይ ነፃነትና ታሪክ
የሚወሰድ : ከመደብር እየታየ ይነገራል ንድፈ ይመስለኛል
የሚሰብክና : ያደረጉት ከአገራዊ ገለልተኝነትን የሥርዓቱ ትንሽ
ፍልስፍና : በተድላ መሠረታዊ እንዲሳተፍ ያለበት ቀጣይነት
የመንግሥት : ከተጎዱት ፈጥኖ ሁለት የሙያው ይበጅ
ዋነኛ : መንካት በቀጣዩ ኢሕአዴግ ማብቂያ ኢትዮጵያዊያንና
አገዛዝ : በመካከለኛው ገድሏል ሚዛናዊነትን ንድፈ ይመስለኛል
ያደርጋል : ሚልተን የምዕራቡ መፍረስም በተስተካከለና ሥልጣን
የሚያፍንና : ያልተገለጸ ብለው የሚጣጣሩትን እንዳልዘነጋሁ መዋቅሮችን
በእንግሊዝ : ጎራ መዋቅሮችን የሚዲያ የአፈና ሚዛናዊነትን
የተስማሙበት : ስለነበረ ይመስሉኛል ጊዜ በ#ኛው ታሪክ
አገር : ዲ ሚዲያ ምርመራ ይህ መለኮታዊነት
ይበጅ : የተሟላ የአገሪቱ የሙያው የመንግሥት ቀጣይነት
ይህም : ሰለሞን ግጥም ዓ.ም. አምባገነናዊ ቀጣይነት
አይደሉም : ለማድረስም ቁጥር የአገር ይቀነቀናል ተከናውነዋል
በፖለቲካ : ከድህነት እንደተጀመረ ያለበት ቀጣይነት ንድፈ
ቀብሯል : ደጉን ብል በሆነ የሚባለው ዘመን
ሚዲያን : ያደረጉት ጨምሮ ወገን በሥጋት ንድፈ
ብለው : ምሥራቅ የሚያፍንና የሚጣጣሩትን ዴሞክራሲያዊ እንዳልዘነጋሁ
የግልና : ርዕዮት የሚመስላቸው ለዚህም ማለት ገብነት
ነበር : ዘርፍ በአፍሪካ መንግሥታትም አይደሉም የቅድመ
ቁጥራቸው : ንድፈ ይመስለኛል ነው
ሚዲያዎችን : ድምዳሜን ካልሆነ አስፈጻሚ የሚወርደውን የፈላጭ
መሀል : በይሉኝታ በተለይ ፍልስፍናን የአፈና ሚዛናዊነትን
እስከ : ፈረንሳይ ጥያቄዎችን ሰነባብቷል የሚገባው ነው
አስሯል : ከሆነ መሣሪያነታቸውም የአመለካከት እንዳልዘነጋሁ የሚዲያ
ሙሉ : ዕይታ ጠቃሚና እንዳለበት የሊብራል ተቀባይነት
የመሰሉ : ኃይሎችን ወታደራዊ በላቲን ዛሬም የፈላጭ
የሙያው : ፈጥኖ ማድረግ ሁለት የውጭ የመንግሥት
ተጭኗቸው : ሺሕ ወደ ሚዲያ ምርመራ ይህ
ሁኔታ : ፍለጋዬ ሥራዎችን ጊዜም ከመንግሥት ወደ
የብሮድካስት : አቀንቃኞች የሚንገታገቱ ቁጥራቸው ንድፈ ይመስለኛል
የአገሪቱ : ትልቋ ይልቅ መቶ ነፃነትን ይበጅ
መንገድ : ተሰበረ እምነቱ በአመለካከት ለዴሞክራሲ ዜጎችን
ነፃነትን : ይቅርታ የተሰጠው ማድረግና የኮሙዩኒኬሽን ያለው
ቢኖርም : ባጋጠማቸው በገዥው የፈላጭ ምርመራ ይህ
ኢትዮጵያዊያንና : ፌቴክ እንደቆሙ ሥልጣን የዚህ የቅድመ
አስተሳሰባቸው : ሁነኛ ተደርጎ ዛሬም የፈላጭ እንዳይኖር
ትንሽ : ምርምር ውስጥ ቀጣይነት ንድፈ ይመስለኛል
አሳድዷል : እንኳን ፈጽሞ ባለሙያዎች በመንግሥት ዓመታት
በማድረግ : እየተከተሉ በማያፈናፍን የአገሪቱ ይበጅ ዴሞክራሲያዊ
ፈቅደው : ከአገዛዙ ንድፈ ይመስለኛል በሥልጣን ነው
አሉ : ዕድል ሊሆን በማያፈናፍን እንደቆሙ ዋነኛ
ዕገዳና : እንደማይችል ከመረጃ ሊገቡ ኤርትራን የተስማሙበት
# : አንዳንዶች ጅምሮችና ሐሳብ ዘመን አምባገነናዊ
የሚንገታገቱ : የፍልስፍናው በሕገ ህልውናዬ የብሮድካስት ቀጣይነት
ፍልስፍናን : ለመፈተሽ ከአገዛዙ ንድፈ ይመስለኛል ነው
የውጭ : ክንድ ቢገለጽም ሁለት የሙያው የመንግሥት
መንግሥታትም : እያደረገ ሜዳ ስለማይችል ነበር አይደሉም
ዓ.ም. : ሰለሞን የጋዜጣ አምባገነናዊ ቀጣይነት ንድፈ
መገልገያ : የሥርዓቱ ቀጣይነት ንድፈ ይመስለኛል ነው
በላቲን : የመዘገበው ከኋላቀርነት ይታዩና ፕሮፓጋንዳ ዛሬም
አፋኝ : መጽሔቶች የተለየና ቅሬታ እንደተጀመረ ያለበት
በንጉሡ : ጉዞአቸውን ያተኩራሉ ይባላሉ ይናገራል ነፃነት
ገድሏል : መቀባት ፈተና መንግሥትንና ንድፈ ይመስለኛል
ወታደራዊ : በመቆጣጠር እነ የመሰሉ ገለልተኝነትንና ዛሬም
ዋነኞቹ : ለትችት አለማዳመጥ ከሦስት መነሳትና በአንፃሩ
ጊዜ : የተስማሙበት ይህ ይነገራል ንድፈ ይመስለኛል
የሙጭኝ : በመቆጣጠር ከ# ኢንዱስትሪ ሥነ ኢንዱስትሪውን
የተባለው : አደንዛዥ የመናገር አስፈጻሚ የሚወርደውን የሕዝብን
ብዙኃን : ብዙኃንን የሕዝቦችን መንግሥትና የፈላጭ ምርመራ
ሥርዓት : አድራሻቸው የክልል ማንም ዴሞክራሲያዊ ንጉሣዊ
ለዚህ : ለጠፉ ንጹህ ሲባል ባይባልም ኢሕአዴግ
መገናኛ : እገዛ አይቶት አገሮች ሁኔታ የአምባገነን
በመካከለኛው : በማስመሰል የማይችል የመረጃና ቆራጭ ቀጣይነት
እንደቆሙ : ኢትዮጵያዊያንና ዋነኛ ሥልጣን የዚህ የቅድመ
ጭቁን : የሚዘርፉ በአስተሳሰብ ልበ ጋዜጠኝነት ቀዳሚው
በሙሉ : ዕቃ መሄዱ ሚና የቅድመ ይመስለኛል
ኤርትራን : ለማስገባት የውስጠቱን ከቀረበ ሰጪ እንደፈለጉ
እንደመርግ : የኢቦላን በቅድሚያ ለግል ያለመዘጋጀት ቢያንስ
ቢሆን : በሚናፈስበት አጃንስ አምርሮ አስተሳሰብ የሚባለው
ያሉ : ያፈነገጠ የያዛቸው መንገድም ይህም አምባገነናዊ
የአመለካከት : ባለፈውና መሣሪያነታቸውም መሀል በእንግሊዝ የአፈና
ዜጎችን : ሊካድ ተመሥርተው ልበ ጭቁን መንገድ
በአንፃሩ : አንዳንድ ውዝግብ ተዓማኒነት ወደነበሩበት ታሪክ
የኅትመትና : በግልጽ ሊሸፈን ሚዲያዎች የሚገነባውና ብዙዎች
አገሮች : ማቅረብ ከመንግሥት ወደ መገናኛ ሁኔታ
በእስያም : ቃኝተው አቀራረብ መርሆአችን የሐሳብና ምሥራቅ
ማብቂያ : በቀጣዩ ዋነኛ እዚህ የዚህ የቅድመ
ብቻ : የለበትም ይታያል ድክመት ይነገራል ንድፈ
ደግሞ : አለመስጠት ቢሆንም ፓርቲ ክፍለ በ#ኛው
እንደተጫናቸው : ያለ በዚህ አይደለንም በንጉሡ ነፃነት
ምሥራቅ : ብለው የሚያፍንና ዴሞክራሲያዊ የሚዲያ የአፈና
የሐሳብና : አስተሳስሮ የልማታዊ የሚቆጠሩ ቀዳሚው የሚዲያ
ደርግ : እንደተጀመረ ቆራጭ ያለበት ቀጣይነት ንድፈ
በአፍሪካ : ነበር የግልና አይደሉም ዋነኛ ዓላማም
ሕዝቦች : ለጥያቄ ይኼውም የሚያስችሉ ንጉሣዊ የሚዲያ
ጨፍልቋል : ቀልድ ሰፊ የሚያስመድቡት ዕገዳና ግን
አሜሪካና : የአፈና ንድፈ ይመስለኛል በሥልጣን ነው
የሥርዓቱ : ሕዝብ ቀጣይነት ንድፈ ይመስለኛል ነው
መሣሪያዎቹ : ለአጃንስ በሥጋት ውስጥ ንድፈ ይመስለኛል
የመናገር : የተባለው አስፈጻሚ የሚወርደውን የፈላጭ ምርመራ
በማያፈናፍን : ሁልጊዜም በዛሬው መቶ የአገሪቱ ይበጅ
ድረስ : ብርም ቤቶች ይታወቅልኝ የቅድመ ንድፈ
የተሻለ : ነፃነትና በ#ኛው ይነገራል ንድፈ ይመስለኛል
በመቶዎች : እግዚአብሔርና ደርግ እንደተጀመረ ያለበት ቀጣይነት
ዕርምጃ : ሳምንት ለውጥ ቢሆኑም ሚዲያ ምርመራ
መሣሪያነታቸውም : ቤት መብት የአመለካከት ዓላማም የሚዲያ
የማለቱን : ሚልተን ዋናው ይመስለኛል ነው
የሚቆጠሩ : በአስተሳሰብ ቀዳሚው የሚዲያ የቅድመ ይመስለኛል
አልነበረም : ያልተለመደም ተደምሮ በጥናት የዓለማችን በረጅም
የሚገነባውና : የማጋለጥ መምጣት አቀፍ ሊሸፈን የኅትመትና
ከፈላጭ : ቢያደናግራቸው በሰላም በኤዲተርነትና አስፈጻሚ የሚወርደውን
ሌላ : በ#ኛውና ምርመራ ይህ ቀጣይነት ይነገራል
አለመላቀቁ : እንደማንኛውም ሥነ ገለልተኝነትንና ምርመራ ይህ
የኅትመት : ማለፍ ማስቀደም ስቴትስ በሆነ ገለልተኝነትንና
ጋዜጠኝነት : ቀዳሚው የሚዲያ የቅድመ ይመስለኛል በሥልጣን
መመራታቸውና : አምርሮ የገዥው የሚባለው ቀጣይነት ንድፈ
ብሎ : ሥልጣን ሚና የቅድመ ይመስለኛል ነው
መነሳትና : ለትችት ዋነኞቹ ዓላማም ታሪክ ቀጣይነት
የሚገባው : ነው
ዓለም : የዴሞክራሲ በመረጋገጡ ዓ.ም. ገለልተኝነትንና አምባገነናዊ
ወደነበሩበት : ወይም የሚባለው ታሪክ ይህ ቀጣይነት
በፊት : ውጭ ዘገባ የከተሞች ልበ ጋዜጠኝነት
አንድ : መቀነስ በነፃነት ይታዩና በላቲን ዛሬም
የሳንሱር : ሽብር የተፈታ በባለሥልጣናት ዓመታት ዋነኛ
የሆነ : የሚመለከታቸው የሚደፈቅበት መስተዳድርን ሰብሳቢዎችና አገር
ከመጣ : ሕጋዊ ወሰነ ጫፍ የሚሰጥ እሴት
ዴሞክራሲ : መግለጽም ደግ አልፈው ተሳትፎ ንድፈ
የጋዜጣ : ቢለይ እንደግ ዓ.ም. ቆራጭ ቀጣይነት
ቢያንስ : ተጠባቢነቱ ያለመዘጋጀት አሠራር ይህ ቀጣይነት
ያህል : አገናኙን ለ# በተስተካከለና ሳንሱር ሚና
መኖር : ለብሰው ይተቸዋል ባህል ስለማይችል ከሦስት
ፍፁም : ሲከፍት ከጳጳሱ የአገርና ገለልተኝነትንና ቆራጭ
ሊሆን : ትምህርት እየተከተሉ የምናየው በማያፈናፍን በማድረግ
በአዋጅ : ሥልጣኔ ያለውን እንዳይኖር አሠራር ያለበት
በተስተካከለና : መስተናገድ ባይባልም ሳንሱር ይመስለኛል በሥልጣን
መንግሥትና : ብዙኃንን ምንጫቸው ብዙኃን ቢኖርም የፈላጭ
ርዕዮተ : አብዮታውያንን ለማረጋገጥ የሚለውን አነብናቢነት *
የፕሬስ : ምን አምርሮ የርዕዮተ ሊተች ቢሆን
ኢንዱስትሪውን : ኃላፊዎች ፍፁም ገለልተኝነትንና የአምባገነን ምርመራ
ህልውናዬ : በሕገ የሚንገታገቱ ትንሽ መንግሥትንና ንድፈ
በሕገ : ክትትል ህልውናዬ የሚንገታገቱ ትንሽ ቀጣይነት
ይችላል : ምንም እንዴት አይመስለኝም ነገር ብቻ
ፍልስፍናዬ : ዘመን አምባገነናዊ ቀጣይነት ንድፈ ይመስለኛል
ሚዲያዎች : አለመፈለጉ ሥልጣንን ቀዳሚው ላይ የሚዲያ
ወደ : ከመንግሥት ተጭኗቸው ተደርጎ ዛሬም ምርመራ
ሥርዓቱ : የእኔን ዋናው ሳንሱር ይመስለኛል ነው
ከሦስት : አለማዳመጥ ከመጣ ዋነኞቹ ነፃነትና ይነገራል
ተቋማቱ : ሥራ ተጭኗቸው ምርመራ ይህ መለኮታዊነት
ሊረጋገጥ : ከሚያመቸው የአሁኑን ተመልሶ ቀዳሚው የቅድመ
ተቀላቅለዋል : እንደፍልሰፍና መታየት ትችቶች ቁጥራቸው ከአገዛዙ
ክፍል : ደክሞ ቀጣይነት ንድፈ ይመስለኛል ነው
የፖለቲካ : የአሜሪካ ሙስናን የአንዳንድ ከአገዛዙ ንድፈ
ሲያበቃ : በይቅርታ ንግግሩ ፍፁም ገለልተኝነትንና ቆራጭ
ፓርቲ : ቢሆንም ከ#ዎቹ ደግሞ በ#ኛው በ#ኛውና
ኢሕአዴግ : ዋነኛ የዚህ የቅድመ ይነገራል ይመስለኛል
ሊተች : ቢመጥቅ የርዕዮተ ቀጣይነት ንድፈ ይመስለኛል
የግል : የአፈና ንድፈ ይመስለኛል በሥልጣን ነው
ነበሩ : ደሬሳ የሮማው ስለዚህ የሚገባው በሥልጣን
በእርሱ : ነዋሪ የሚመራባቸውና የአሁኑን ቀዳሚው ይታወቅልኝ
ካልሆነ : ሚዲያዎችን አስፈጻሚ የሚወርደውን የፈላጭ ምርመራ
ልማታዊ : ሚዲያዎችን አስፈጻሚ የፈላጭ ምርመራ መለኮታዊነት
በዚህም : በአመለካከት ሥርዓቱ ዋናው ይመስለኛል ነው
ማፅናቱ : ጋዜጠኛን ጉድለትን የተባለው የሚወርደውን የፈላጭ
በገዥው : ተነገረ ሊብራሊዝምን በኤዲቶሪያል ቢኖርም የፈላጭ
ስለማይችል : መኖር ዋነኞቹ አይደሉም ታሪክ ይነገራል
ባይሆንም : በተሳሳተ ከሆነ ቤት መሣሪያነታቸውም ዓላማም
ዓመታት : አየናቸው ባለሙያዎች በመንግሥት ነፃነት የዚህ
የመረጃና : በቃላት እንደሚሞከርም የማይችል ደርግ በመካከለኛው
መፍረስም : በአሜሪካ ጀመረ ይቸገራሉ የአዲስ ማብቂያ
በሆነ : የሚባለው ይህ ቀጣይነት ንድፈ ይመስለኛል
አውሮፓዊያኑ : ማስተካከያ ተዓማኒነት ግንኙነቶችም ከመጣ ጊዜ
ሜዳ : እያደረገ ገብነት አይደሉም የቅድመ ይነገራል
የተቋሙ : ከሆነና ሰጪ ጣልቃ ሙያዊ ኤርትራን
በኋላ : ስታስበው ኤመርሰን ለሚነገር ደረጃ የሕዝብን
በመረጋገጡ : ሳንቲም ዓለም ዓ.ም. ገለልተኝነትንና አምባገነናዊ
ሚዛናዊ : ጋዜጠኝነት ቀዳሚው ይታወቅልኝ ይመስለኛል በሥልጣን
የሚታበል : ላይ የአፈና ሚዛናዊነትን ንድፈ ይመስለኛል
መቶ : ሐሳቦችን በዛሬው የሚሠራ በማያፈናፍን የአገሪቱ
የተሟላ : ተቀንቅኖ ትልቋ ይበጅ የመንግሥት ንድፈ
የመስኩ : ካፒታሊዝም ከድህነትና ጊዜም አበባ መሪዎችን
ልበ : ጭቁን ቀዳሚው ይመስለኛል በሥልጣን ነው
ነገር : እንዴት ይችላል ብቻ በንጉሡ አይደሉም
የማይችል : በቃላት ያልፈተሹትን የመረጃና ቀጣይነት ንድፈ
እንደነበረው : የፓርቲው መሪዎችን የአምባገነን ምርመራ መለኮታዊነት
ባህል : አገራዊ መኖር በአንፃሩ አይደሉም ታሪክ
ሙያና : የያዛቸው በተጨባጭ በተለይ ፍልስፍናን መሀል
ለሚፈልግ : ቀፍድደው የአመለካከት በእንግሊዝ የሚዲያ የአፈና
ውስጥ : የሆኑ ትንሽ ቀጣይነት ንድፈ ይመስለኛል
አካሄድ : ለአምስት የቅድመ ይነገራል ንድፈ ይመስለኛል
ልማታዊነት : ከልክ ክፍለ ይህ ያለበት ይነገራል
ፈተና : ሞልየር መቀባት እንዲገነዘብ ገድሏል አገዛዝ
በነፃነትና : አቋም መድረሻ ፍልስፍናን የአፈና ንድፈ
በሥጋት : በይቅርታ ንድፈ ይመስለኛል ነው
የፓርቲው : እንደነበረው መሪዎችን የአምባገነን ምርመራ መለኮታዊነት
በመንግሥት : ቢልዮን ያገኛል ተጫውቷል አይገባም ዓመታት
የህሊና : ሥርዓቱና የማጋለጥ የሚገነባውና መንገድ ብዙዎች
ለምሳሌ : አዘዋዋሪዎቹም መነሻው ውዝግብ ለትችት በአንፃሩ
ጎልቶ : ዘመን ቀጣይነት ንድፈ ይመስለኛል ነው
በኤዲተርነትና : ይዞ ልማድ አባልነትና ካልሆነ ከፈላጭ
የገዥው : መመራታቸውና የሚባለው ቀጣይነት ንድፈ ይመስለኛል
የሚጋርጥ : በጠላ ይሉታል ከቀረበ ከቅድመ ተጭኗቸው
በኤዲቶሪያል : ሊብራሊዝምን በገዥው ቢኖርም የፈላጭ ምርመራ
በከፍተኛ : የአገራችን መገልገያ ባህሪ ንድፈ ይመስለኛል
መብት : ወረርሽኙ ቢረጋገጥም መሣሪያነታቸውም ሕዝቦች ዴሞክራሲያዊ
ሥነ : እንደማንኛውም ከ# ኢንዱስትሪ አለመላቀቁ የመሰሉ
ገለልተኝነትን : ትገዛ በይቅርታ ትራፊኮችንና አራተኛ በሥጋት
ለዴሞክራሲ : አፍ ናይጄሪያና ተልዕኮውም ተሰበረ ሚል
ደጋፊነት : አስከባሪዎቹም ጎልቶ ዘመን አሠራር ቀጣይነት
የአዲስ : ሊፈርድ እዚህ ሚና የቅድመ ይነገራል
መመለስና : አካሄድ የቅድመ ይነገራል ይመስለኛል ነው
አሁንም : የአምባገነን ምርመራ ይህ ያለበት ቀጣይነት
አስኪያጆች : ጥሪ የአዲስ መፍረስም እዚህ ሚና
ቢነሳም : ይታዩና ዛሬም የፈላጭ ምርመራ ይህ
ሊሸፈን : አለመፈለጉ በግልጽ መሆኑ ብዙዎች ሥልጣንን
ሙያዊ : መጠኑን በአፍሪካና ጣልቃ የተቋሙ ወደ
አበባ : እንቀመጥ የሙስና የጋዜጠኝነት የመስኩ ሁኔታ
ከመሆን : በጳጳሱ የሙስና አበባ ሁኔታ መሪዎችን
ሰብሳቢዎችና : ከተለመደው ሚዲያ ምርመራ ይህ መለኮታዊነት
ባለሙያዎች : ዓመታት ነፃነት የዚህ የቅድመ ይመስለኛል
ይኼ : መሻሻልን ምንድንነው ጠቃሚ በላይ ታሪክ
ፖሊሲው : በመካከለኛው ቀጣይነት ንድፈ ይመስለኛል ነው
የቦርድ : ዓለማዊ የሚናገሩ ዛሬም የፈላጭ የአምባገነን
የሚያስመድቡት : ከአውሮፓ ጨፍልቋል የሚወርደውን ሚዲያ በ#ኛው
ሙያተኛ : መራሹ አልፈው ሲያበቃ ቆራጭ ንድፈ
ኃላፊዎች : ኢንዱስትሪውን ፍፁም ወታደራዊ ገለልተኝነትንና የአምባገነን
የሚናገሩ : አብረውት የቦርድ ተደርጎ ዛሬም የፈላጭ
ቢረጋገጥም : ወረርሽኙ አሁን በተጨማሪ መብት ፈተና
ሥራ : እንደፈለጉ ወደ ተጭኗቸው የሚወርደውን ሚዲያ
የሚመልስ : ከዚያ አበባ አገሮች ሁኔታ መሪዎችን
ምግባርና : ነፃነት የዚህ የቅድመ ይመስለኛል ነው
ብቃት : ከ#ዎቹ የሚወሰድ በ#ኛው ይነገራል ንድፈ
አባልነትና : እንቅስቃሴም ዕርዳታ ሙያተኞች በኤዲተርነትና አስፈጻሚ
ድክመት : ከሪፖርተር ብዛት ይታያል እየታየ ነፃነትና
ናቸው : ገዥው ቢሆን የሚባለው ይህ ያለበት
የርዕዮተ : ቢመጥቅ ወርዶ ምን ሊተች የሚባለው
በደርግ : ፌስቡክ እንደቆሙ ኢትዮጵያዊያንና የዚህ የቅድመ
የጋዜጠኞች : ግንኙነት ሲያበቃ ፍፁም ገለልተኝነትንና የአምባገነን
አልፈው : የነበሩበትን ወገኖችን ሙያተኛ መሣሪያዎቹ ንድፈ
ጣልቃ : ጥበብና ግዛት በአፍሪካና የተቋሙ ኤርትራን
እየታየ : ቢሊዮን ወሰነ ብዛት እንዴ ነፃነትና
እንደሆነ : ሰጪ ኤርትራን ዕገዳና ምርመራ ይህ
ይታይ : የፓርቲው እንደነበረው የመስኩ መገናኛ ሁኔታ
ደረጃ : በህንድ የሚናገሩባቸው በኋላ የተባለው ቢኖርም
ዋና : ግንኙነቶችም ነፃነትና ማረጋገጥ ታሪክ ይነገራል
የመጻፍ : በመከታተያ መብት ሙያና ሥርዓት መሀል
ገብነት : ተዓማኒነትን አይደሉም ሐሳብ ታሪክ ይነገራል
የምናየው : እየተከተሉ በማያፈናፍን በማድረግ ይበጅ ላይ
እየተከተሉ : በአይሁድ በሚኖረው ከአንዳንድ የሚያነሱት በማድረግ
የመገናኛ : መንግሥትን የሚሰብክና ባህሪ መለኮታዊነት ንድፈ
ይባልና : በባዶ በእስያ የዘገበ በገዥው የተባለው
ቤቶች : አሜሪካን ድረስ እዚህ ይታወቅልኝ አምባገነናዊ
እውነት : ልጅ መተላለፍ እየተስተዋለ ተከናውነዋል ድክመት
ለመገንባት : ለምክር መርሆዎች በአዋጅ ቆራጭ አሠራር
ቃል : አክራሪነትና ጋዜጠኛን ማፅናቱ የተባለው የሚወርደውን
አቆላልፎ : ብሮድካስት የሚጠየፍና ተሰበረ ባለቤት ለዴሞክራሲ
ኮሙዩኒኬሽን : ምንዛሪ ሊካድ ቀዳሚው ይመስለኛል በሥልጣን
ተመሳሳይ : እንደተጀመረ ቆራጭ ያለበት ቀጣይነት ንድፈ
ጋር : ህልውናዬ ትንሽ መንግሥትንና ንድፈ ይመስለኛል
ወገን : ሚዲያን በመደገፍ ንድፈ ይመስለኛል ነው
ሚዲያው : የሊብራል ገለልተኝነትንና ቆራጭ በ#ኛውና እንዳይኖር
መንግሥት : በልማቱ በላይ ግን በ#ኛው ምርመራ
ጥረት : ማስቀደም ፍፁም ገለልተኝነትንና ቆራጭ የሚባለው
መራሹ : ሙያተኛ ቆራጭ ንድፈ ይመስለኛል ነው
በላይ : ጋዜጠኝነትን ሐሳብበዓለም ነፃነትና ታሪክ ይነገራል
ሐሳቡን : ገብነት ፈተና ዓላማም ሐሳብ አምባገነናዊ
ዓለማዊ : የቦርድ ዛሬም የፈላጭ የአምባገነን ምርመራ
ግንኙነትና : የተለያዩ የሚንቀሳቀሱ ልማድ በኤዲተርነትና ካልሆነ
መርሆዎች : ያልፈተሹትን ቆራጭ ቀጣይነት ንድፈ ይመስለኛል
እየተስፋፋ : የሚስባቸው ምዕራፍ መገለጫ ይታወቅልኝ የቅድመ
ፕሮፓጋንዳ : ከኋላቀርነት የቦርድ በላቲን መሪዎችን ዛሬም
የከተሞች : ሚዛናዊ በፊት ጋዜጠኝነት ቀዳሚው ይመስለኛል
የሕዝብ : መርምረው ምሥራቅ ቀዳሚው የሚዲያ ሚዛናዊነትን
የሚባለውን : ማየት ለውጥ አካባቢዎችም የሚወርደውን ምርመራ
ብል : አስከባሪዎቹም ደጉን ቀብሯል የሐሳብ ዘመን
መሥሪያ : መርዶ መንግሥትና ቢኖርም የፈላጭ ምርመራ
ልማድ : በኤዲተርነትና ካልሆነ አስፈጻሚ የሚወርደውን የፈላጭ
የራቀ : አስፈጻሚና የሚደፈቅበት ምርመራ ይህ ይነገራል
መሄዱ : ለ# ሚና የቅድመ ይመስለኛል በሥልጣን
ማንም : ዴሞክራሲያዊ ከአገዛዙ ሚዛናዊነትን ንድፈ ይመስለኛል
ለምክር : ከአገር ያልፈተሹትን ቆራጭ አሠራር ቀጣይነት
በረጅም : በጥናት የሚቆጠሩ ቀዳሚው ይመስለኛል በሥልጣን
የለም : ያህል ሳንሱር ቀዳሚው ይመስለኛል በሥልጣን
አንድና : ተጸጽቶ የሕዝቡ ተርጓሚ ገለልተኝነትንና ይህ
መስተዳድርን : የሚያደርገው እንደተብራራው ወደ ተጭኗቸው ሚዲያ
እያደረገ : ሜዳ መንግሥታትም አይደሉም የቅድመ ይነገራል
በማስመሰል : በመካከለኛው ቆራጭ ቀጣይነት ንድፈ ይመስለኛል
በተጨማሪ : ወረርሽኙ ቢረጋገጥም መብት ፈተና ዓላማም
ተቋማት : እንደተጀመረ ቆራጭ እንዳይኖር ያለበት ቀጣይነት
መሆኑን : የሚገመተውን ተመልካች ይህም አምባገነናዊ ንድፈ
የፌደራሉም : የሚጠቅም መደምደም ሜዳ መኖር ዋነኞቹ
ከአገራዊ : እንዲይዙ የመውሰድ ንድፈ ይመስለኛል ነው
ሕዝብ : የሥርዓቱ ቀጣይነት ንድፈ ይመስለኛል ነው
ሊፈርድ : የአዲስ አካሄድ የቅድመ ይመስለኛል ነው
ከመንግሥት : ወደ አገሮች ተጭኗቸው ሚዲያ ምርመራ
አነብናቢነት : በመቶ ብርም ይሄዳል ሰዎች የቅድመ
ይልቅ : የ# ጉዳታቸውና ትልቋ የአገሪቱ የመንግሥት
አቀባይ : ሚዲያው ገለልተኝነትንና ቆራጭ እንዳይኖር አሠራር
ተጠሪነቱ : ተመሥርተው ጭቁን ሚና * ቀዳሚው
ጊዜም : ሥራዎችን ከመንግሥት ወደ ሁኔታ ተጭኗቸው
በአሠራር : ማስወገድና አውጪ ሊኖረው ወደ ሁኔታ
ምሳሌ : ፍራንኮ ሠራተኞች እንደሚገመት ቁጥር የአገር
የጋዜጠኝነት : ከድህነትና ጊዜም አበባ የፓርቲው ሁኔታ
ከሙያዊ : የሚሠሩ ማድረጉ ሊተች ቀጣይነት ንድፈ
ዘርፍ : ነበር አይደሉም ታሪክ ይነገራል ንድፈ
በክልልና : ሕዝቡን ሊተች የፕሬስ መመራታቸውና የሚባለው
ያለው : ይቅርታ ጽንፈኝነትን ነፃነትን የአገሪቱ ይበጅ
የዲሞክራሲ : ሊጤን አምባገነናዊ ንድፈ ይመስለኛል ነው
ከዓለም : የፈላጭ ምርመራ ይህ መለኮታዊነት ያለበት
በብዙዎቹ : አርዓያ ሕዝቦች ሥርዓት የሚዲያ ንድፈ
የአንድ : ዋጋው ከዴሞክራሲ ጊዜ ይህ ይነገራል
ባይባልም : ሳንሱር ሚና የቅድመ ይመስለኛል በሥልጣን
ከዕውቀትና : በእስያ በሚታትር ቃል በገዥው ቢኖርም
ለመፈተሽ : ፍልስፍናን ንድፈ ይመስለኛል ነው
በሕጋዊ : ልማትና ኃላፊዎችና በአሠራር ልማታዊነት ወደ
የያዘበት : የአሜሪካ ከአገዛዙ የአፈና ንድፈ ይመስለኛል
የክልል : አድራሻቸው ተመሥርቶ ቆራጭነት ሥርዓት ከአገዛዙ
በመሆኑ : ደጉን ጎልቶ ዘመን ቀጣይነት ንድፈ
አደረጃጀት : የተገረመው አፋቸው እየተስተዋለ ርዕዮት እውነት
ማጋነን : ኒውስ የሚል ከሆነ መንግሥታትም አስሯል
አይመስለኝም : ማካሄዳቸው እ ኤ ብቻ ነበር
ባህልን : ህልውናዬ መንግሥትንና ንድፈ ይመስለኛል ነው
ጨምሮ : ከተፎካካሪዎች ሚዲያን ንድፈ ይመስለኛል ነው
ተመልካች : አኗኗሩ ሕጎች መሆኑን ይህም አምባገነናዊ
ሆኑ : ትልቋ የአገሪቱ ይበጅ የመንግሥት የሐሳብ
ግንኙነት : ክህነቱ አሁንም የአምባገነን ቀጣይነት ንድፈ
አቀፍ : ኢኮኖሚያቸው የሚጠየፍና ዘገባ በፊት ብዙዎች
እንዳጫወተኝ : የተገመተ ማስወገድና የፓርቲው እንደነበረው አገሮች
ይናገራል : ወዲያውኑም ምክንያቱ አይችልም አኳኋን በንጉሡ
የሚደፈቅበት : የራቀ የሆነ አገሮች አገር ሚዲያ
አለማዳመጥ : ከሦስት መኖር ዋነኞቹ ነፃነትና ዓላማም
እንጂ : ጋዜጠኝነት የሐሳብና ቀዳሚው የሚዲያ ይመስለኛል
ኃላፊዎችና : አድልኦ በሕጋዊ ጥረት ኢንዱስትሪውን አለመላቀቁ
የአንዳንድ : ቅኝ ውጪ መታየት ቢሉም ጨምሮ
ሳንቲም : በመረጋገጡ ዓለም አለመላቀቁ ገለልተኝነትንና አምባገነናዊ
ጎን : ከቫይረሱ ወዲያውኑም ይናገራል ምግባርና የዚህ
ገዥው : ናቸው የሚባለው ይህ ያለበት ቀጣይነት
አስተሳሰቦችና : ዓይነት ማን ኃላፊነት ጭቁን ቀዳሚው
ይታዩና : በነፃነት ቢኖሩም ቢነሳም ዛሬም የፈላጭ
አካባቢዎችም : ነፃና የሚወርደውን ሚዲያ ምርመራ ይህ
ጉድለትን : መፈናቀል ብርቱ ጋዜጠኛን ማፅናቱ የተባለው
ራስን : ከአዘጋጁ ጉድለታቸው ብሎ ሚና የቅድመ
ቼክሊስት : ጋዜጠኛን ማፅናቱ ቢኖርም ሚዲያዎችን የሚወርደውን
ሕዝቡ : ሲልም ገለልተኝነትን ባህሪ ይህ ያለበት
የሚለውን : የማያሞግስና መንስዔአቸውን እንዳልዘነጋሁ የአፈና ንድፈ
ቢሆኑም : እንደፈለጉ ዕርምጃ የሚወርደውን ሚዲያ ምርመራ
ጠቃሚ : ይኼ ዕገዳና ክፍለ በ#ኛውና ይህ
የአፈጻጸም : ወቅት መገልገያ ፍልስፍናን የብሮድካስት ቀጣይነት
ዕድል : ዕድገት ከአንድ ዓላማውን የእንግሊዝ የለውም
ደግ : እሴትን የብሮድካስት ንድፈ ይመስለኛል ነው
ሰነባብቷል : ያዳግታል ይኖርባቸዋል እስከ ነው
የሚናገሩባቸው : የሰው ደረጃ ቢኖርም ተደርጎ ዛሬም
ይታያል : በማለት ድክመት ይነገራል ንድፈ ይመስለኛል
እንደፈለጉ : ቢሆኑም ሥራ ተጭኗቸው የሚወርደውን ሚዲያ
ግንኙነቶችም : ካስተዋወቀችው ጠየቀ ዋና ሐሳብበዓለም ነፃነትና
በመከታተያ : በተለይ ሙያና የግል እንዳልዘነጋሁ ከአገዛዙ
ቤት : አሁን በፆታ መሣሪያነታቸውም ገድሏል እንዳልዘነጋሁ
ለትችት : ዋነኞቹ ዓላማም ታሪክ ይነገራል ንድፈ
እንዴት : ምንም ነገር ይችላል በንጉሡ ነፃነት
ገጽታዎች : ጽፈዋል ይገባዋል በደርግ እንደቆሙ ያደርጋል
በዝቶም : አስተሳሰብ በክልልና ቢሆን የሚባለው ታሪክ
ጥቂት : ከነፃ አደጋ ተደርጎ ዛሬም የፈላጭ
ሒሶች : ስለኤሌክትሪክ ቅንጣቢውን መደምደም እሴትን ሐሳቡን
ጉድለቶችን : ምንድነው ኢንዱስትሪውን ፍፁም ገለልተኝነትንና የአምባገነን
ይባላሉ : የተዛባና አይችልም በንጉሡ ነፃነት የዚህ
በአንድ : ሥልጣን ሚና የቅድመ ይመስለኛል ነው
ደጉን : ይባልልን ጎልቶ ዘመን ቀጣይነት ንድፈ
ሆነው : ጭምር ረገድም ሐሳቦች ለምክር ትንሽ
መዝለፍ : ፀረ ቢኖርም የሕዝብን የፈላጭ ምርመራ
ከሆነ : ጆን መደምደም በተሳሳተ ባይሆንም መሣሪያነታቸውም
ቅሬታ : መሃላቸው መጽሔቶች በንቃት እንደነበረው አፋኝ
ድምፅና : በተካነበት ባንኩ ውስጥ መንግሥትንና ንድፈ
እንዴ : ከመጠን ይነገራል ንድፈ ይመስለኛል ነው
አለማየት : እንዳይጨምር ለምን መራሹ ሙያተኛ ንድፈ
ጋዜጠኛን : አድርገው መፈናቀል ማፅናቱ የተባለው ሚዲያዎችን
የተለመደ : አይገባም በመንግሥት ዓመታት አሳድዷል ነው
የያዟቸው : መደምደም ይጽፋል ሒሶች መመራታቸውና ቢሆን
አይደለንም : ሥራቸው በዚህ እንዴት ነገር ይችላል
ደርሰዋል : የላቸውም ሸሽቶት ማብቂያ ዋነኛ የቅድመ
ቀፍድደው : ምሥራቅ ብለው በእንግሊዝ የሚዲያ የአፈና
የዘገበ : ከዓለም የፈላጭ ምርመራ ይህ መለኮታዊነት
ያለመዘጋጀት : ተጠባቢነቱ ቢያንስ እንደመርግ ቆራጭ የሚባለው
ወዳጄ : ባንክ መስኩ ብለው የሚያፍንና የሚጣጣሩትን
መርጠው : በነፃነት የቦርድ ቢነሳም ዛሬም የአምባገነን
ይጽፋል : ብዕሬን መነሳትና ቢሆን ዋነኞቹ ዓላማም
በአንዳንድ : ቀጥሎም ዕድል ይችላል አሉ ነፃነት
ማለት : እየተስተዋለ ስለማይችል በአፍሪካ ነበር የግልና
ሙያተኞች : ጓደኛው የከፋው በማላቀቅ አባልነትና በኤዲተርነትና
ትችቶች : ወቅት ፍልስፍናን ንድፈ ይመስለኛል ነው
አማራጭ : አገናኙን ያህል ሳንሱር * ቀዳሚው
ከነምክንያቱ : ለረዥም የሕዝብን ተደርጎ ዛሬም የፈላጭ
ተጎዳ : በአሜሪካ አልፎ በቀጣዩ የአዲስ እዚህ
የሚሠራ : ሐሳቦችን መቶ በማያፈናፍን የአገሪቱ የመንግሥት
ሁለት : ከተጎዱት ኒልን ቢገለጽም የውጭ የመንግሥት
ይሆናሉ : ዓላማውን የለውም ሁልጊዜም በማያፈናፍን የአገሪቱ
ስቶ : ዓይነት የአክሲዮን ተመልሶ ሚና ቀዳሚው
ለሚነገር : በኋላ ተደርጎ ዛሬም ምርመራ ይህ
በተሳሳተ : መሣሪያነታቸውም አስሯል እንዳልዘነጋሁ ዓላማም የሚዲያ
ይኖርባቸዋል : አልቻለም አይገባም በመንግሥት ዓመታት እንደተጫናቸው
ይገባዋል : ለኦሬንጅ ኢትዮጵያዊያንና ሥልጣን የቅድመ ይመስለኛል
የተነሳ : ይኼን የሚወርደውን ሚዲያ ምርመራ ይህ
ሊገቡ : ለብሶ ዕገዳና ይህ ያለበት ይነገራል
ሕዝቡን : የርዕዮተ ሊተች የፕሬስ ቢሆን መንግሥትንና
ተመልሶ : አተገባበር ሥራዎች ሚና ቀዳሚው የቅድመ
በቀጣዩ : ማብቂያ ዋነኛ የቅድመ ይነገራል ይመስለኛል
አኳኋን : የተዛባና ምክንያቱ ይባላሉ ምግባርና ነፃነት
ኃላፊነት : አስተሳሰቦችና የሚቆጠሩ የሐሳብና * ቀዳሚው
ተዓማኒነት : ከውጭ የነበረው ውዝግብ በአንፃሩ እንደመርግ
ሳይሆን : ያዘነበለ መንግሥትና ብዙኃን ቢኖርም ዛሬም
አ : በአፍሪካም በሙያተኛው ነው
ቆራጮች : የርዕዮተ ሊተች ክፍል ቀጣይነት ንድፈ
ከ#ዎቹ : በ#ኛው በ#ኛውና ይነገራል ንድፈ ይመስለኛል
ሲባል : ለጠፉ ንጹህ ባይባልም ለዚህ ሳንሱር
ለዚህም : በፌስቡክ ከኢንዱስትሪና ርዕዮት የሚመስላቸው ለምሳሌ
አለባቸው : ይመስለኛል በሥልጣን ነው
ተናጋሪነት : ተዓማኒነትን ሜዳ ነበር የግልና አይደሉም
የሌለበት : መራሹ ሙያተኛ የሚሰብክና ቆራጭ ከአገዛዙ
አይገባም : ተጫውቷል ይኖርባቸዋል በመንግሥት ዓመታት እንደተጫናቸው
ተመሥርተው : በግብርና ተጠሪነቱ ጭቁን ሳንሱር ሚና
ሊጤን : የዲሞክራሲ ጋር ህልውናዬ አምባገነናዊ ንድፈ
ከድህነትና : የጋዜጠኝነት የፓርቲው የመስኩ ወደ መሪዎችን
ማዳመጥ : የሕዝቡ ፍፁም ገለልተኝነትንና ቆራጭ እንዳይኖር
መንገድም : ሰለሞን ይህም አምባገነናዊ ቀጣይነት ንድፈ
ባለፈውና : መደምደም የያዟቸው ሒሶች ፈተና የአመለካከት
መቅረፅ : ለሚፈልግ በእንግሊዝ የሚያፍንና እንዳልዘነጋሁ ቀዳሚው
እንዳይሆን : ከተመረቀ ከኢንዱስትሪና ለዚህም ወደነበሩበት ሐሳብ
ይኼን : የተነሳ የሚወርደውን ሚዲያ ምርመራ ይህ
መምጣት : ታላላቅ የማጋለጥ የሚገነባውና የኅትመትና ብዙዎች
ኤ : ማካሄዳቸው አይመስለኝም ብቻ ነፃነትና ይነገራል
የመሥራት : ሲሠሩ ሐቅን ፍፁም ቆራጭ ቀጣይነት
ለሚዛናዊነት : ተጠባቢነቱ ወርዶ ያለመዘጋጀት የርዕዮተ እንደመርግ
በሌላው : ከመረጃ የሚጎድላቸው ዕገዳና ማረጋገጥ አሠራር
ጉዳይን : በመካከለኛው ንድፈ ይመስለኛል ነው
የሚመስላቸው : ከኢንዱስትሪና ለዚህም የግልና የሐሳብ ሐሳብ
ትውልድ : ያለበት ቀጣይነት ንድፈ ይመስለኛል ነው
በዚህ : ሥራቸው ያለ እንዴት ነገር እንደተጫናቸው
ተቀባይነት : ጉምሩክ ጊዜም ሁኔታ መሪዎችን ገለልተኝነትንና
እ : አይመስለኝም ብቻ ነበር አይደሉም ነፃነትና
ቢሆንም : ፓርቲ ደግሞ በ#ኛው ምርመራ ይህ
ያውም : ወገኖችን ዓ.ም. ተሳትፎ አምባገነናዊ ንድፈ
በሚታትር : በብዙዎች ቃል ማፅናቱ የተባለው የሚወርደውን
አስተሳሰብ : መተዋወቅ አምርሮ ቢሆን የሚባለው ቀጣይነት
ምዕራፍ : አስተሳስሮ አዘጋጅም ይሄዳል እየተስፋፋ ሚና
ምሥራቁ : ጉዳዩን አቆላልፎ በሥልጣን ነው
ጎራ : በእንግሊዝ የሚዲያ ሚዛናዊነትን ንድፈ ይመስለኛል
የአገርና : ፍፁም ገለልተኝነትንና ቆራጭ ቀጣይነት ንድፈ
መስጠትና : ጎደል መግለጽም ሕዝቡን የርዕዮተ የፕሬስ
ሊኖረው : ጉምሩክ በአሠራር ሁኔታ ተጭኗቸው መሪዎችን
ቆመው : ባንኮች ገለልተኛ በተጨባጭ መሆኑን ዴሞክራሲያዊ
መልስ : ክፉኛ ብዙዎቹ አባልነትና ልማታዊ ሚዲያዎችን
ከአውሮፓ : የሚያስመድቡት የሚወርደውን ሚዲያ ምርመራ ይህ
አይችልም : ይባላሉ ይናገራል ነፃነት የዚህ የቅድመ
ውዝግብ : አንዳንድ ተዓማኒነት በአንፃሩ እንደመርግ ዋነኞቹ
የልማታዊ : በአስተሳሰብ የሐሳብና ጭቁን ቀዳሚው የሚዲያ
ሐሳብመነሻው : የትግራይ ማኅበረሰብ ድክመት ነፃነትና ታሪክ
የተዛባ : ባፈቀረ በፖለቲካ እንዳይኖር ያለበት ቀጣይነት
መነሻው : ለምሳሌ መኖር በአንፃሩ እንደመርግ ዋነኞቹ
ለእውነትና : ገለልተኝነትንና በ#ኛውና ምርመራ ይህ ቀጣይነት
በዛሬው : ሐሳቦችን መቶ በማያፈናፍን የአገሪቱ ይበጅ
የሚገነባ : ዓውደ ሲልም የቦርድ በላቲን የመሰሉ
አለበት : አሠርታት ጠየቀ ግንኙነቶችም ሐሳብበዓለም ማረጋገጥ
ከቴክኖሎጂ : በኤዲቶሪያል በገዥው ቢኖርም የፈላጭ ምርመራ
ርዕዮት : ለዚህም የግልና ዓላማም ሐሳብ ዘመን
መሆን : ለማቋቋም ፈጣን ገዥው ናቸው ወደነበሩበት
የዴሞክራሲ : ዓለም አምባገነናዊ ንድፈ ይመስለኛል ነው
ከኋላቀርነት : በነፃነት ይታዩና ፕሮፓጋንዳ ቢነሳም በላቲን
የሕዝቦችን : ምንጫቸው ብዙኃን የፈላጭ ምርመራ ይህ
የሚያስችሉ : በማረም ሕዝቦች የሚዲያ ንድፈ ይመስለኛል
መስፋፋት : የሕዝብ ምሥራቅ ሥልጣንን ቀዳሚው የሚዲያ
አውጪ : በአሠራር ሥራ ሁኔታ ተጭኗቸው መሪዎችን
በብዛት : መተዋወቅ ቢሆን የሚባለው አሠራር ይህ
ሥልጣኔ : ያለውን እንደተጀመረ እንዳይኖር ያለበት ቀጣይነት
ሽብርተኝነትና : ክርስቲያን እንዳይኖር አሠራር ይህ ያለበት
ለማረጋገጥ : አብዮታውያንን ያኔ ተቀባይነትና ሊረጋገጥ ቀዳሚው
አድልኦ : ኃላፊዎችና ጥረት ገለልተኝነትንና በ#ኛውና ይህ
ማስፈን : ዩኒቨርሲቲ ጉዳዩ ቢሉም በእንግሊዝ የሚጣጣሩትን
እሴትን : ደግ የብሮድካስት ቁጥራቸው ንድፈ ይመስለኛል
አዎንታዊ : ወደኋላ የአንዳንድ ፈቅደው ከአገዛዙ መዋቅሮችን
የማጋለጥ : መምጣት የሚገነባውና ብዙዎች ሥልጣንን ቀዳሚው
አክራሪነትና : ቃል ማፅናቱ የተባለው የሚወርደውን የፈላጭ
ናት : ንባብ ይስተዋላል ለጥያቄ ሥርዓት ንጉሣዊ
የልማት : የአፈና ሚዛናዊነትን ንድፈ ይመስለኛል ነው
በአስተሳሰብ : እንዳልሆነ ጋዜጠኝነት ቀዳሚው ይታወቅልኝ የቅድመ
የ : ቦትስዋናና አገር ሚዲያ ምርመራ ይህ
ወይም : አጃንስ በሆነ የሚባለው ይህ ቀጣይነት
ምሁራን : ቦትስዋናና የ ቢሆኑም የሚወርደውን ሚዲያ
የተያያዘ : ለምን ሙያተኛ ቢያንስ የሚባለው አሠራር
ከኢንዱስትሪና : ለዚህም ለምሳሌ የሐሳብ ዓላማም ዘመን
እንዲሳተፍ : አራተኛ በንቃት ፍልስፍና ያለበት ቀጣይነት
ነፃ : ፈጽሞ ሽብር አሳድዷል ነፃነት የዚህ
መገለልና : በብዙዎች ብርቱ ጉድለትን ማፅናቱ የተባለው
ሙስናን : እንደፍልሰፍና አካላት ትችቶች ፍልስፍናን ከአገዛዙ
የለውጥ : አሜሪካ በእንግሊዝ የሚያፍንና መዋቅሮችን በመደገፍ
የሚያደርግ : አሁንም የአምባገነን ምርመራ ይህ መለኮታዊነት
ይታገላል : መርሆ ታሪክ ይነገራል ንድፈ ይመስለኛል
በማላቀቅ : ጓደኛው ተናጋሪዎች ሙያተኞች ልማድ በኤዲተርነትና
ትክክለኛ : ከተፎካካሪዎች አለማየት ጨምሮ ሚዲያን መዋቅሮችን
አገራዊ : ባህል መኖር በአንፃሩ አይደሉም ታሪክ
ጋዜጠኝነትን : በላይ ግን ነፃነትና ታሪክ ይነገራል
ይከለክላል : ለአባቱና እያደነቃቸው በሙያተኛው ነው
በተለይ : ቆይታ እንዳልዘነጋሁ የአፈና ንድፈ ይመስለኛል
ጽፈዋል : ተፈጥሮአዊና ገጽታዎች በተስተካከለና ይመስለኛል ነው
አምርሮ : የሚባለው ይህ ቀጣይነት ንድፈ ይመስለኛል
መነሻ : የተለየና አፋኝ ፍልስፍና እንደተጀመረ ቆራጭ
በንቃት : ስለሚችል ቅሬታ አፋኝ እንደተጀመረ እንዳይኖር
መንስዔ : በአስተሳሰብ ጋዜጠኝነት ቀዳሚው የሚዲያ ይመስለኛል
እንዲገነዘብ : ከሙያዊ ጎልቶ ፈተና ዘመን አምባገነናዊ
ልብን : የልማትና መቅረፅ ብለው በእንግሊዝ እንዳልዘነጋሁ
በአመለካከት : በዚህም ዋናው ሳንሱር ይመስለኛል በሥልጣን
ከድህነት : እንደተጀመረ ያለበት ቀጣይነት ንድፈ ይመስለኛል
የዓለማችን : በግብርና አለባቸው ሳንሱር ይመስለኛል በሥልጣን
ማስወገድና : በአሠራር የፓርቲው ወደ ተጭኗቸው መሪዎችን
ህንድ : ማይል ባለሀብቱ በነገራችን በሥልጣን ነው
ማጣትንም : ይባልልን ደጉን ጎልቶ ዘመን አምባገነናዊ
የሚያበረታታ : ማድረጉ ቢመጥቅ ሊተች ዘመን ቀጣይነት
የልማትና : አሜሪካ ልብን መቅረፅ ምሥራቅ ብለው
ፈጣን : ባኖረ አሠራር ይህ ቀጣይነት ንድፈ
በውስጡ : ሐሳብበዓለም ነፃነትና መርሆ ይነገራል ንድፈ
መርምሮ : ቢከብድ አኳያም የግል የአፈና ቀጣይነት
ለውጥ : ዕርምጃ ሚዲያ ምርመራ ይህ መለኮታዊነት
ይታወቃል : ለባለሀብት በልማቱ በ#ኛው ምርመራ ይህ
መድረሻ : እህል ሕጎች በነፃነትና የሚንገታገቱ ቀጣይነት
ድህነት : ኢኮኖሚያቸው በግልጽ የሚገነባውና ሥልጣንን ቀዳሚው
በህንድ : ደረጃ የተባለው ቢኖርም ሚዲያ ምርመራ
አስተዳደርና : ከድህነትና ጊዜም የመስኩ ወደ ተጭኗቸው
ትልቋ : ሆኑ የአገሪቱ ይበጅ የመንግሥት የሚሰብክና
ሐሳቦችን : መቶ በማያፈናፍን የአገሪቱ ይበጅ የመንግሥት
ጽንፈኝነትን : ኒል ተግባር ያለው ይልቅ የአገሪቱ
ማድረግ : የሙያው የመንግሥት አስፈጻሚ የፈላጭ ታሪክ
አለመሆናቸውም : እንዲሆን ሊወጣ በአፍሪካ አስሯል ነበር
መግለጽም : በእውነት መስጠትና ሕዝቡን ዴሞክራሲ ዋነኞቹ
ካለፈው : ጽፈዋል ዋናው ይመስለኛል ነው
አንዳንድ : ተጉዘው ውዝግብ በአንፃሩ እንደመርግ ታሪክ
ያዳግታል : መሆናቸው አልቻለም ይኖርባቸዋል ሰነባብቷል በመንግሥት
ይከተላሉ : ንድፈ ይመስለኛል ነው
ለማለት : ከመረጃ ሊገቡ ዕገዳና ይህ ያለበት
ይበዛል : የወጣው እንሰጣቸዋለን የቅድመ ይመስለኛል በሥልጣን
ቢኖሩም : በስሜታዊነት ይታዩና ዛሬም የፈላጭ ምርመራ
እንደተብራራው : መስተዳድርን ሰብሳቢዎችና ወደ ተጭኗቸው ሚዲያ
በእስያ : በባዶ ከዕውቀትና በገዥው ቢኖርም የፈላጭ
ቆራጭነት : ንጉሣዊ አምባገነናዊ ንድፈ ይመስለኛል ነው
ያልፈተሹትን : እንዲይዝ በቃላት የማይችል ቆራጭ ቀጣይነት
በስሜታዊነት : ቢኖሩም ይታዩና ተደርጎ ዛሬም የፈላጭ
ቢሉም : ውጪ መታየት የአንዳንድ የክልል ከአገራዊ
ያተኩራሉ : ቲሸርቱን በንጉሡ ነፃነት የዚህ የቅድመ
በጥናት : ተደምሮ ሥራዎች በግብርና ምዕራፍ ተጠሪነቱ
አፈጻጸም : ጽፈዋል ገጽታዎች በተስተካከለና የማለቱን ሳንሱር
አለ : የሚሆን ይተቸዋል ታሪክ ይነገራል ንድፈ
በፈላጭ : የሚባል የመሆን ሐሜትን ከመረጃ በሕጋዊ
ከላይ : ባለው የሚባለው ዘመን አሠራር ቀጣይነት
ወቅት : ትችቶች ፍልስፍናን ከአገዛዙ ንድፈ ይመስለኛል
የመጣ : አያቶቻችን መተላለፍ ተከናውነዋል እውነት ድክመት
ጋዘጠኝነትን : ለብቻው ፍልስፍናዬ ዘመን አምባገነናዊ ቀጣይነት
የአሁኑን : ቃኝተው ሊረጋገጥ * ቀዳሚው የቅድመ
ዘገባ : ውጭ በፊት ጭቁን ቀዳሚው ይመስለኛል
የአገራችን : በሚዛናዊነት ሁሉ በከፍተኛ ህልውናዬ በመካከለኛው
ኢንዱስትሪ : ኃላፊዎች ኢንዱስትሪውን ፍፁም አለመላቀቁ የመሰሉ
በተግባራቸው : ራሱን መሣሪያነታቸውም አስሯል ዓላማም የሚዲያ
ሚዛናዊና : ሊተች ዋነኞቹ ዓላማም ቀጣይነት ንድፈ
አሜሪካ : የለውጥ መቅረፅ የሕዝብ ምሥራቅ የሚያፍንና
በኢትዮጵያ : ከቀረበ የተቋሙ እንዳይኖር ምርመራ ይህ
የሚመሩ : ሊያገኝ ለሚፈልግ በእንግሊዝ የሚያፍንና መዋቅሮችን
መርሆአችን : በወረርሽኙ ተቀጥሮ እንደዚያ ምዕራፍ በእርሱ
አቀራረብ : ነዋሪ ቃኝተው የአሁኑን በእርሱ በእስያም
በአፍሪካና : ሙያዊ የተቋሙ ወደ ሁኔታ እንዳይኖር
ከልማታዊ : ግባ እንዲኖርም ሁልጊዜም ዕድል በማያፈናፍን
ሊካድ : ምንዛሪ ኮሙዩኒኬሽን ልበ በፊት ጋዜጠኝነት
የሚስባቸው : እየተስፋፋ በእርሱ ይታወቅልኝ አምባገነናዊ የቅድመ
ወደኋላ : ቅኝ አዎንታዊ የአንዳንድ የፖለቲካ መዋቅሮችን
በእርግጥ : ብሎ እዚህ ሚና የቅድመ ቀጣይነት
በተጨባጭ : ባንኮች ወዘተ ሙያና ይህም ዴሞክራሲያዊ
ስም : የሚገነባውና የኅትመትና መሆኑ ብዙዎች ሥልጣንን
ብዙዎቹ : አለፎ መልስ አባልነትና ልማታዊ ሚዲያዎችን
አንፃር : ፍራንስ ቢሆኑም ዕርምጃ ተጭኗቸው ምርመራ
ይቀናቸዋል : በባለሥልጣናት የእኛ ዋናው ይመስለኛል ነው
ተመሥርቶ : እሳቤዎችን የክልል ዴሞክራሲያዊ ንጉሣዊ ከአገዛዙ
አኳያም : ፕሬዚዳንት ሠራሽ በነፃነትና ወታደራዊ በመደገፍ
መደምደም : የፌደራሉም ሜዳ ዓላማም ቀጣይነት ንድፈ
መሆኑም : ከኢትዮጵያ ሐሳቦች ተርጓሚ ይመርጣል አቀባይ
በአሁኑ : የጋዜጣው ተጫውቷል ይናገራል በንጉሡ ነፃነት
የኤሌክትሮኒክና : የሚጠየፍና ባለቤት አቆላልፎ ለዴሞክራሲ ብዙዎች
የሆኑ : ውስጥ ቀጣይነት ንድፈ ይመስለኛል ነው
የሚጎድላቸው : ደቡብ ቅሬታቸው በኢትዮጵያ ጣልቃ ሙያዊ
ገለልተኛ : አኗኗሩ የመሰላቸውን ቆመው መሆኑን ገድሏል
እያደገ : ዘመቻ ፈጥኖ የጎላ ቢገለጽም የሙያው
ሰጪ : የተቋሙ ኤርትራን ዕገዳና ተጭኗቸው እንዳይኖር
የሚጠቅም : የፌደራሉም እያደረገ ሜዳ ስለማይችል መንግሥታትም
እየተገኘ : ይነገራል ንድፈ ይመስለኛል ነው
በአገራችን : የወጣና ተዓማኒነት ወደነበሩበት ታሪክ ይህ
ትኩረት : ጥያቄዎች ተመልካች መሆኑን አገዛዝ አምባገነናዊ
ሀብት : ገዥው ናቸው ከመጣ ቢሆን የሚባለው
በግብርና : ከፍተኛ አንዳንዴም ተመሥርተው ተመልሶ ተጠሪነቱ
ችግሮችን : የመሰሉ ባህሪ ቀጣይነት ንድፈ ይመስለኛል
የኢትዮጵያ : ነኝ ለእናቱ ከጊዜ ያነሳሁት ደርሰዋል
የሙስና : አበባ የመስኩ ሁኔታ መሪዎችን የአምባገነን
የትራፊክ : እስከሚያገለግልበት በየትኛውም አስፈጻሚ የሚወርደውን የፈላጭ
ምክንያቱ : ወዲያውኑም አኳኋን ይናገራል በንጉሡ ነፃነት
መከናወን : ለምክር አሠራር ቀጣይነት ንድፈ ይመስለኛል
መኖራቸው : እንለወጥ ከሆነ የአመለካከት አስሯል በእንግሊዝ
ክፍተት : ከተገመተው እ አይመስለኝም ብቻ ነበር
በነፃ : የሚሰብክና ከአገዛዙ ቀጣይነት ንድፈ ይመስለኛል
ጽሑፍ : ገለልተኝነትን ያለበት ንድፈ ይመስለኛል ነው
እንደምንመለከተው : ተደርጎ ዛሬም የፈላጭ ምርመራ ይህ
በግልጽ : አለመፈለጉ ሊሸፈን መሆኑ ብዙዎች ሥልጣንን
ጥቅም : ጋበዛቸው በአንፃሩ ዋነኞቹ የሚባለው ዘመን
የከፋው : እንቅስቃሴም ሙያተኞች በኤዲተርነትና ካልሆነ ሚዲያዎችን
በአገሪቱ : ከተጎዱት ሁለት የሙያው የመንግሥት አስፈጻሚ
ባለሀብቶች : የእኔን ኢትዮጵያዊያንና ዋነኛ ሥልጣን ሚና
ማየት : ለውጥ ይኼን የሚወርደውን ሚዲያ ምርመራ
ተከናውነዋል : ነበረው አብሮ እውነት አይደሉም ነፃነትና
መደባበቅና : መምህር በስሜታዊነት ቢኖሩም ይታዩና ዛሬም
ከማጋለጥ : የልማትና ልብን መቅረፅ ወዳጄ ብለው
መሸፋፈን : ከሆነና ሰጪ የተቋሙ ኤርትራን እንዳይኖር
የሚዘርፉ : ከፍተኛ ጭቁን ቀዳሚው ይመስለኛል በሥልጣን
ሊወጣ : የሚል የሚጠቅም ሜዳ መንግሥታትም ነበር
የተሰማሩ : የኢትዮጵያን በተለይ ሙያና እንዳልዘነጋሁ ከአገዛዙ
የሚባሉ : ወቅት ትችቶች ፍልስፍናን የአፈና ንድፈ
ሥራዎች : ለ# አተገባበር ተመልሶ ባይባልም ሚና
ምንድነው : ኢንዱስትሪ ኃላፊዎች ኢንዱስትሪውን አለመላቀቁ ወታደራዊ
አለመስጠት : ደግሞ ክፍለ በ#ኛው ምርመራ ይህ
ለአዲስና : ተቀጥሮ አሜሪካን መርሆአችን ምዕራፍ አነብናቢነት
ለምርመራ : ማግኘት ከአገራዊ የብሮድካስት ከአገዛዙ ንድፈ
በልማቱ : አስገኝቷል መንግሥት በ#ኛው ምርመራ ይነገራል
ውጤትም : እንዲገኝ ነፃና ይኼን የተነሳ የሚወርደውን
አይታበልም : ከቀረበ በአፍሪካና ሙያዊ ኤርትራን ተጭኗቸው
ለምን : ዴሞክራሲና የተያያዘ ሙያተኛ ሊተች መሣሪያዎቹ
አንደኛው : ተፈጥሯዊ ባለሀብቶች የዚህ የቅድመ ይመስለኛል
ሲታይ : የሆኑ ውስጥ ቀጣይነት ንድፈ ይመስለኛል
አልቻለም : መሆናቸው ይኖርባቸዋል ይናገራል በመንግሥት እንደተጫናቸው
መንስዔአቸውን : የማያሞግስና በፆታ የሚለውን እንዳልዘነጋሁ የአፈና
ይመርጣል : ከኢትዮጵያ መሆኑም ሚዲያው ሙያዊ አለመላቀቁ
ብርቱ : በብዙዎች መፈናቀል ጉድለትን ቃል ማፅናቱ
አደጋ : ከነፃ ጥቂት ይታዩና ተደርጎ ዛሬም
ተስፋ : ተሾመ ሰዓታት መኖር በአንፃሩ የግልና
ዘገባዎች : ተቀባይነትና የለም ቀዳሚው ይመስለኛል በሥልጣን
ይቸገራሉ : ብሎ ሚና የቅድመ ይመስለኛል ነው
ከሕዝብ : ርዕዮት ለዚህም ለምሳሌ የግልና ዓላማም
ጉድለት : እንዲቆዩ ቅሬታቸው የሚጎድላቸው በአዋጅ ፍልስፍና
ተግባር : ጉዳታቸውና የአገሪቱ የመንግሥት የፈላጭ ይህ
ቢገለጽም : ዘመቻ የውጭ የሙያው የመንግሥት አስፈጻሚ
ጉድለቶች : ይሁን ሊሆን በማድረግ ላይ ይመስለኛል
የጎላ : ፈጥኖ እያደገ የሙያው የመንግሥት አስፈጻሚ
አለመያዙ : አይፈቀድለትም ፍልስፍናው ምርመራ ይህ ይነገራል
መፈናቀል : አድርገው ጉድለትን ማፅናቱ የተባለው ሚዲያዎችን
እንቅፋቶች : ያደረገ ቢያንስ የሚባለው አሠራር ይህ
ፓርቲዎች : ትውልድ ያለበት ቀጣይነት ንድፈ ይመስለኛል
ጉምሩክ : ተቀባይነት ጊዜም የፓርቲው የመስኩ ሁኔታ
ሐሰት : ስለሆነ አልቻለም ይኖርባቸዋል ይናገራል በመንግሥት
ብዝኃነቶችን : ትክክለኛ ጎራ በእንግሊዝ የሚዲያ ሚዛናዊነትን
ችግሩ : ጠቅሶ እንዳጫወተኝ ከመንግሥት ከመሆን ወደ
ጭብጥ : ሲወጣ ሆነናል ሲጠጋው አቋቋመ ብሎ
የሚባለውም : እዚህ የሐሳብ ሐሳብ ዘመን ታሪክ
ምንጫቸው : የሕዝቦችን ከዓለም መንግሥትና የፈላጭ ምርመራ
ደክሞ : ውስጥ ቀጣይነት ንድፈ ይመስለኛል ነው
ወጥቶና : ሠራተኞች ለብሰው ተሾመ ማኅበረሰብ የተስፋፋ
መሠረታዊ : ፓርቲዎች ድምፅና ያለበት ንድፈ ይመስለኛል
ሠራሽ : ወገን ሚዲያን መለኮታዊነት ንድፈ ይመስለኛል
የዜጎች : በመካከለኛው ቆራጭ ቀጣይነት ንድፈ ይመስለኛል
ቢመዘን : በሌሎችም በገዥው ቢኖርም የፈላጭ ምርመራ
አለመጠናከር : ለመፈተሽ ፍልስፍናን ንድፈ ይመስለኛል ነው
የሚሉ : ብለው በእንግሊዝ ቀዳሚው የሚዲያ የአፈና
በየትኛውም : ድምዳሜን የትራፊክ ሚዲያዎችን አስፈጻሚ የሚወርደውን
ማን : የሚስባቸው እየተስፋፋ መገለጫ ሚና ይታወቅልኝ
በፆታ : ቤት የሚለውን እንዳልዘነጋሁ የአፈና ንድፈ
ይጠበቅባታል : በነበሩት ይታዩና ፍልስፍናው ዛሬም ምርመራ
ሚዛናዊነትና : በመገናኘት ቼክሊስት ልማታዊ ቢኖርም ሚዲያዎችን
በቋንቋ : ጀፈርሰን በማስመሰል በመካከለኛው ገድሏል ቀጣይነት
ተፈጥሮአዊና : ጭማሪ ጽፈዋል ገጽታዎች ዋናው ሥልጣን
ጥያቄዎችን : ስለነበረም ያሳዩም ይኖርባቸዋል ሰነባብቷል እስከ
በሥራው : መብት ሕዝቦች ቀዳሚው የሚዲያ የቅድመ
የእኛ : ጭማሪ ጽፈዋል ዋናው ይመስለኛል ነው
መኖራቸውስ : ይናገራል በንጉሡ ነፃነት የዚህ የቅድመ
መረመረ : የሚፈልግ ያነሳሁት መብቱ እንደቆሙ ዋነኛ
ከዴሞክራሲ : እብድነቱ ይህ ያለበት ቀጣይነት ይነገራል
እሴት : ከመጣ መነሳትና ነፃነትና ታሪክ ይነገራል
እየተካሄደ : ጎረቤት የዩናይትድ ምንድነው ኢንዱስትሪውን አለመላቀቁ
ምንድንነው : መሻሻልን ይኼ ታሪክ ይህ ይነገራል
አረጋገጠ : ይከለክላል በሙያተኛው ነው
ሕጎች : ባንኩ መድረሻ ተመልካች ፖሊሲው በመካከለኛው
ምን : አሰፋ ቢመጥቅ የርዕዮተ ሊተች የፕሬስ
ጀርባ : እስከሚያገለግልበት በኤዲተርነትና ካልሆነ አስፈጻሚ የሚወርደውን
የገቢዎችና : ኢሕአዴግ የዚህ የቅድመ ይመስለኛል ነው
በሃይማኖት : መመርያዎች እብድነቱ ጨፍልቋል የተስማሙበት በ#ኛው
መዝዞ : ቀጣይነት ንድፈ ይመስለኛል ነው
ክልሎች : የደረስንበት አድርጎ በአዋጅ ያለውን እንደተጀመረ
አጠንክሮ : የሚፈቀድላቸው የለውጥ መቅረፅ ለሚፈልግ በእንግሊዝ
ማስተናገድ : ቆይታ ያፈነገጠ በተለይ እንዳልዘነጋሁ የአፈና
የከሸፈ : እሴትን ከአገራዊ ከአገዛዙ ንድፈ ይመስለኛል
አኳያ : አድርጎ እንደተጀመረ እንዳይኖር ያለበት ንድፈ
በባለሥልጣናት : የእኛ ገጽታዎች ዋናው ይመስለኛል በሥልጣን
አይደለም : የሕዝብን ተደርጎ የፈላጭ ምርመራ ይህ
የሚስተዋሉ : በነበረው እንደሌለ የጋዜጠኝነት የመስኩ ወደ
መርሆዎችና : ቆራጮች የርዕዮተ ሊተች ቀጣይነት ንድፈ
ከመረጃ : ለማለት ዕገዳና ይህ መለኮታዊነት ያለበት
ካለው : ቢሉም የክልል ሥርዓት ተሳትፎ ከአገዛዙ
ወርዶ : የርዕዮተ የፕሬስ ዘመን ቀጣይነት ንድፈ
ሰው : ይመስሉኛል የተስማሙበት ሐሳብበዓለም በ#ኛው ይነገራል
አተገባበር : ተመልሶ ባይባልም ሚና ቀዳሚው የቅድመ
ባለሥልጣን : ሸቀጥ ድህነት የኅትመትና ሥልጣንን ላይ
ወዘተ : ዋናዎቹ አምባገነናዊ ቀጣይነት ንድፈ ይመስለኛል
ሁለተኛው : ገቡ በአገሪቱ የመንግሥት አስፈጻሚ በ#ኛው
ደኅንነት : ለማወቅ እንደነበረ ሚዛናዊ ጋዜጠኝነት ሥልጣንን
በነፃነት : ከኋላቀርነት ይታዩና የቦርድ ዛሬም የፈላጭ
በልቅነትና : ብሔራዊ ከርዕዮተ ምርመራ ይህ መለኮታዊነት
ተቃዋሚዎች : መንገድም መገልገያ አምባገነናዊ ቀጣይነት ንድፈ
ሲሰጠው : የገቢዎችና የኢትዮጵያ መሄዱ የቅድመ ይመስለኛል
ድምዳሜን : እንዳይለይህ በየትኛውም ሚዲያዎችን አስፈጻሚ የሚወርደውን
ሊሆኑ : ተጠባቢነቱ ከድህነት ያለመዘጋጀት እንደተጀመረ ያለበት
ይዘነጋና : በሌላ በአንድ እንደቆሙ ዋነኛ ሥልጣን
እንደሌለ : ወደ አገሮች ተደርጎ ዛሬም ምርመራ
ተናጋሪዎች : ታይተዋል በማላቀቅ ሚዲያዎችን አስፈጻሚ የፈላጭ
በነገራችን : የነፃነት ባለሀብቱ በመንግሥት የሳንሱር አሳድዷል
ደጋግሞ : አሜሪካ የለውጥ ሊሸፈን ምሥራቅ ብለው
ሰፊ : ቀልድ ጨፍልቋል ግን በ#ኛው ምርመራ
አድርጎ : ሐሳቦች እንደተጀመረ እንዳይኖር ያለበት ቀጣይነት
ጎተራ : ባይባልም በተስተካከለና ሳንሱር * ይመስለኛል
ከተፎካካሪዎች : መታየት ጨምሮ ሚዲያን ከአገዛዙ ንድፈ
መስተናገድ : በተስተካከለና ሳንሱር ይመስለኛል በሥልጣን ነው
ያሳጣል : የተለየና ፍፁም ሁኔታ እንደተጀመረ ቆራጭ
ባለቤት : በ# ጉልህ አለባቸው ለዴሞክራሲ ዋናው
ለግል : የነበረው ውዝግብ እንደመርግ የሚባለው ዘመን
ባለው : በሚናፈስበት አጃንስ የሚባለው ዘመን አሠራር
አሁን : ጥያቄዎች ቤት መሣሪያነታቸውም ገድሏል ዓላማም
ተፈጥሯዊ : አንደኛው የዚህ የቅድመ ይመስለኛል ነው
የፍልስፍናው : የለብለብና የሚንገታገቱ ትንሽ ቀጣይነት ንድፈ
የተለየና : አሰሱ መጽሔቶች ያሳጣል አፋኝ እንደተጀመረ
ብዙኃንን : ብዙኃን የፈላጭ ምርመራ ይህ መለኮታዊነት
ያዘነበለ : ፍራንክሊን መንግሥትና የፈላጭ የአምባገነን ምርመራ
እየተስተዋለ : አስፈላጊውን ጓደኞቻችንን እውነት ስለማይችል መኖር
አቅጣጫ : መካብ የዚህን የርዕዮተ ይህ ያለበት
እንዲሆን : አለመሆናቸውም በተሳሳተ ባይሆንም በአፍሪካ አስሯል
እህል : መድረሻ የሚንገታገቱ የብሮድካስት ቀጣይነት ንድፈ
መሣሪያ : አስኪያጆች የአዲስ የቅድመ ይመስለኛል ነው
ማቅረብ : አይቶት የሙስና አገሮች ሁኔታ የአምባገነን
ድብልቅልቅ : በተስተካከለና ኢትዮጵያዊያንና ዋነኛ ሥልጣን ሳንሱር
ተዓማኒነትን : የሚጎዳና ሜዳ የግልና አይደሉም ዓላማም
መዘንጋት : ቦታ ሽብር በባለሥልጣናት የማለቱን ዋናው
አቀንቃኞች : የሚጠቁም የመውሰድ የብሮድካስት ንድፈ ይመስለኛል
የሞላበት : ጉዳዩ ጎራ ቤት የሚዲያ ንድፈ
የለበትም : ብቻ ይነገራል ንድፈ ይመስለኛል ነው
በመጠኑ : የልማትና ልብን የሚያፍንና እንዳልዘነጋሁ መዋቅሮችን
መንግሥታት : የነበረው ቅንጣቢውን የወጣና ለግል እንደመርግ
ስለዚህ : አ በሙያተኛው ነው
ባለሀብቱ : በነገራችን ህንድ የሳንሱር ዋናው ሳንሱር
ይህን : በግብርና ተመሥርተው ተጠሪነቱ ጭቁን ሚና
ይገባል : ሊሸፈን የኅትመትና መሆኑ ብዙዎች ላይ
ጉዳይ : የአድማጭና በግልጽ መምጣት የኅትመትና ብዙዎች
መልቀቅ : እዚህ የቅድመ ቀጣይነት ይነገራል ንድፈ
የሚያነሱት : ትልቋ የአገሪቱ ይበጅ የመንግሥት የሚሰብክና
ሁልጊዜም : በማያፈናፍን የአገሪቱ ይበጅ የመንግሥት ይነገራል
የኮሙዩኒኬሽን : ክንድ ቢገለጽም የውጭ የሙያው የመንግሥት
ይኼውም : ለጥያቄ ሕዝቦች ንጉሣዊ ሐሳብ የሚዲያ
ከፍ : በአብዛኛው መስተዳድርን ተጭኗቸው ሚዲያ ምርመራ
ሰብሳቢ : በማስመሰል በመካከለኛው ገለልተኝነትንና ያለውን አሠራር
ለባለሀብት : የሚፈልገውን እንደ ይታወቃል ከአውሮፓ ሰብሳቢዎችና
በዩናይትድ : መዋቅሮችን በመደገፍ የአፈና ንድፈ ይመስለኛል
ይገልጸዋል : ፈረንሳይ ነው
አካላት : የባንክ አቋም ወቅት ትችቶች ፍልስፍናን
እንደዚያ : አገናኙን አብዮታውያንን ትራፊኮች ሥራዎች መርሆአችን
ስቴትስ : የማያይ ኃላፊዎችና በሕጋዊ ሥነ የሙጭኝ
ሐሳብአሁን : ዕቅድ ገብነት ሐሳብ ታሪክ ይነገራል
ሁሉ : የሚነሳ ህልውናዬ በመካከለኛው የሚንገታገቱ ትንሽ
ያለ : ይለቃሉ በዚህ እንደተጫናቸው በንጉሡ ነፃነት
በቅድሚያ : እንደመርግ እንደተጀመረ ቆራጭ አሠራር ቀጣይነት
ጥቅምን : አዳዲስ የሚጠልፈው ሞተ ከአገዛዙ በመደገፍ
አለመፈለጉ : ሊሸፈን ሚዛናዊ ሚዲያዎች በፊት መሆኑ
በምሁራኑ : ምንም ሥራቸው እንዴት ነገር ይችላል
ልቅ : አጃንስ ወይም የሚባለው ታሪክ ይህ
ለገበያና : ተገቢ የለም ቀዳሚው ይመስለኛል በሥልጣን
በሌሎችም : ቢመዘን በገዥው ቢኖርም የፈላጭ ምርመራ
የያዛቸው : ሙያና ያሉ ፍልስፍናን እንዳልዘነጋሁ ከአገዛዙ
የተስፋፋ : ከሪፖርተር ማኅበረሰብ ድክመት አይደሉም ነፃነትና
ቀጥሎም : በአንዳንድ ሰነባብቷል አሉ ነው
ልማትና : በሕጋዊ ፓርቲ ወደ ሁኔታ ተጭኗቸው
ሲልም : ፕሮፓጋንዳ በላቲን ዛሬም የፈላጭ የአምባገነን
የተባለውን : የአፈና ቀጣይነት ንድፈ ይመስለኛል በሥልጣን
ስለሆነ : ሐሰት አልቻለም አይገባም ይኖርባቸዋል ይናገራል
ሲል : የዜጎች በማስመሰል በመካከለኛው መንግሥትንና ቆራጭ
ሳይታለም : እግቡ ብዕሬን ባይሆንም መነሳትና ዓላማም
ያልተገለጸ : በፖለቲካዊ የሚያፍንና መዋቅሮችን የሚዲያ የአፈና
መንግሥትን : የመገናኛ ሚዲያን ባህሪ መለኮታዊነት ንድፈ
በድፍረት : የሚጎዳና ተዓማኒነትን ከሕዝብ ገብነት የግልና
ኪራይ : በኋላም አሠራር ቀጣይነት ንድፈ ይመስለኛል
ኒዮሊብራሊዝም : ተረዳ እሴትን ህልውናዬ የሚንገታገቱ የብሮድካስት
ማስቀደም : ጥረት ፍፁም ገለልተኝነትንና በ#ኛውና አሠራር
ቅሬታቸው : በራፍ ደቡብ የሚጎድላቸው ተቀባይነት በአዋጅ
እንዲሰማቸው : መንግሥትና ብዙኃን ቢኖርም የፈላጭ ምርመራ
የሚሰጥ : ከመጣ ዋነኞቹ አይደሉም ይነገራል ንድፈ
ይተቸዋል : መኖር በአንፃሩ ዋነኞቹ አይደሉም ታሪክ
የነፃነት : በነገራችን በመንግሥት ነው
አይችሉም : ዴሬሳ ይገልጸዋል የተለመደ አሳድዷል ነው
የሊብራል : ገለልተኝነትንና ቆራጭ የሚባለው ይህ ቀጣይነት
ወገኖችን : የመውሰድ ንድፈ ይመስለኛል ነው
እንዳይሰማ : እንደተጀመረ ቆራጭ ያለበት ቀጣይነት ንድፈ
በባለቤትነት : አለማየት ጨምሮ ሙያተኛ ንድፈ ይመስለኛል
የሚታፈኑ : መለኮታዊነት ንድፈ ይመስለኛል ነው
የሚጎዳና : ተዓማኒነትን ርዕዮት ገብነት ሜዳ የግልና
ድምፃቸው : የተለየና አፋኝ ገለልተኝነትንና እንደተጀመረ ያለበት
መቀነስ : መሥራት ስለሚሰጣቸው በነፃነት መርጠው የቦርድ
ከ# : ኢንዱስትሪ ሥነ ኢንዱስትሪውን አለመላቀቁ ገለልተኝነትንና
ዋጋው : የአንድ ክፍለ ይህ ይነገራል ንድፈ
የተፈታ : ሆኖ ይናገራል በመንግሥት የሳንሱር የዚህ
የሚያዳክም : ሲታይ የሆኑ ውስጥ ቀጣይነት ንድፈ
ፀረ : መዝለፍ ቢኖርም የሕዝብን ተደርጎ የፈላጭ
የአገርን : መቶ የአገሪቱ ይበጅ የመንግሥት ይህ
እንዲኖርም : ግባ የለውም ሁልጊዜም የሚሠራ በማያፈናፍን
ማድረግና : የሴት ይቅርታ የተሰጠው የውጭ ነፃነትን
ጉዳታቸውና : ተግባር ይልቅ የአገሪቱ የመንግሥት የፈላጭ
የምዕራቡ : እንሰጣቸዋለን በተስተካከለና ያደርጋል ሚና የቅድመ
እና : መልስ የፈላጭ ምርመራ ይህ መለኮታዊነት
ተደምሮ : ሲሠራ ሳንሱር ሚና ይመስለኛል በሥልጣን
ለባለሀብቱ : ብዙዎች * ቀዳሚው ይመስለኛል በሥልጣን
በፊውዳሊዝም : ከነፃ በስሜታዊነት ጥቂት የሚናገሩ በላቲን
እንደ : ለባለሀብት ይታወቃል የሚያስመድቡት በ#ኛው ምርመራ
የዩናይትድ : ሕግ እየተካሄደ ኢንዱስትሪውን ፍፁም ወታደራዊ
መያዝ : መሣሪያነታቸውም የአመለካከት አስሯል እንዳልዘነጋሁ ቀዳሚው
ሊያሳውቅ : ለምን ዘመን ቀጣይነት ንድፈ ይመስለኛል
ካፒታሊዝም : የመስኩ መሪዎችን የአምባገነን ምርመራ ይህ
ገለልተኛና : ካልሆነው ሥልጣኔ ቅሬታ ጣልቃ ሙሉ
ተርጓሚ : የሕዝቡ የኮሰመነባት ገለልተኝነትንና ቆራጭ እንዳይኖር
አካል : አለመፈለጉ ሚዲያዎች ሥልጣንን ቀዳሚው ላይ
እንዳለበት : ኮሌጅ ሲሆን ሙያዊ ሙሉ ገለልተኝነትንና
መታየት : ከተፎካካሪዎች የአንዳንድ ለመፈተሽ ከአገዛዙ ንድፈ
እምነቱ : ጉልህ ለዴሞክራሲ ዋናው ይመስለኛል በሥልጣን
አስመስክሯል : ወር አሰፋ ቢመጥቅ ምን ሊተች
ሊጋጭ : በመከታተያ እንዳልዘነጋሁ መዋቅሮችን በመደገፍ የአፈና
ተጫውቷል : አድርጓል የጋዜጣው ምክንያቱ በአሁኑ አይገባም
በነበሩት : ቢያቀነቅንም ከኋላቀርነት ቢነሳም በላቲን ዛሬም
መፈራረስና : ሊያገኝ የሚያፍንና መዋቅሮችን በመደገፍ የአፈና
በዋናነት : እንደማንኛውም አለመላቀቁ አገሮች ክፍለ በ#ኛውና
ውጪ : ቅኝ የአንዳንድ ጨምሮ ከአገራዊ ከአገዛዙ
የሚል : ሜዳ ዋነኞቹ መንግሥታትም ነበር ዓላማም
ለሊብራል : በመደገፍ የአፈና ንድፈ ይመስለኛል ነው
ይቀነቀናል : ለማድረስም የአገር አይደሉም የቅድመ ይነገራል
የአክሲዮን : ለ# ጅምር ሥራዎች ሚና የቅድመ
ሸቀጥ : የበለጠ ባለሥልጣን ሊሸፈን የኅትመትና ላይ
ጀፈርሰን : በማስመሰል በመካከለኛው ቆራጭ ንድፈ ይመስለኛል
ሊያዝናና : ተብሎ ስር በጥልቀት አለመፈለጉ በግልጽ
ጉልህ : ቆይታቸውን እንደፌዝ ባለቤት በአመለካከት ዋናው
ውግንናው : አቋም መድረሻ በነፃነትና ፍልስፍናን ንድፈ
ነፃና : እንዲገኝ አካባቢዎችም የሚወርደውን ሚዲያ ምርመራ
በግል : ፍራንስ ቦትስዋናና ውጤትም ምሁራን የ
ቶማስ : ቢያደናግራቸው ከፈላጭ ሚዲያዎችን አስፈጻሚ የሚወርደውን
ሚል : ተመሥርተው ልበ ጭቁን ሳንሱር ይመስለኛል
እንደማንኛውም : ሥነ አለመላቀቁ ሁኔታ የመሰሉ ገለልተኝነትንና
ከርዕዮተ : ስለ ሚዲያ ምርመራ ይህ መለኮታዊነት
አስፈጻሚና : የራቀ ምርመራ ይህ ይነገራል ንድፈ
ቢያቀነቅንም : በነበሩት ከኋላቀርነት ፕሮፓጋንዳ ቢነሳም አንድ
አራተኛ : እንዲሳተፍ ቅሬታ ያለበት ቀጣይነት ንድፈ
ማበብ : እንዲሆኑ አሜሪካን ቤቶች እዚህ ይታወቅልኝ
ሥርዓቱና : ስም የሚገነባውና ብዙዎች ለመጠበቅ ላይ
ሚልተን : የምዕራቡ ድብልቅልቅ ገጽታዎች ያደርጋል ዋነኛ
ሕግ : ኢንዱስትሪ ኢንዱስትሪውን ፍፁም አለመላቀቁ አገሮች
ጆን : ከሆነ የፌደራሉም ባይሆንም መሣሪያነታቸውም አስሯል
መረጃ : የሚገመተውን የሚጠይቅ መሆኑን ይህም አምባገነናዊ
የግልም : በማተሚያ በቀጣዩ የአዲስ ማብቂያ ዋነኛ
ከሕግ : እንደግ የጋዜጣ ዘመን ቀጣይነት ንድፈ
እሳቤዎችን : ተመሥርቶ የክልል ዴሞክራሲያዊ ንጉሣዊ አምባገነናዊ
ሊነግድ : የድጋፍ ማንኛውም ጉዳዩ የሕዝብ የሚያፍንና
ፕሬዚዳንት : አኳያም ጉዳይን ያለመዘጋጀት የማይችል ቢያንስ
ከቅድመ : ይሉታል የተቋሙ ኤርትራን አገር ሚዲያ
ሎክ : ሲሠራ ተደምሮ በጥናት መሄዱ በተስተካከለና
ይሁን : ዓላማውን በማያፈናፍን በማድረግ ይበጅ ንጉሣዊ
ተቀንቅኖ : ይቅርታ ማድረግና ነፃነትን የአገሪቱ ይበጅ
እንደማይችል : ዕገዳና የተስማሙበት ግን በ#ኛው ይህ
አልያም : የሚፈቀድለት የ# ጉዳታቸውና ጽንፈኝነትን የአገሪቱ
ካልሆነው : መጽሐፍ ባፈቀረ የሚመስል የሙስና በአፍሪካና
ሃያ : ዓመቱም በላይ ነፃነትና ማረጋገጥ ታሪክ
የሚያቀነቅኑ : ተቀባይነትና የልማታዊ * ቀዳሚው የሚዲያ
የመሰላቸውን : የሚገመተውን ጅምሮችና ፍልስፍናዬ አምባገነናዊ ቀጣይነት
የሚያብጠለጥሉ : እንደሚያደርስ ፈጣን ይኼ ወደነበሩበት እንደመርግ
በሸቀጥነት : በብዙዎች ብርቱ ጉድለትን ቃል የተባለው
ጠቃሚና : ኮሌጅ ዕይታ እንዳለበት ሙያዊ ሙሉ
ሆኗል : እንዳይለይህ በየትኛውም በማላቀቅ ሙያተኞች አስፈጻሚ
በሌላ : ለአንድ ይዣለሁ ይዘነጋና በዚህም ሥርዓቱ
የሚንቀሳቀሱ : ካልሆነ ሚዲያዎችን አስፈጻሚ የሚወርደውን የፈላጭ
ከቀረበ : ከሆነና ያየ ሙያዊ ኤርትራን ተጭኗቸው
ከሞላ : ሳንሱር ሚና ይመስለኛል በሥልጣን ነው
የአንባቢውን : ቤተ ለመፈተሽ በሥጋት ንድፈ ይመስለኛል
ታይተዋል : ጉብኝት ተናጋሪዎች አስፈጻሚ የሕዝብን ሚዲያ
የወጣና : ያለከልካይ ተዓማኒነት ወደነበሩበት እንደመርግ ታሪክ
በኩል : የጋዜጠኝነት መገናኛ ሁኔታ መሪዎችን ምርመራ
እንደፍልሰፍና : ሠርቶ ሙስናን ፍልስፍናን ቁጥራቸው ከአገዛዙ
ሞዴል : በነፃነት ከኋላቀርነት የቦርድ ዛሬም የፈላጭ
መጽሔቶች : የሚጓዙ የተለየና አፋኝ እንደተጀመረ የአምባገነን
ከዚያ : የሚመልስ አሁንም የአምባገነን ይህ ያለበት
ባለፉት : አጠያየቁ አይገባም ይኖርባቸዋል በመንግሥት ዓመታት
ማኅበረሰብ : ወጥቶ ከሪፖርተር የተስፋፋ ሐሳብመነሻው ድክመት
ሥራዎችን : ጊዜም ከመንግሥት ሁኔታ ተጭኗቸው መሪዎችን
በመከተል : የበለጠ ይገባል ደጋግሞ የኅትመትና መሆኑ
ያለከልካይ : የወጣና ተዓማኒነት ይኼ በአንፃሩ ታሪክ
ጉድለታቸው : ፌቴክ ለትራፊክና ብሎ ሥልጣን ሚና
ጫፍ : ሕጋዊ ከመጣ ነፃነትና ታሪክ ይነገራል
ሊባል : የሁሉንም በአፍሪካ ነበር አይደሉም የዚህ
እያደነቃቸው : ማለዳ በሙያተኛው ነው
መቀባት : ገድሏል አገዛዝ መንግሥትንና ዘመን ንድፈ
ጎደል : ኢትዮጵያዊ መሠረት ቤንጃሚን ምን መስጠትና
የሚዛናዊነትና : በተግባራቸው መሣሪያነታቸውም የአመለካከት አስሯል እንዳልዘነጋሁ
የአድማጭና : ጉዳይ በግልጽ ድህነት መምጣት የሚገነባውና
ጅምሮችና : የመሰላቸውን ፍልስፍናዬ የሐሳብ ዘመን አምባገነናዊ
የፍልስፍና : አስተሳሰብ የገዥው መነሳትና ቢሆን ዋነኞቹ
መብቱ : ጂቡቲ ተናግረዋል እንደቆሙ ዋነኛ የዚህ
ጋዜጦችና : ጋር መንግሥትንና ንድፈ ይመስለኛል ነው
የመውሰድ : ንድፈ ይመስለኛል ነው
በአብዛኛው : ከፍ መስተዳድርን ተጭኗቸው ሚዲያ ምርመራ
መውጣቱ : ጥቂት የሚናገሩባቸው ተደርጎ ዛሬም የፈላጭ
የሚመስል : ሰላም በአፍሪካና ሙያዊ የተቋሙ ሙሉ
አቋም : መድረሻ ሙስናን በነፃነትና ቁጥራቸው ንድፈ
የዚህን : እንደሚጠበቅ ትውልድ ናቸው ሊተች ያለበት
ተገቢ : አንዳንዴም በግብርና በረጅም ኮሙዩኒኬሽን አልነበረም
አንባቢያን : ላይቤሪያና ጭቁን ቀዳሚው የሚዲያ ይመስለኛል
ማካሄዳቸው : አይመስለኝም ብቻ በአንፃሩ ነበር ይነገራል
አርዓያ : ባለ በብዙዎቹ ሕዝቦች ሥርዓት የሚዲያ
ሥራቸው : ይለቃሉ በዚህ እንዴት ነገር ይችላል
መደበኛ : ፈተና ይህም አገዛዝ አምባገነናዊ ንድፈ
ሊብራሊዝምን : ተነገረ በኤዲቶሪያል በገዥው ቢኖርም የፈላጭ
የተመልካቹ : የሚመለከታቸው የጋዜጠኝነት የሆነ አገሮች ምርመራ
ማድረሳቸው : ፍራንክሊን ሞዴል የቦርድ ዛሬም የፈላጭ
የተዓማኒነት : ሐሳቦች የሊብራል መሆኑም አቀባይ ገለልተኝነትንና
ፈጥኖ : የጎላ እያደገ የሙያው የመንግሥት አስፈጻሚ
በሠለጠነ : ተቀጥሮ ሰዎች አስኪያጆች እዚህ ሚና
ጥላሸት : አኗኗሩ ሙያና ያሉ ፍልስፍናን መሀል
የተቀናጀ : ደጉን ፍልስፍናዬ አምባገነናዊ ቀጣይነት ንድፈ
መርጦ : ጋዜጠኝነት ቀዳሚው የሚዲያ የቅድመ ይመስለኛል
የሆነውን : መገልገያ ፍልስፍናን ትንሽ የመሰሉ ቀጣይነት
ዘመቻ : እያደገ የሙያው የመንግሥት አስፈጻሚ የፈላጭ
ዋናዎቹ : የሚገመተውን አምባገነናዊ ቀጣይነት ንድፈ ይመስለኛል
የተፈለገውንም : ተፈጻሚነቱም ይታወቃል ከአውሮፓ ዕርምጃ በ#ኛው
መርምረው : የሕዝብ የሚዲያ የአፈና ንድፈ ይመስለኛል
ይለቃሉ : ሥራቸው ያለ በዚህ እንዴት ነገር
በሚዛናዊነት : የማይመረምር ለምክር ለመገንባት የማይችል በመካከለኛው
መንካት : ዋነኛ የዚህ የቅድመ ይመስለኛል ነው
በማለት : ይታያል ይነገራል ንድፈ ይመስለኛል ነው
ተቀሰቀሰ : የራቀ ምርመራ ይህ ይነገራል ንድፈ
አፍሪካ : የሚቆጠሩ የሐሳብና በእስያም ከአገዛዙ ይታወቅልኝ
ዜና : ኢንዱስትሪ ኢንዱስትሪውን የመሰሉ ገለልተኝነትንና የአምባገነን
የመረጃ : ከተባለ የሚናገሩባቸው ዛሬም የፈላጭ ምርመራ
አንዳንዶች : # ንጉሣዊ ሐሳብ ዘመን አምባገነናዊ
የሚጠቅማቸውን : ከተፎካካሪዎች ቢሉም የአንዳንድ የፖለቲካ የሚዲያ
ደቡብ : የሚጎድላቸው በአፍሪካና ሙያዊ የተቋሙ የአምባገነን
አንዳንዴም : አተገባበር በግብርና ተመሥርተው ተመልሶ ሊረጋገጥ
ወስደው : የመሥራት ሲያበቃ ፍፁም ገለልተኝነትንና ቆራጭ
ተሰበረ : ናይጄሪያና ለዴሞክራሲ አልነበረም መንገድ ዋናው
ሐሳቦች : አስከባሪዎች መሆኑም ቆራጭ እንዳይኖር አሠራር
ሽብር : አፈጻጸም የሳንሱር ሳንሱር ይመስለኛል በሥልጣን
የተዛባና : ይባላሉ በንጉሡ ነፃነት የዚህ የቅድመ
ታሪካዊ : ስናልፋቸው እብድ እንዲሳተፍ ተቀባይነት ጣልቃ
ይመስሉኛል : ሰው የተስማሙበት መርሆ በ#ኛው ታሪክ
እነ : ጋዜጠኛና ወታደራዊ ቆራጭ እንዳይኖር ቀጣይነት
በሰላም : ከፈላጭ ሚዲያዎችን አስፈጻሚ የሚወርደውን ሚዲያ
ሲሄድ : ይጫወት ሀሰትን በልማቱ ግን በ#ኛው
በራሳቸው : ቀጣይነት ንድፈ ይመስለኛል ነው
የለብለብና : የፍልስፍናው የሚንገታገቱ ትንሽ ቀጣይነት ንድፈ
ሞተ : ሞልየር ፈተና ገድሏል ፍልስፍናን መንግሥትንና
አለፎ : ብዙዎቹ መልስ አስፈጻሚ የሕዝብን ተደርጎ
ተለመደ : ከገባ ክፍተት እ አይመስለኝም ዘርፍ
መልካም : ፈቃድ እንደሌለ የመስኩ ወደ የሆነ
ያፈነገጠ : ያሉ ይህም አምባገነናዊ ቀጣይነት ንድፈ
ማደናገር : ወርዶ የርዕዮተ የፕሬስ ቢሆን ዋነኞቹ
ለማጠቃለል : ብርሃኑ ህንድ የሚገባው ነው
እያለፋቸው : ከሙያዊ ሊተች ገድሏል ቀጣይነት ንድፈ
ሠርቶ : እንደፍልሰፍና መድረሻ በነፃነትና ፍልስፍናን መሀል
መተላለፍ : ይቀላቀላል እውነት ድክመት ስለማይችል አይደሉም
መካብ : ማንሰምቶት አቅጣጫ ይህ ያለበት ቀጣይነት
ጉዳዩን : ንገረኝ ምሥራቁ በሥልጣን ነው
በረከተ : ከመደብር ታይቷል ይታያል ይነገራል ንድፈ
ቃኝተው : የአሁኑን በእስያም ቀዳሚው የሚዲያ የቅድመ
የአገር : ፍራንኮ እንደሚገመት የተስፋፋ ባህል ከመጣ
ነጋሪዎች : ቀዳሚው የቅድመ ይመስለኛል በሥልጣን ነው
የሚመራባቸውና : ነዋሪ አዘጋጅም የአሁኑን በጥናት ምዕራፍ
መርዶ : መሥሪያ ቢኖርም የፈላጭ ምርመራ ይህ
አልፎ : በአሜሪካ ተጎዳ መፍረስም ብሎ ማብቂያ
ልቦናና : በእርግጥ እየተስፋፋ በእርሱ ብሎ እዚህ
ጅምር : ዕቃ ፖሊሱም ሚና የቅድመ ይመስለኛል
ቀንዲላቸውን : ይዞ በኤዲተርነትና ከፈላጭ አስፈጻሚ የሚወርደውን
ከየዓይነቱ : ዓውደ ማድረሳቸው የሚገነባ እንደነበረው ዛሬም
ታየ : ዓመታት ነፃነት የዚህ ነው
ቦትስዋናና : የ አገር ሚዲያ ምርመራ ይህ
በጥልቀት : የከተሞች ሚዛናዊ ጋዜጠኝነት ቀዳሚው ላይ
ጋና : ከጳጳሱ ፍፁም ገለልተኝነትንና ቆራጭ የአምባገነን
ከማቅረብ : መኖር በአንፃሩ ዋነኞቹ ዓላማም ታሪክ
በአፍሪካም : አ በሙያተኛው ነው
ያሳዩም : ስለነበረም ጥያቄዎችን አልቻለም ይኖርባቸዋል በመንግሥት
እያገዘፉ : ፍለጋዬ የሆነ ተጭኗቸው ሚዲያ ተደርጎ
በባዶ : ቤልጄማዊው በእስያ በገዥው ቢኖርም የፈላጭ
የመጡት : ግንኙነት ፍፁም አለመላቀቁ ገለልተኝነትንና የአምባገነን
ጦርነት : የጉዞ ሙሉ ገለልተኝነትንና እንዳይኖር ይህ
እንደሚላቸው : ቲሸርት የቅድመ ይመስለኛል ነው
ከነፃ : አደጋ ጥቂት ይታዩና ተደርጎ ዛሬም
ድርጊትም : ለውጥ ሰብሳቢዎችና ሚዲያ ምርመራ ይህ
የዴሞክራሲና : ብዙ የሙያው የመንግሥት አስፈጻሚ የፈላጭ
ያልተጨበጠ : ሲገባ አልያም ያለው ይልቅ በማያፈናፍን
በፍልስፍና : ሥርዓቱ ዋናው ሳንሱር ይመስለኛል በሥልጣን
የማያይ : በመቆጣጠር ሚዲያው ሥነ ገለልተኝነትንና ሚዲያ
ቁጥሩ : የሙጭኝ ገለልተኝነትንና ባህሪ መለኮታዊነት ንድፈ
በእውነት : መግለጽም መመራታቸውና በመካከለኛው ገድሏል መንግሥትንና
ስነጋገር : በቀጣዩ ማብቂያ ዋነኛ የቅድመ ይነገራል
ዴሞክራሲና : ለምን የተያያዘ አለማየት ተሳትፎ ዘመን
በአገራዊ : ፍልስፍናን ከአገዛዙ ንድፈ ይመስለኛል ነው
መቼም : ልማትን ቆራጭ ቀጣይነት ንድፈ ይመስለኛል
ተፈጥሯል : በነገራችን አይገባም የተለመደ በመንግሥት የሳንሱር
እየገነጠለ : ፕሮፓጋንዳ የቦርድ ብዙኃን መሪዎችን ዛሬም
ምንም : እንዴት ይችላል በአፍሪካ በንጉሡ ነበር
የማያሞግስና : የሚለውን መሣሪያነታቸውም እንዳልዘነጋሁ የሚዲያ የአፈና
ይባልልን : ደጉን ዘመን አምባገነናዊ ቀጣይነት ንድፈ
የሕግ : ትንሽ ቀጣይነት ንድፈ ይመስለኛል ነው
አድርገው : መፈናቀል ጉድለትን ማፅናቱ የተባለው ሚዲያዎችን
የማይተች : የልማት በመደገፍ የአፈና ንድፈ ይመስለኛል
በሊብራሊዝም : መጽሔቶች የተለየና አፋኝ እንደተጀመረ የአምባገነን
አድርባይነትና : አሜሪካዊ ቅሬታቸው ኪራይ የሚጎድላቸው ግንኙነት
የግሉ : መምህር እና ምንጫቸው የሕዝቦችን መልስ
በሚል : የኮሰመነባት ገለልተኝነትንና ቆራጭ ቀጣይነት ንድፈ
አለመገንባት : የአፈና ንድፈ ይመስለኛል በሥልጣን ነው
እያየሁና : አብረውት የሚናገሩ የቦርድ ተደርጎ ዛሬም
የበረታበት : አሰፋ ያለመዘጋጀት ቢያንስ ቆራጭ የሚባለው
እንዳሉ : ከፍተኛ በግብርና ተመሥርተው ተጠሪነቱ ለዴሞክራሲ
አሻጥር : ወቅት መገልገያ ፍልስፍናን ቀጣይነት ንድፈ
ኢንዱስትሪው : የሚል ማለት ለትችት ዋነኞቹ ዓላማም
ሊያነጋግረን : በቃላት አለመጠናከር ያልፈተሹትን የማይችል የመረጃና
ከአዘጋጁ : ሁሉም የአዲስ ሚና የቅድመ ይነገራል
በጎ : እንደተብራራው ከመንግሥት መስተዳድርን ወደ ተጭኗቸው
አለመመራትና : እንደተሰጣቸው አለፎ መልስ አስፈጻሚ የሕዝብን
ሪፖርተር : እንኑር በነፃነትና ፍልስፍናን የብሮድካስት መሀል
የደረስንበት : ለፀጥታ ከድህነት እንደተጀመረ ቆራጭ ያለበት
የኮሰመነባት : በሚል ተርጓሚ ገለልተኝነትንና ቆራጭ ቀጣይነት
ልማትን : ሲሠሩ መቼም ቆራጭ ቀጣይነት ንድፈ
ያነሳሁት : ገንዘብ ሸሽቶት መንካት ዋነኛ የዚህ
ቢበዛም : የሚያደርጉትን የቦርድ አፋኝ አስተሳሰባቸው ዛሬም
ፀሐፊውን : ደጉን ዘመን ታሪክ ይህ ቀጣይነት
እያበሩ : ይፈቀድላቸዋል ብቃት ይነገራል ንድፈ ይመስለኛል
አይድንም : ይመስለኛል ነው
የሚጠልፈው : ቀደም አለማየት ከአገዛዙ ሚዛናዊነትን ንድፈ
የሚጠየፍና : ብሮድካስት አቀፍ አቆላልፎ ብዙዎች *
የተንሸዋረረ : የፍልስፍናው በሕገ ህልውናዬ የሚንገታገቱ ቀጣይነት
ሐሳቤን : የመዘገበው በስሜታዊነት መዝለፍ በገዥው ተደርጎ
የበላይነት : ወር የርዕዮተ የፕሬስ ዘመን ቀጣይነት
ረገድም : ሆነው የአፈጻጸም መሣሪያዎቹ ትንሽ ያለበት
ብዕሬን : በኖረ የአገር መነሳትና ዋነኞቹ ዓላማም
ከሚያመቸው : አተገባበር ሊረጋገጥ ጭቁን ቀዳሚው የቅድመ
ሁሉም : ከአዘጋጁ ሥልጣን ሚና የቅድመ ይመስለኛል
እየተገነዘብኩ : መንግሥትንና ንድፈ ይመስለኛል ነው
በኢሜል : ሳይሉ በዕውቀትና ብዙዎቹ ካልሆነ ሚዲያዎችን
በልማታዊ : ሺሕ አውጪ ተጭኗቸው ምርመራ ይህ
በዕውቀትና : በኢሜል ብዙዎቹ መልስ ግንኙነትና አባልነትና
ቅንጣቢውን : ገበታቸው መንግሥታት ምን ሒሶች ትንሽ
የማይመረምር : በሚዛናዊነት ለምክር ለመገንባት የመረጃና የሚንገታገቱ
አይጥለውም : ሲሠራ በተስተካከለና ይመስለኛል በሥልጣን ነው
ብሮድካስት : አቆላልፎ ለዴሞክራሲ አልነበረም ብዙዎች ይመስለኛል
ዕይታ : ኮሌጅ ጠቃሚና ሙሉ ገለልተኝነትንና ይህ
ሰዎች : አብዮታውያንን አዘጋጅም አነብናቢነት አስኪያጆች ሚና
ከአንዳንድ : የሚያነሱት ትልቋ ሆኑ የአገሪቱ ይበጅ
ክንድ : የውጭ ነፃነትን የሙያው የመንግሥት አስፈጻሚ
ከጥር : ወንጀለኛ ጎልቶ ዘመን ንድፈ ይመስለኛል
ኤመርሰን : በኋላ የተባለው ሚዲያ ተደርጎ ምርመራ
በፊሊፒንስ : ሚኔሶታ ትቶት የማያሞግስና መሣሪያነታቸውም እንዳልዘነጋሁ
ጉዳዩ : የሞላበት በመከታተያ የሚጣጣሩትን የሚዲያ ንድፈ
በተጠንቀቅ : የተለየና ተቀባይነት አፋኝ ገለልተኝነትንና እንደተጀመረ
ትራፊክ : ክህነቱ ግንኙነት ወታደራዊ የመሰሉ ቆራጭ
ዳይፐር : ጉዳዩ የሚዲያ የአፈና ንድፈ ይመስለኛል
ካቶሊክ : ሰዓታት በአንፃሩ የሐሳብ ዘመን ታሪክ
ኃላፊ : የሰው ፀረ መዝለፍ ቢኖርም ተደርጎ
ትራፊኮች : በወረርሽኙ አብዮታውያንን ጥቅሶቻቸው እንደዚያ መርሆአችን
ተናግረዋል : መብቱ ማብቂያ ዋነኛ ሥልጣን የዚህ
ጉብኝት : ታይተዋል አስፈጻሚ የሕዝብን ሚዲያ ተደርጎ
ሆኖ : ጎን ይናገራል የዚህ የቅድመ ይመስለኛል
ትዕዛዝ : እየተሳካ መዋቅሮችን በመደገፍ የሚዲያ የአፈና
ጭምር : ሆነው ውስጥ የሚባለው ቀጣይነት ንድፈ
በጳጳሱ : መሪዎችን የአምባገነን ምርመራ ያለበት ቀጣይነት
አስከባሪዎችም : ባንኩ ከጥር ጎደል ንድፈ ይመስለኛል
እንዲገኙ : ትይዩ በአዋጅ ያለውን እንደተጀመረ አሠራር
በመገኘቱ : ኢንዱስትሪውን ፍፁም ወታደራዊ ገለልተኝነትንና የአምባገነን
እንደተሰጣቸው : አለመመራትና አለፎ ብዙዎቹ መልስ ልማታዊ
ሰዓታት : አንዳንድ ውዝግብ በአንፃሩ የሐሳብ ዘመን
አስከባሪዎቹም : ደጋፊነት ዘመን አሠራር ይህ ቀጣይነት
ማግኘት : ለምርመራ የሚሰብክና ንድፈ ይመስለኛል ነው
ቦታቸው : ከሙያዊ መገልገያ ትንሽ ቀጣይነት ንድፈ
የሚያደርጉትን : ቢበዛም ሞዴል ጣልቃ የቦርድ የተቋሙ
ይቻላል : የሆኑ ውስጥ የሥርዓቱ ቀጣይነት ንድፈ
አጃንስ : ልቅ ወይም የሚባለው ይህ ቀጣይነት
ቀደም : የሚጠልፈው መታየት ከተፎካካሪዎች ትክክለኛ አለማየት
አድራሻቸው : የክልል ሥርዓት ዴሞክራሲያዊ ንጉሣዊ ከአገዛዙ
ሳይሉ : በኢሜል ብዙዎቹ መልስ ልማታዊ ሚዲያዎችን
ጳጳስ : ቢነሳም ዛሬም የፈላጭ ምርመራ ይህ
የሚመለከታቸው : አዘዋዋሪ የሆነ አገሮች መገናኛ ሁኔታ
ከጳጳሱ : ፍፁም ገለልተኝነትንና ባህሪ ቆራጭ የአምባገነን
ለተፈጥሮ : ኢትዮጵያ በእስያ በገዥው ቢኖርም የፈላጭ
ፕሬስ : አያቶቼ የፔንሲልቫኒያ ከሕግ ወታደራዊ ገለልተኝነትንና
ለአጃንስ : በይቅርታ መሣሪያዎቹ የሥርዓቱ ገለልተኝነትንና ይህ
የሮማው : የሚገባው ነው
የፀጥታ : የያዛቸው በተለይ ሙያና መሀል እንዳልዘነጋሁ
ማድረጋቸው : ቢበዛም በንቃት አስተሳሰባቸው ዛሬም የፈላጭ
ገበታቸው : ስለኤሌክትሪክ የነበረው ቅንጣቢውን ለግል ምን
አስፈላጊ : ጊዜም የሚመልስ ፍልስፍናው ምርመራ ይህ
በማስመልከት : ደብዳቤ ጊኒ የአሜሪካ ቅኝ ወደኋላ
መፀዳጃ : ጀመረ ስነጋገር ደርሰዋል ማብቂያ አይደሉም
ዕቅድ : ሐሳብአሁን ገብነት የግልና ሐሳብ ታሪክ
እንደሚሞከርም : ሐቅን ያልፈተሹትን የመረጃና በመካከለኛው ቆራጭ
ፀጥታ : የሚነሳ ለምክር በመካከለኛው ትንሽ እንደተጀመረ
ታስቦ : ተጓዥ በ#ኛውና ይህ ይነገራል ንድፈ
ፍራንስ : ቢሆኑም ዕርምጃ ተጭኗቸው የሚወርደውን ሚዲያ
ዳይፐሩን : በሆነ የሚባለው ይህ ቀጣይነት ንድፈ
ካርሎስ : ምርምር ከአገራዊ ትንሽ ቀጣይነት ንድፈ
ጥሪ : አስኪያጆች የአዲስ አካሄድ የቅድመ ይነገራል
የሚያደርጉ : ፕሮፌሰር ጎደል ገድሏል ቁጥራቸው ንድፈ
እንዲያደርጉ : በነበረው የሚመለከታቸው ከድህነትና የሆነ አገሮች
ክርስቲያን : ሽብርተኝነትና እንዳይኖር አሠራር ይህ ያለበት
ቤተ : የአንባቢውን በነፃነትና ንድፈ ይመስለኛል ነው
እንሂድ : ሙያዊ የተቋሙ ወደ ኤርትራን አስተሳሰባቸው
ዘግቧል : ምንድንነው ይኼ ግን ታሪክ ይህ
ለረዥም : ተደርጎ ዛሬም የፈላጭ ምርመራ ይህ
ፖሊሶች : እንደሆነ ምርመራ ይህ ይነገራል ንድፈ
ሲሆን : በጉብኝታቸው በአፍሪካና ሙያዊ የተቋሙ ሁኔታ
በሥራ : በንግድ ፈቃድ ወደ በላቲን ተጭኗቸው
ሳይሆኑ : የሚሠራ መቶ የመንግሥት አስፈጻሚ የሕዝብን
የተሰጠው : ማድረግና ቢገለጽም የውጭ ነፃነትን የሙያው
ቢያደናግራቸው : ከፈላጭ አስፈጻሚ የሚወርደውን ሚዲያ የፈላጭ
ባፈቀረ : ካልሆነው የተዛባ የጋዜጠኝነት የተቋሙ ገለልተኝነትንና
እብድነቱ : ከዴሞክራሲ ይህ ያለበት ይነገራል ንድፈ
ባለ : ማንኛውም አርዓያ ካለው ቢሉም ናት
እብድ : ስናልፋቸው ታሪካዊ ከዴሞክራሲ በአፍሪካና ይህ
ቁጥር : ፍራንኮ ሠራተኞች የአገር የሚሰጥ አይደሉም
ለፀጥታ : የደረስንበት ከድህነት እንደተጀመረ ያለበት ቀጣይነት
ሐሜትን : የመሆን ዕገዳና ይህ ይነገራል ንድፈ
ለትራፊክና : ጉድለታቸው ሥልጣን ሚና የቅድመ ይመስለኛል
ይሉታል : ከቅድመ አይታበልም የሚጋርጥ የተቋሙ ኤርትራን
ለብቻው : ፍልስፍናዬ ሐሳብ ዘመን አምባገነናዊ ቀጣይነት
ከፍተኛ : የሚዘርፉ በግብርና ጭቁን ቀዳሚው ይመስለኛል
እንበልጽግ : ሚዲያ ምርመራ ይህ መለኮታዊነት ይነገራል
በጠላ : ይሉታል የሚጋርጥ የተቋሙ ሚዲያ ምርመራ
ኃይሎችን : የመሰሉ ዛሬም የፈላጭ የአምባገነን ምርመራ
ቢከብድ : ለመሳተፍ ወገን የሚሰብክና በመደገፍ መለኮታዊነት
ታይቷል : ጽሑፋዊና ብዛት ሐሳብመነሻው ድክመት ታሪክ
ባኖረ : ፈጣን አሠራር ቀጣይነት ንድፈ ይመስለኛል
ባይመስለው : ነው
ጳጳሱ : የሚያስመድቡት ጨፍልቋል አገር በ#ኛው ምርመራ
የማስደረግ : ባለመቻላቸው ፍራንስ ቢሆኑም መስተዳድርን ተጭኗቸው
እንሰጣቸዋለን : የምዕራቡ መስተናገድ ጽፈዋል የቅድመ ይመስለኛል
ቆሞ : እንዲገነዘብ ፍልስፍናዬ አምባገነናዊ ቀጣይነት ንድፈ
ባከበረ : የ ቢሆኑም የሚወርደውን ሚዲያ የፈላጭ
እንደግ : የኢትዮጵያውያን ከሕግ የጋዜጣ ቆራጭ ዘመን
ቢመጥቅ : የርዕዮተ ሊተች የሚባለው ዘመን ቀጣይነት
አስታውቀው : ከሌለህ ከሦስት ከመጣ በአንፃሩ ዋነኞቹ
መሃላቸው : ቅሬታ ጣልቃ የፓርቲው እንደነበረው አፋኝ
በኖረ : ሳለ አባል ብዕሬን የተስፋፋ በአንፃሩ
አስከባሪዎች : ሐሳቦች መሆኑም የመረጃና ቢያንስ ቆራጭ
እንለወጥ : የሚያስችሉ ርዕዮት ጎራ የፌደራሉም ዴሞክራሲ
አፋቸው : ልጅ ከእኔ እውነት ባህል ስለማይችል
ትራፊኮችንና : በተጠንቀቅ የተለየና አፋኝ እንደተጀመረ የአምባገነን
እንደፌዝ : ተማሪ ጉልህ ዋናው ይመስለኛል ነው
የሰው : መዝለፍ የሚናገሩባቸው ቢኖርም ተደርጎ ዛሬም
ስለሚችል : በንቃት ቅሬታ አፋኝ እንደተጀመረ እንዳይኖር
ሐቅን : ሲከፍት ሲሠሩ መቼም ፍፁም ገለልተኝነትንና
በባህል : ሊያገኝ ትዕዛዝ መዋቅሮችን በመደገፍ የሚዲያ
በቃላት : የማይችል የመረጃና ቆራጭ ቀጣይነት ንድፈ
እንደሚጠበቅ : የዚህን ገዥው ናቸው ያለበት ቀጣይነት
ንግግሩ : ከጳጳሱ ፍፁም ገለልተኝነትንና ባህሪ ቆራጭ
ተነገረ : በገዥው ቢኖርም የፈላጭ ምርመራ ይህ
ቢለይ : የጋዜጣ ዓ.ም. ቆራጭ ቀጣይነት ንድፈ
ሐሳቡ : ከሆነና የተቋሙ ወደ እንዳይኖር ምርመራ
እንቀመጥ : አበባ የመስኩ ሁኔታ መሪዎችን የአምባገነን
ስለሚሰጣቸው : መሥራት የቦርድ ዛሬም የፈላጭ የአምባገነን
ከልክ : ልማታዊነት ክፍለ ይህ ይነገራል ንድፈ
በይሉኝታ : ያመሰጠረበት ለመፈተሽ ፍልስፍናን የብሮድካስት መሀል
አድናቆት : የመሰሉ ዛሬም የአምባገነን ምርመራ መለኮታዊነት
ሀሰትን : ሲሄድ በላይ ዕገዳና ግን በ#ኛው
አኗኗሩ : ተመልካች መሆኑን ፍልስፍናን ይህም አምባገነናዊ
ቀልድ : ሰፊ ጨፍልቋል ግን በ#ኛው ምርመራ
ሥራን : መሠረት ቢመጥቅ የርዕዮተ ውስጥ በሆነ
ብዛት : ከሪፖርተር ድክመት በአንፃሩ ታሪክ ይነገራል
የውስጠቱን : ኤርትራን ተጭኗቸው ምርመራ ይህ ያለበት
ታስረን : ኮሌጅ ሲሆን በአፍሪካና ጣልቃ ሙያዊ
በጉብኝታቸው : ሲሆን በአፍሪካና ሙያዊ ሁኔታ ገለልተኝነትንና
አትምጡብኝ : ከኢንዱስትሪና ለዚህም የሐሳብ ዘመን ታሪክ
ብለዋል : በሚል የመረጃና ቆራጭ ቀጣይነት ንድፈ
የሕዝቡ : ተርጓሚ ገለልተኝነትንና ቆራጭ እንዳይኖር ቀጣይነት
በብዙዎች : ብርቱ ጉድለትን ቃል ማፅናቱ የተባለው
ቢተኮስ : የሁሉንም የምንዛሪ ሊባል እ በአፍሪካ
የገለጹት : በጳጳሱ ከመሆን መሪዎችን የአምባገነን ምርመራ
ፕላን : ልማታዊ ካልሆነ ሚዲያዎችን የሚወርደውን ሚዲያ
ዓይተህ : ሁሉ ጉዳይን ህልውናዬ የብሮድካስት ንድፈ
የሚጠይቅ : ያውም አምባገነናዊ ንድፈ ይመስለኛል ነው
ሐሳቦቼን : ሙያተኛ ሲያበቃ ፍፁም ገለልተኝነትንና መለኮታዊነት
ከእኔ : ከተገመተው ጓደኞች አፋቸው እውነት ነበር
ዝግጁ : በአፍሪካ ዋነኞቹ ዓላማም ሐሳብ የቅድመ
ጥርጥር : ተናጋሪነት መንግሥታትም ነበር የቅድመ ይመስለኛል
ሆረስ : ፀረ መዝለፍ የሚናገሩባቸው ቢኖርም የሕዝብን
አሰፋ : ምን ሊተች የፕሬስ የሚባለው ዘመን
የነበረው : ከፍሎሪዳ አንዳንድ ተዓማኒነት እንደመርግ ታሪክ
እየወደድናቸው : በመካከለኛው ቆራጭ ንድፈ ይመስለኛል ነው
ያለፈ : በግብርና በጥናት በረጅም ጭቁን ቀዳሚው
እርጋታ : ከድህነትና የፓርቲው እንደነበረው መሪዎችን የአምባገነን
በሠራው : የሊብራል ይመርጣል ሚዲያው ገለልተኝነትንና ቆራጭ
ሲሠሩ : ቫይረስ ሲከፍት ልማትን መቼም ያልፈተሹትን
ሸሽቶት : ያነሳሁት ደርሰዋል ኢሕአዴግ ዋነኛ የዚህ
ግልጽ : ተማረከ የአገር አገራዊ ባህል በአንፃሩ
ወገኑማ : እግዚአብሔርና እንደተጀመረ ቆራጭ ያለበት ቀጣይነት
በይቅርታ : በሥጋት ሲያበቃ የሥርዓቱ ገለልተኝነትንና ንድፈ
ተግባራት : ቤተ ሪፖርተር ፍልስፍናን ከአገዛዙ ንድፈ
ትቶት : ቤት የሚለውን ገድሏል እንዳልዘነጋሁ ተሳትፎ
ፍቅር : የምታውቁ ፊላደልፊያ እንዳይለውጥህ በላይ አውሮፓዊያኑ
እንኑር : ሪፖርተር የአንባቢውን የአፈጻጸም ለመፈተሽ ፍልስፍናን
ጓደኞቻችንን : አስፈላጊውን እየተስተዋለ እውነት መኖር አይደሉም
ይቅርታ : ማድረግና ነፃነትን የአገሪቱ የሙያው የመንግሥት
የሚኖረውም : ተደርጎ ዛሬም የፈላጭ ምርመራ ይህ
መጠን : ስታስበው በኋላ የሕዝብን ተደርጎ ዛሬም
ከማከናውናቸው : ማለፍ እኛ ፕሬዚዳንት አኳያም የሙጭኝ
ከሌለህ : አስታውቀው ከሦስት መኖር ከመጣ በአንፃሩ
በሚናፈስበት : አጃንስ ልቅ ባለው ቢሆን የሚባለው
ሳይንቲስትም : የሕግ በሚዛናዊነት ባህሪ ቀጣይነት ንድፈ
ከመጠን : እንዴ ይነገራል ንድፈ ይመስለኛል ነው
የመንፈስ : ቆመው የክልል መሆኑን ሙያና ከአገዛዙ
እንደየምርጫችን : የተባለው አገር የሕዝብን ሚዲያ ተደርጎ
እንወስን : ዲ አገር ሚዲያ ምርመራ ይህ
ንገረኝ : በሥልጣን ነው
ፍራንክሊን : ያዘነበለ ብዙኃንን የፈላጭ ምርመራ ይህ
ተጠንቀቅ : ቢሮዎች መግለጽም በክልልና ከሦስት መመራታቸውና
ማለዳ : በአፍሪካም እያደነቃቸው አ በሙያተኛው ነው
ቤንጃሚን : ጎደል ይከተላሉ ንድፈ ይመስለኛል ነው
በማረም : የሚያስችሉ ተሳትፎ ንጉሣዊ የሚዲያ ቀጣይነት
አይቶት : የሚጓዙ የአወሮፓውያኑ ማቅረብ የጋዜጠኝነት እንደነበረው
ካለህ : በአፍሪካና ሙያዊ ወደ ኤርትራን አስተሳሰባቸው
ማንሰምቶት : መካብ ይህ ያለበት ቀጣይነት ንድፈ
ይሄዳል : ብርም አነብናቢነት እየተስፋፋ አስኪያጆች የአዲስ
ደስታ : የሞላበት የሚዲያ ንድፈ ይመስለኛል ነው
ሌሎችንም : መተዋወቅ አምርሮ ቀብሯል ዘመን ታሪክ
ጋዜጠኛና : እነ መሆኑም ወታደራዊ ገለልተኝነትንና ቆራጭ
በተድላ : ያለበት ቀጣይነት ንድፈ ይመስለኛል ነው
ተጸጽቶ : ውስጥ የሥርዓቱ ገለልተኝነትንና ቀጣይነት ንድፈ
እኛ : ከማከናውናቸው ስቴትስ የጋዜጠኞች የሙጭኝ የአምባገነን
ንጹህ : የሚያውቁት በማተሚያ ሲባል የቅድመ ይመስለኛል
አየናቸው : ዓመታት ነፃነት የዚህ የቅድመ ይመስለኛል
ስናልፋቸው : እብድ ታሪካዊ ይህ ያለበት ቀጣይነት
እንዳይለይህ : ድምዳሜን በየትኛውም ሚዲያዎችን አስፈጻሚ የሚወርደውን
ሕይወታችን : ምንም በምሁራኑ እንዴት ይችላል ነበር
በሄድን : እየጠየቁ የሚጎድላቸው አሁንም የአምባገነን ምርመራ
እንዳይለውጥህ : ከማለቃቸው የኢቦላን ፍቅር በቅድሚያ ሊሆኑ
ሞልየር : ሞተ ፈተና ገድሏል መንግሥትንና ዓላማም
እየቀነሰ : ቫሉታ በኋላም አድርባይነትና ኪራይ ለምክር
አሉባልታ : ሲከፍት መሆኑም ፍፁም ገለልተኝነትንና ቆራጭ
ስህተት : ወርዶ የርዕዮተ ሊተች የፕሬስ ዘመን
ዓይነት : ስቶ አስተሳሰቦችና ቀዳሚው የሚዲያ የቅድመ
ተጠቀምባቸው : ለአምስት ተጎዳ ቤቶች ድረስ እዚህ
ማንቆለጳጰሳችን : እግዚአብሔርና እንደተጀመረ ቆራጭ ያለበት ቀጣይነት
የበለጠ : ሸቀጥ ሚዲያዎች የኅትመትና ሥልጣንን ላይ
ክፉኛ : መልስ አባልነትና ልማታዊ ሚዲያዎችን አስፈጻሚ
የለውም : ሁልጊዜም በማያፈናፍን የአገሪቱ ይበጅ የመንግሥት
ዕርዳታ : ይዞ በኤዲተርነትና አስፈጻሚ የሚወርደውን የፈላጭ
በሚገኝ : መግለጽም በክልልና ዴሞክራሲ መነሳትና መመራታቸውና
አባቱ : የሚገባው ነው
እንደሚኖርበት : ኒውስ እያደረገ መንግሥታትም አይደሉም የቅድመ
ማሳተም : ሰሎሞን ቪክተርና እንደተጫናቸው በንጉሡ ነፃነት
በ# : ዋናው ይመስለኛል ነው
በማተሚያ : ሊፈርድ የአዲስ አካሄድ የቅድመ ይመስለኛል
ተረዳ : ኒዮሊብራሊዝም መመራታቸውና ትንሽ የሚባለው አሠራር
አሜሪካን : እንዲሆኑ ቤቶች እዚህ ይታወቅልኝ አምባገነናዊ
የራሱን : እንደሚገመት ማኅበረሰብ የተስፋፋ የመጣ ድክመት
ስለነበረም : ጥያቄዎችን ይኖርባቸዋል እስከ ነው
የፔንሲልቫኒያ : በጠሊቅ አያቶቼ ደጉን የሥርዓቱ ዘመን
ለ# : ሥራዎች ባይባልም መሄዱ ያህል ሚና
አዘጋጅም : ጥቅሶቻቸው ምዕራፍ ሚና የቅድመ ይመስለኛል
ለአባቱና : ይከለክላል በሙያተኛው ነው
ጋዜት : በቁጥጥር አገናኙን ከሚያመቸው ሥራዎች የአሁኑን
ሆነ : ያየ መጽሐፍ ሲሆን ከቀረበ ጣልቃ
የማተሚያ : በይሉኝታ የፍልስፍናው ሕጎች አለመጠናከር ፍልስፍናን
ተቀባይነትና : ቀዳሚው የቅድመ ይመስለኛል በሥልጣን ነው
ልጅ : የተገረመው እውነት ድክመት አይደሉም ነፃነትና
ዓመቱ : እንዴት ነገር ይችላል በንጉሡ ነፃነት
መሥራት : ስለሚሰጣቸው መቀነስ የቦርድ ዛሬም የፈላጭ
ጠየቀ : ካስተዋወቀችው ሐሳብበዓለም ነፃነትና በ#ኛው ማረጋገጥ
ወዲያውኑም : ይናገራል በንጉሡ ነፃነት የዚህ የቅድመ
ተነባቢነት : ተጭኗቸው አገር ሚዲያ ምርመራ ይህ
ተረጋገጠለት : በእውነት መግለጽም መስጠትና ሊተች መመራታቸውና
ሊያገኝ : የሚያፍንና መዋቅሮችን የሚዲያ የአፈና ንድፈ
ያኔ : አተገባበር ለማረጋገጥ ስቶ ሊረጋገጥ ሚና
ስለነበረ : የተስማሙበት ሐሳብበዓለም ታሪክ ይህ ይነገራል
የሚፈልገውን : ለባለሀብት በሕጋዊ ክፍለ ምርመራ ይህ
ለማድረስም : ይቀነቀናል አይደሉም ይነገራል ንድፈ ይመስለኛል
ገዛና : ኢትዮጵያዊያንና ዋነኛ ሥልጣን ሚና የቅድመ
ዩኒቨርሲቲ : ማስፈን በመከታተያ የፖለቲካ ከአገዛዙ የሚዲያ
የጋዜጣው : መሆናቸው ተጫውቷል በአሁኑ ይናገራል በንጉሡ
ማተሚያ : ሚል በግብርና ተመሥርተው ተጠሪነቱ ልበ
ተቀጥሮ : በሠለጠነ ለአዲስና መርሆአችን እዚህ የቅድመ
የእንግሊዝ : ከአንድ ያልተጨበጠ ሁልጊዜም በማያፈናፍን የአገሪቱ
እግቡ : ራሱን ተዓማኒነትን ከሆነ ገብነት ባይሆንም
የገንዘብ : እና ልማታዊ ካልሆነ ሚዲያዎችን የፈላጭ
ድሃ : እኔና ተከናውነዋል ሜዳ አይደሉም የቅድመ
ፊላደልፊያ : ከማለቃቸው የምታውቁ ፍቅር ይኼ አውሮፓዊያኑ
ስለፈለገ : እየተደራደረ ከተማውን ድሃ ብዕሬን መደምደም
ፔንሲልቫኒያ : አንዳንድ በአንፃሩ ዋነኞቹ ታሪክ ቀጣይነት
የነበረችውን : ባለ ጉዳዩ ማስፈን ዴሞክራሲያዊ ከአገዛዙ
ተቀጠረ : አድርጓል የጋዜጣው ተጫውቷል በአሁኑ ይናገራል
የሥራው : የለብለብና በመካከለኛው የሚንገታገቱ ቆራጭ ቀጣይነት
ከጊዜ : ለእናቱ የኢትዮጵያ ኢሕአዴግ ዋነኛ የዚህ
#ኛ : መደምደም የፌደራሉም ሜዳ መኖር ዋነኞቹ
ለእናቱ : ከጊዜ መብቱ ዋነኛ የዚህ የቅድመ
ጋዜጣ : መኖር ዋነኞቹ አይደሉም ታሪክ ይነገራል
ማጥናት : ጥያቄዎችን ያዳግታል ይኖርባቸዋል ሰነባብቷል በመንግሥት
ዛሬ : ከሙያዊ ሊተች ቢሆን ገድሏል የሚባለው
ገንዘብ : ያነሳሁት መንካት ዋነኛ የቅድመ ይነገራል
ስለኤሌክትሪክ : ገበታቸው ሒሶች መኖር ዋነኞቹ ገድሏል
አቋቋመ : ሲጠጋው በአንድ ሥልጣን ሚና የቅድመ
በመመለስ : ያደረሰው ሕዝብ ፍፁም የሥርዓቱ አፋኝ
ኮሌጅ : ዕይታ ጠቃሚና እንዳለበት በአፍሪካና ሙያዊ
ወራት : ነበሩ በሥልጣን ነው
እራሱ : ማቅረብ መገናኛ ሁኔታ መለኮታዊነት ንድፈ
ላይም : ትቶት የማያሞግስና መሣሪያነታቸውም ገድሏል እንዳልዘነጋሁ
ለማቋቋም : ናቸው አውሮፓዊያኑ ከመጣ ወደነበሩበት ቢሆን
ትገዛ : ገለልተኝነትን በሥጋት ያለበት ንድፈ ይመስለኛል
ጀመረ : የሚገቡም መፀዳጃ መፍረስም ማብቂያ አይደሉም
በኋላም : ኪራይ አሠራር ቀጣይነት ንድፈ ይመስለኛል
ዓላማውን : የማሻሻያ የለውም ሁልጊዜም ይሆናሉ በማያፈናፍን
ቪክተር : ጓደኛው ተናጋሪዎች ብዙዎቹ መልስ ሙያተኞች
የ# : ተግባር ይልቅ የአገሪቱ የመንግሥት ይህ
የሚጠቁም : አቀንቃኞች በሥጋት ንድፈ ይመስለኛል ነው
ከተላቀቀች : ከፍሎሪዳ የነበረው አንዳንድ ውዝግብ በአንፃሩ
እንደነበረ : ተገቢ ሥልጣንን ቀዳሚው ይመስለኛል በሥልጣን
የሚያደርገው : ነገሮች መስተዳድርን ወደ ሚዲያ ተደርጎ
ጓደኛን : ቢለይ የጋዜጣ ገለልተኝነትንና ቆራጭ የሚባለው
ቤልጄማዊው : በባዶ በገዥው ቢኖርም የፈላጭ ምርመራ
ወትሮው : አደንዛዥ አድርገው የተባለው አስፈጻሚ የሕዝብን
ከእንግሊዝ : በልማቱ መንግሥት በ#ኛው ምርመራ ይነገራል
ይጫወት : ሲሄድ ግን በ#ኛው ምርመራ ይነገራል
ቢታወቅም : ብሔራዊ የሆነ ምርመራ ይህ መለኮታዊነት
ቅኝ : የአንዳንድ ጨምሮ በነፃነትና ፍልስፍናን መዋቅሮችን
እንዲሆኑ : አሜሪካን ቤቶች ድረስ እዚህ ዘመን
ቫን : አይቶት ሁኔታ የአምባገነን ምርመራ ይህ
በሁለቱም : ነዋሪ በእርሱ * ቀዳሚው ይታወቅልኝ
ቡክ : በአካል ያለከልካይ ይታገላል ይኼ ታሪክ
ከተባለ : በነፃነት ይታዩና ቢነሳም ዛሬም የፈላጭ
ጥቅሶቻቸው : አዘጋጅም ምዕራፍ በሙሉ * ቀዳሚው
እንቅስቃሴም : የከፋው አባልነትና በኤዲተርነትና ካልሆነ ሚዲያዎችን
ዓመቱም : ሃያ በፈላጭ በላይ የተሻለ ዕገዳና
ያገኛል : በመንግሥት ዓመታት አሳድዷል ነፃነት የዚህ
ሶሳይቲ : ሚል ተጠሪነቱ በተስተካከለና ጭቁን ያደርጋል
ታላላቅ : መምጣት የሚገነባውና የኅትመትና ብዙዎች ሥልጣንን
ሰላም : በአፍሪካና ሙያዊ የተቋሙ ወደ ሁኔታ
እየተሳካ : መዋቅሮችን በመደገፍ የሚዲያ የአፈና ንድፈ
ኒል : የሚፈቀድለት ጽንፈኝነትን ያለው ነፃነትን የመንግሥት
ሮያል : በሌሎች የሚባሉ ለመፈተሽ ፍልስፍናን መሀል
ሲከፍት : ፍፁም ገለልተኝነትንና ቆራጭ ቀጣይነት ንድፈ
በማድረጉም : ቢኖሩም ዛሬም የፈላጭ ምርመራ ይህ
ነገሮች : የሚያደርገው ወደ ሚዲያ ተደርጎ ምርመራ
አስገኝቷል : በልማቱ መንግሥት ግን በ#ኛው ምርመራ
ፈረንሳይ : ይገልጸዋል ጥያቄዎችን ይኖርባቸዋል ነው
ለመፍጠር : አጃንስ እንቅፋቶች ወይም በሆነ ቢያንስ
አብዮታውያንን : በወረርሽኙ ጥቅሶቻቸው ሰዎች በሠለጠነ ለማረጋገጥ
ወዳጆች : ሻጭ ተመልካች መሆኑን ፍልስፍናን ይህም
የፌስ : በነገራችን የተለመደ በመንግሥት ዓመታት የሳንሱር
ተልዕኮውም : አይጥለውም ተገቢ በተስተካከለና ሳንሱር ይመስለኛል
ሄዷል : ወሰነ ከመጠን እንዴ ነፃነትና ይነገራል
የመሆን : ዕገዳና ግን ይህ ይነገራል ንድፈ
ፍለጋ : መርሆአችን አነብናቢነት ድረስ እዚህ ይታወቅልኝ
ፌቴክ : ጉድለታቸው ኢትዮጵያዊያንና ሥልጣን ሚና የቅድመ
መስኩ : ባንክ ወዳጄ ብለው የሚያፍንና መሆኑ
በሳይንስ : በነፃነት ዓለማዊ የሚናገሩ የቦርድ ዛሬም
ብርሃኑ : እንኳን አይችሉም የሚገባው ነው
ድጋፍ : አኗኗሩ በአገራዊ የመሰላቸውን ለመፈተሽ ፍልስፍናን
አጋጠመው : ጂቡቲ መንካት ዋነኛ የዚህ የቅድመ
ዲ : አገር ሚዲያ ምርመራ ይህ መለኮታዊነት
በፖለቲካዊ : ያልተገለጸ በመከታተያ የሚያፍንና መዋቅሮችን በመደገፍ
ግንባር : ቅሬታ አፋኝ መሪዎችን እንደተጀመረ የአምባገነን
ከማል : ያለፈ በግብርና አልነበረም ጭቁን ቀዳሚው
መካከል : ይቀነቀናል የሚል ሜዳ መነሳትና ዋነኞቹ
በመወከል : ከዚያ አሁንም የአምባገነን ይህ ያለበት
በጅምር : እያገኙ ሐሳቡ የተቋሙ እንዳይኖር ይህ
ምርምር : ትንሽ ቀጣይነት ንድፈ ይመስለኛል ነው
ሮዚም : ቃል የተባለው አስፈጻሚ የሚወርደውን ሚዲያ
ግዛት : በጉብኝታቸው በአፍሪካና ጣልቃ ሙያዊ የተቋሙ
አድርጓል : ተቀጠረ ተጫውቷል ይናገራል በመንግሥት በንጉሡ
በአሜሪካ : ማብቂያ እዚህ ሚና የቅድመ ይነገራል
መልዕክት : ርዕዮት የሚመስላቸው ለዚህም በመሆኑ ዓላማም
ፌስቡክ : ተፈጥሯዊ በደርግ እንደቆሙ የዚህ የቅድመ
ሁነኛ : አስተሳሰባቸው ተደርጎ ዛሬም የፈላጭ እንዳይኖር
አሜሪካዊ : አድርባይነትና ኪራይ ሚዲያው ገለልተኝነትንና አሠራር
ቀርተውበታል : ይተቸዋል መኖር እንደመርግ አይደሉም ቆራጭ
ቪክተርና : ሰሎሞን ማሳተም እንደተጫናቸው በንጉሡ ነፃነት
አባል : ሳለ በኖረ በአንፃሩ ዋነኞቹ ታሪክ
ጸሐፊዎችና : መቀየሪያ ልማትን ቆራጭ ቀጣይነት ንድፈ
ተሾመ : ወጥቶና ተስፋ ለትችት ለምሳሌ የግልና
የአሜሪካ : ውጪ የአንዳንድ የፖለቲካ ከአገዛዙ መዋቅሮችን
ብዙ : የጎላ ቢገለጽም እያደገ የሙያው የመንግሥት
ተሳክቶለት : ጽንፈኝነትን ሁለት የመንግሥት የፈላጭ ታሪክ
በፌስቡክ : ለዚህም የግልና ዓላማም ሐሳብ ዘመን
ጉዞአቸውን : የተዛባና በንጉሡ ነፃነት የዚህ የቅድመ
ከፊልም : ጓደኞች ነበር የዚህ የቅድመ ይነገራል
ሸርት : ከሕግ ተርጓሚ ገለልተኝነትንና ቆራጭ ዘመን
በአካል : ቡክ ያለከልካይ ይኼ ታሪክ ይነገራል
ለብሰው : መኖር በአንፃሩ ዋነኞቹ ታሪክ ቀጣይነት
ካሜራ : ይህ ያለበት ቀጣይነት ይነገራል ንድፈ
ፈጽሞ : በመንግሥት የሳንሱር አሳድዷል ነፃነት የዚህ
ከተመረቀ : እንዳይሆን ተዓማኒነት አውሮፓዊያኑ ወደነበሩበት በአንፃሩ
ከአንድ : የለውም ዕድል በማያፈናፍን የአገሪቱ ይበጅ
የጻፋቸውና : ይስተዋላል አርዓያ የሕዝብ ሕዝቦች ሥርዓት
ለጠፉ : የሚያውቁት ሲባል ለዚህ ዋነኛ የቅድመ
ማይል : ህንድ በአመለካከት የሳንሱር መንገድ ዋናው
መጽሐፍ : ሆነ ካልሆነው አይታበልም በአፍሪካና በኢትዮጵያ
መተዋወቅ : አምርሮ አስተሳሰብ ቢሆን የሚባለው አሠራር
አካባቢዎች : ሺሕ ሚዲያ ምርመራ ይህ መለኮታዊነት
ስለ : አገር ሚዲያ ምርመራ ይህ መለኮታዊነት
ወሰነ : ሄዷል ከመጠን ከመጣ ነፃነትና ይነገራል
ፍላጎት : ቲሸርት የቅድመ ይመስለኛል በሥልጣን ነው
ተማረከ : ግልጽ ባህል በአንፃሩ ታሪክ ይህ
የሚያውቅ : ፓርቲ ክፍለ በ#ኛው ይህ ይነገራል
አገናኛቸው : መፀዳጃ ደርሰዋል ማብቂያ ይነገራል ንድፈ
የአፋልጉን : በሙያተኛው ነው
ኦስተን : ስናልፋቸው ታሪካዊ የሚመስል እንዲሳተፍ የሚመልስ
ጓደኞች : መግዣ ከእኔ ነበር አይደሉም ዋነኛ
ለማወቅ : ደኅንነት ሚዛናዊ ጋዜጠኝነት ቀዳሚው የሚዲያ
ቴክሳስ : ሰፊ ግን በ#ኛው ይህ ይነገራል
ተጉዘው : አንዳንድ ውዝግብ በአንፃሩ እንደመርግ ታሪክ
አገናኙን : ሥራዎች ያህል ሳንሱር ሚና *
ከተማውን : ድሃ ተከናውነዋል ምሳሌ መንግሥታትም አይደሉም
ኒልን : ሁለት የውጭ ነፃነትን የመንግሥት አስፈጻሚ
የምታውቁ : ፍቅር እሴት ግንኙነቶችም ይኼ ከመጣ
ጓደኛው : ሙያተኞች አባልነትና በኤዲተርነትና ሚዲያዎችን አስፈጻሚ
አጠያየቁ : አድርጓል ተቀጠረ ተጫውቷል አልቻለም ያዳግታል
ፖስተር : የሚያውቁት ለጠፉ ንጹህ ኢትዮጵያዊያንና ዋነኛ
መደብር : በ#ኛው ምርመራ ይህ ይነገራል ንድፈ
የላቸውም : ደርሰዋል ማብቂያ ያደርጋል ዋነኛ የቅድመ
የተለያዩ : ቀንዲላቸውን በኤዲተርነትና ካልሆነ አስፈጻሚ የሚወርደውን
ያገኙት : አስገኝቷል በልማቱ ከ#ዎቹ ግን በ#ኛው
በቪክተርና : አካሄድ የቅድመ ይነገራል ንድፈ ይመስለኛል
የሚወዳቸውን : ለፀጥታ የደረስንበት ከድህነት እንደተጀመረ ያለበት
በቪዲዮ : እንዲይዝ ሲሠሩ እንደሚሞከርም ያልፈተሹትን የመረጃና
ትምህርት : ሊሆን በማድረግ የአገሪቱ ይበጅ ሚና
እንደጠየቀው : ለኦሬንጅ ገጽታዎች ዋነኛ ሥልጣን የዚህ
ዞሩ : ይባላሉ በንጉሡ ነፃነት የዚህ የቅድመ
አሰሱ : የተለየና ያሳጣል አፋኝ እንደተጀመረ ቆራጭ
ሳምንት : እንዲገኝ በግል ዕርምጃ የሚወርደውን ሚዲያ
ቲ : ተርጓሚ የሊብራል ገለልተኝነትንና ቆራጭ እንዳይኖር
ሆኖም : በመቆጣጠር እየተካሄደ ለእውነትና ኢንዱስትሪውን ገለልተኝነትንና
እንዳለበትም : ተከናውነዋል እ አይደሉም ነፃነትና ይነገራል
እየረቀፁ : እንደማይችል ሰፊ ዕገዳና ግን የሚወርደውን
ባነበበው : ገቡ ሁለተኛው በአገሪቱ ያለው የመንግሥት
ገቡ : ሁለተኛው በአገሪቱ የመንግሥት ይነገራል ንድፈ
ይዘዋወር : መርሆ ታሪክ ይነገራል ንድፈ ይመስለኛል
ዕፅ : ታወቀ የአዲስ የቅድመ ይመስለኛል ነው
ለኦሬንጅ : ጉድለታቸው ይቸገራሉ ይገባዋል ብሎ ኢትዮጵያዊያንና
ከተለመደው : ሚዲያ ምርመራ ይህ መለኮታዊነት ይነገራል
ኒውስ : መካከል የሚል የፌደራሉም ሜዳ መነሳትና
አደገኛ : ብር ብሎ ሥልጣን ሚና የቅድመ
ፖሊስ : ዓላማም ሐሳብ ዘመን አምባገነናዊ ቀጣይነት
አዘዋዋሪዎችን : ለረዥም የሚናገሩባቸው መሥሪያ ደረጃ የቦርድ
ወር : የርዕዮተ ሊተች የፕሬስ ቢሆን የሚባለው
ለጥያቄ : ንጉሣዊ የሚዲያ ንድፈ ይመስለኛል ነው
ከፍሎሪዳ : አንዳንድ ውዝግብ ለምሳሌ በአንፃሩ እንደመርግ
የእውነቴን : ይናገራል በንጉሡ ነፃነት የዚህ የቅድመ
ሲጠጋው : ሲወጣ አቋቋመ ሥልጣን ሚና የቅድመ
ክትትል : በሕገ የሚንገታገቱ ትንሽ ንድፈ ይመስለኛል
እየተደራደረ : ሜዳ መንግሥታትም ነበር አይደሉም ዓላማም
ለማዋል : በነበረው ጉምሩክ የራቀ ሁኔታ ተጭኗቸው
ያጋለጠው : ምንድንነው ይኼ በአንፃሩ ታሪክ ይነገራል
አብረውት : የሚናገሩ የቦርድ ተደርጎ ዛሬም የፈላጭ
አዘዋዋሪ : የሚመለከታቸው የሆነ አገሮች መሪዎችን ምርመራ
ቆይታቸውን : ጉልህ ዋናው ይመስለኛል ነው
በካሜራቸው : ከማቅረብ መኖር አይደሉም መንግሥትንና የሚባለው
አዘዋዋሪዎቹም : ከፍሎሪዳ አንዳንድ ውዝግብ ለምሳሌ በአንፃሩ
በቁጥጥር : የአሁኑን ለማረጋገጥ ርዕዮተ በእስያም *
የተሰማው : ይፈቀድላቸዋል በውስጡ ከ#ዎቹ መንግሥት የተሻለ
የሚፈልግ : መረመረ ደርሰዋል እንደቆሙ ዋነኛ የዚህ
እንዳይገቡ : ዳይፐሩን አምርሮ የሚባለው አሠራር ይህ
ሊሸጥ : ካፒታሊዝም የሙስና የመስኩ የሆነ መሪዎችን
ይስተዋላል : ናት ሕዝቦች ሥርዓት ንጉሣዊ የሚዲያ
አደንዛዥ : ወትሮው የተባለው አስፈጻሚ የሕዝብን ሚዲያ
ቲሸርት : የቅድመ ይመስለኛል በሥልጣን ነው
ስር : ሊያዝናና መምጣት ብዙዎች ሥልጣንን ቀዳሚው
ጋበዛቸው : ጥቅም አስተሳሰብ በአንፃሩ የሚባለው ታሪክ
የተገረመው : ልጅ እውነት ስለማይችል አይደሉም ታሪክ
ይዣለሁ : ሲወጣ አቋቋመ ይቸገራሉ በአንድ ብሎ
ያደርጉባቸዋል : ሆነናል ለትራፊክና በሙሉ ሥልጣን ሚና
የመዘገበው : ሐሳቤን በስሜታዊነት በላቲን ተደርጎ የፈላጭ
ፖሊሱም : ዕቃ ሚና የቅድመ ይመስለኛል በሥልጣን
እጅ : ጊኒ ወቅት ለመፈተሽ የብሮድካስት ንድፈ
እኔና : ድሃ ተከናውነዋል ነበር አይደሉም ዋነኛ
ሻጭ : ወዳጆች ተመልካች መሆኑን ሙያና ይህም
ራሱን : ተዓማኒነትን የፌደራሉም ገብነት ሜዳ ዓላማም
ማሪዋና : ሐቅን መቼም የማይችል የመረጃና ቆራጭ
ቲሸርቱን : ያተኩራሉ በንጉሡ ነፃነት የዚህ የቅድመ
ከመደብር : በረከተ ይታያል የሚወሰድ ታሪክ ይነገራል
ሲጣጣሩ : ጉዳይን በማስመሰል ቢያንስ ንድፈ ይመስለኛል
ገልጿል : የሚመለከታቸው የሚደፈቅበት የራቀ ሁኔታ ምርመራ
ዓመት : ብርና እንዳጫወተኝ የአምባገነን ምርመራ መለኮታዊነት
ሆነናል : ሲወጣ ያደርጉባቸዋል ሲጠጋው ጭብጥ ብሎ
እንዲቆዩ : በራፍ የሚጎድላቸው በአፍሪካና ተቀባይነት አሁንም
ወጣ : ጭማሪ የእኛ ጽፈዋል ያደርጋል ይመስለኛል
ፍለጋዬ : በንግድ ሁኔታ ተጭኗቸው ዛሬም የአምባገነን
ያየ : ከቀረበ የተቋሙ ኤርትራን ተጭኗቸው እንዳይኖር
ለአንድ : ባለፈው ሲጠጋው ለትራፊክና በአንድ ሥልጣን
ለብሶ : ለማለት ሊገቡ ዕገዳና ይህ መለኮታዊነት
ያልተለመደም : አገናኙን ሥራዎች በተስተካከለና አልነበረም ሳንሱር
መጠኑን : ሙያዊ የተቋሙ ወደ ኤርትራን አስተሳሰባቸው
ጥሩ : የዴሞክራሲ የክልል ሚዲያን ተሳትፎ አምባገነናዊ
በእነዚሁ : ጋዜጠኝነትን በላይ ግን ነፃነትና ይነገራል
ወንጀለኛ : ከጥር ፈተና ዘመን አምባገነናዊ ቀጣይነት
ማሊ : በይቅርታ የጋዜጠኞች በሥጋት የሥርዓቱ ባህሪ
ኪሳራ : መሀል ከአገዛዙ የአፈና ሚዛናዊነትን ንድፈ
ብሎም : አቋም የሚባሉ መድረሻ በነፃነትና ቁጥራቸው
ወረርሽኙ : መብት መሣሪያነታቸውም ሕዝቦች ተሳትፎ የሚዲያ
የዓለም : አሁን ትኩረት እንዲገነዘብ ፈተና ፍልስፍናዬ
ናይጄሪያና : ተልዕኮውም ለዴሞክራሲ በተስተካከለና አልነበረም ሳንሱር
የአወሮፓውያኑ : አበባ ሁኔታ የአምባገነን ምርመራ ይህ
የነበሩት : ዩኒቨርሲቲ ቆመው ከአገዛዙ ንድፈ ይመስለኛል
በመቆጣጠር : ከጳጳሱ ኢንዱስትሪውን ገለልተኝነትንና ቆራጭ የአምባገነን
ከቫይረሱ : የዚህ የቅድመ ይመስለኛል ነው
የኢኮኖሚ : አጃንስ ምን በሆነ በ#ኛውና የሚባለው
የዕርዳታ : ፖሊሲው በመካከለኛው መገልገያ አገዛዝ ገለልተኝነትንና
መሻሻልን : ይኼ ግን ታሪክ ይህ ይነገራል
ኢኮኖሚያቸው : አለመፈለጉ አቀፍ በፊት የሚገነባውና ብዙዎች
የተጠቁት : ታይተዋል አስፈጻሚ የሕዝብን ሚዲያ ተደርጎ
ቢልዮን : በመንግሥት ዓመታት ነፃነት የዚህ ነው
ላይቤሪያና : ጭቁን ቀዳሚው የሚዲያ ይመስለኛል በሥልጣን
ቫይረስ : ሲሠሩ ልማትን የማይችል ቆራጭ ቀጣይነት
እየተጎዳ : አገናኙን ሥራዎች በተስተካከለና ያህል አልነበረም
ፊት : ጥቅም ሊተች የፕሬስ በአንፃሩ ዋነኞቹ
ጠቅሶ : ስለሚችል በንቃት እንደነበረው አፋኝ ሁኔታ
ባንክ : ሊነግድ የሚያፍንና የሚጣጣሩትን የሚዲያ የአፈና
የኢቦላ : የተቋሙ ሚዲያ ምርመራ ይህ ያለበት
ሥርጭት : ተመልካች ቢረጋገጥም ፈተና ይህም አገዛዝ
እንደዘገበው : በባዶ በሚታትር የተባለው የሕዝብን ተደርጎ
ያደረጉት : ሙያተኛ መሣሪያዎቹ ሚዲያን የሚሰብክና ንድፈ
በተያዘው : አዘዋዋሪዎችን የሚናገሩባቸው የሚናገሩ የቦርድ ዛሬም
ዶላር : ሊገቡ ይህ ያለበት ይነገራል ንድፈ
ቢሊዮን : ወሰነ እንዴ እየታየ ከመጣ ነፃነትና
ያጋለጠውን : መልቀቅ አስኪያጆች የአዲስ እዚህ ሐሳብ
የተገመተ : እንዳጫወተኝ አበባ የፓርቲው እንደነበረው መሪዎችን
ሴኔጋል : መሠረት ቢመጥቅ ትንሽ አሠራር ቀጣይነት
እንደሚገመት : ሠራተኞች የተስፋፋ ወጥቶና ስለማይችል መኖር
ጊኒ : ወቅት ትችቶች ለመፈተሽ ፍልስፍናን ከአገዛዙ
ባለፈው : ለትራፊክና በእርግጥ ብሎ ሥልጣን ሚና
በወረርሽኙ : አብዮታውያንን ትራፊኮች እንደዚያ መርሆአችን አነብናቢነት
አውጪዎችና : ባንኮች ውግንናው በተጨባጭ ይህም አምባገነናዊ
ጎረቤት : እየተካሄደ ምንድነው ጉድለቶችን ኢንዱስትሪውን ፍፁም
መሆናቸው : የጋዜጣው ተጫውቷል አልቻለም በአሁኑ ይናገራል
የኢቦላን : እንደመርግ ቆራጭ ታሪክ ይህ ያለበት
ሴራሊዮን : የሚገነባውና የኅትመትና ለመጠበቅ ላይ ይመስለኛል
ባንክን : የሃይማኖት መሆኑን ቢረጋገጥም ፍልስፍናዬ ይህም
በምዕራብ : በስሜታዊነት ይታዩና ዛሬም የፈላጭ ምርመራ
ታይቶባቸው : መሆናቸውን መደምደም የፌደራሉም ዋነኞቹ ገድሏል
አስታወቀ : ዋጋው የአንድ ጊዜ ይህ ይነገራል
ያደረሰው : ተጸጽቶ ሕዝብ የሥርዓቱ ገለልተኝነትንና ባህሪ
እንደሚያደርስ : በአንፃሩ እንደመርግ ታሪክ ይነገራል ንድፈ
ሠራተኞች : ፍራንኮ እንደሚገመት የአገር ማኅበረሰብ የተስፋፋ
አሳይቷል : ይናገራል በንጉሡ ነፃነት የዚህ የቅድመ
እንዳይዛመት : ተደርጎ ዛሬም የፈላጭ ምርመራ ይህ
አቅርቦታል : ይኖርባቸዋል የተለመደ አሳድዷል ነው
ከተገመተው : እውነት ብቻ ነበር አይደሉም ይነገራል
ፖሊሲ : ለሊብራል ሊጋጭ በመከታተያ ወገን በመደገፍ
በሚኖረው : እየተከተሉ የምናየው በማድረግ ይበጅ ዴሞክራሲያዊ
ዕድገት : ዕድል በማያፈናፍን አሉ የአገሪቱ ይነገራል
ከተጎዱት : ሁለት የመንግሥት አስፈጻሚ የፈላጭ ምርመራ
ምንዛሪ : የሚዘርፉ ሊካድ ልበ ቀዳሚው ይመስለኛል
ከዚህ : በራሳቸው ቀጣይነት ንድፈ ይመስለኛል ነው
ተጓዥ : በሆነ በ#ኛውና ይህ ቀጣይነት ይነገራል
ማንኛውም : ባለ ካለው የሕዝብ ሥርዓት ዴሞክራሲያዊ
ባወጣው : ሐሳቦች አቀባይ ሚዲያው ገለልተኝነትንና እንዳይኖር
እንዲይዝ : ያልፈተሹትን የመረጃና ደርግ ቆራጭ ቀጣይነት
ተጓዦች : ተችሏል ይቀናቸዋል ለዴሞክራሲ የሳንሱር ዋናው
ይፈቀድላቸዋል : የተሰማው እየተገኘ ይነገራል ንድፈ ይመስለኛል
የሚወጡ : ለብቻው በተጨማሪ ፍልስፍናዬ ቀብሯል ሐሳብ
ብርና : እንዳጫወተኝ እንደነበረው አገሮች ሁኔታ መሪዎችን
እገዛ : አይቶት በጳጳሱ እንደነበረው መገናኛ ሁኔታ
ግለሰብ : ከመንግሥት ወደ አገሮች ተጭኗቸው ሚዲያ
የወጣው : ነኝ የቅድመ ይመስለኛል ነው
እንዲይዙ : ከአገራዊ ንድፈ ይመስለኛል ነው
ማገዙንም : እየጨመሩ ከአገዛዙ ንድፈ ይመስለኛል በሥልጣን
ብርም : በመቶ አነብናቢነት ድረስ ይታወቅልኝ የቅድመ
ማድረጉ : ሊተች ቀጣይነት ንድፈ ይመስለኛል ነው
ተብሎ : በግልጽ መምጣት ብዙዎች ሥልጣንን ቀዳሚው
ብር : አደገኛ በእርግጥ ብሎ ሥልጣን ሚና
የሚጓዙ : አይቶት ከድህነትና እንደነበረው አፋኝ መሪዎችን
በነበረው : የሚመለከታቸው ከድህነትና የሆነ አገሮች ሁኔታ
እንዳይጨምር : አለማየት ከአገራዊ ሙያተኛ ንድፈ ይመስለኛል
የሚገቡም : ጀመረ መፍረስም ማብቂያ የቅድመ ይነገራል
መሠረት : ቢመጥቅ የርዕዮተ ውስጥ ሊተች ቢያንስ
በኢኮኖሚው : ከጳጳሱ ለእውነትና ፍፁም ገለልተኝነትንና ቆራጭ
የሚፈቀድላቸው : ሊያገኝ የሚመሩ የለውጥ ለሚፈልግ የሚያፍንና
በእጃቸው : የልማታዊ ጋዜጠኝነት የሐሳብና ቀዳሚው የሚዲያ
ታወቀ : እንደሚላቸው የቅድመ ይመስለኛል ነው
መመርያ : ይዘነጋና እንደቆሙ ኢትዮጵያዊያንና ዋናው ሥልጣን
ጭማሪ : ተፈጥሮአዊና ጽፈዋል ገጽታዎች ዋናው ሥልጣን
የሚገመተውን : ዋናዎቹ የመሰላቸውን ፍልስፍናዬ አምባገነናዊ ንድፈ
የሚነሳ : ፀጥታ ሁሉ ለምክር በመካከለኛው ትንሽ
ጂቡቲ : አጋጠመው ዋነኛ የዚህ የቅድመ ይነገራል
ባንኩ : በመካከለኛው ቀጣይነት ንድፈ ይመስለኛል ነው
ከሳምንታት : ይኼ ወደነበሩበት መርሆ ታሪክ ይህ
ሲወጣ : ሆነናል ይዣለሁ ሲጠጋው አቋቋመ ጭብጥ
የሚችለው : ደስታ የሞላበት የሚዲያ የአፈና ንድፈ
ከኢትዮጵያ : መሆኑም አቀባይ ሚዲያው ገለልተኝነትንና ቆራጭ
ይደርሳል : ደጉን ቀብሯል ዘመን አምባገነናዊ ቀጣይነት
ብሔራዊ : ቢታወቅም ከርዕዮተ ነፃና ቢሆኑም ምርመራ
መመርያው : ማንሰምቶት ናቸው አሠራር ይህ ያለበት
ማስተካከያ : ካስተዋወቀችው ጠየቀ ግንኙነቶችም አውሮፓዊያኑ ሐሳብበዓለም
ሲገባ : ያልተጨበጠ ያለው የመንግሥት ታሪክ ይነገራል
የሚፈቀድለት : አልያም ጽንፈኝነትን ይልቅ የአገሪቱ የመንግሥት
የማሻሻያ : ዓላማውን የለውም በማያፈናፍን የአገሪቱ ይበጅ
ለማግኘት : ተነገረ በኤዲቶሪያል በገዥው ቢኖርም የሕዝብን
አይፈቅድም : እ አይመስለኝም ይችላል ብቻ ነበር
ሥልጠናውን : በሄድን የሚጎድላቸው በአሠራር መሪዎችን የአምባገነን
ከሚያዘጋጀው : ወደኋላ የያዘበት ተቀላቅለዋል ፈቅደው ከአገዛዙ
ውጭ : ገንዘቡን በፊት ጋዜጠኝነት ቀዳሚው ይመስለኛል
በእጅ : በአካል ቡክ ያለከልካይ ይኼ መርሆ
አይፈቀድለትም : አለመያዙ ለውጥ ዕርምጃ ፍልስፍናው ምርመራ
ተቀጥረው : አብዮታውያንን ድረስ ይታወቅልኝ የቅድመ ንድፈ
ግለሰቦች : ከሪፖርተር ብዛት የተስፋፋ ባህል መኖር
ደብዳቤ : በማስመልከት የአንዳንድ ከአገዛዙ መዋቅሮችን በመደገፍ
ዜግነቱ : መርጦ ጋዜጠኝነት ቀዳሚው የሚዲያ ይመስለኛል
በተያያዘም : ፍፁም ገለልተኝነትንና ቆራጭ ቀጣይነት ንድፈ
ለመሳተፍ : ቢከብድ ወገን የኅትመት የብሮድካስት የአፈና
ከቀጣሪዎቻቸውና : እንዲይዙ ከአገራዊ ገለልተኝነትን የብሮድካስት ያለበት
እንደሚችሉ : መንግሥታትም ነበር አይደሉም የቅድመ ይነገራል
ከገባ : ተለመደ ክፍተት አይመስለኝም ብቻ ነበር
ማለፍ : ከማከናውናቸው ማስቀደም ጥረት ፍፁም ገለልተኝነትንና
አስፈላጊውን : ጓደኞቻችንን እየተስተዋለ እውነት ስለማይችል መኖር
ሺሕ : አካባቢዎች ተጭኗቸው አገር ሚዲያ ምርመራ
የሚሠሩ : ከሙያዊ ገድሏል ንድፈ ይመስለኛል ነው
ነዋሪ : በእርሱ * ቀዳሚው ይታወቅልኝ የቅድመ
ኤምባሲዎች : የተነሳ የሚወርደውን ሚዲያ ምርመራ ይህ
ጥናቶችንና : የሚዲያ ንድፈ ይመስለኛል ነው
ተደንግጓል : ጽሑፍና ሄዷል ከመጠን ነፃነትና ይነገራል
የድጋፍ : ሊነግድ በመከታተያ በእንግሊዝ እንዳልዘነጋሁ መዋቅሮችን
እንዲሁም : ፍልስፍናዬ አምባገነናዊ ቀጣይነት ንድፈ ይመስለኛል
ይዞ : በኤዲተርነትና ካልሆነ ከፈላጭ አስፈጻሚ የሚወርደውን
በተጨማሪም : ጽሑፋዊና ከሪፖርተር ብዛት ማኅበረሰብ ሐሳብመነሻው
ፈቃድ : በንግድ ወደ የሆነ ሁኔታ ተጭኗቸው
ግለሰቦቹ : ካፒታሊዝም የመስኩ መሪዎችን የአምባገነን ምርመራ
ቀናት : ንገረኝ ህንድ ነፃ የተለመደ አሳድዷል
የባንክ : ወቅት ትችቶች ፍልስፍናን ከአገዛዙ የአፈና
ጣሪያው : ተቀሰቀሰ ሰብሳቢዎችና ተጭኗቸው ምርመራ ይህ
ዓውደ : የሚገነባ የቦርድ ዛሬም የፈላጭ የአምባገነን
ሥልጠናዎችን : የፈላጭ ምርመራ ይህ መለኮታዊነት ያለበት
ማቅረብና : እሴትን ትችቶች ለመፈተሽ ፍልስፍናን የብሮድካስት
ከውጭ : በእጅ ተዓማኒነት ይኼ አውሮፓዊያኑ ታሪክ
ኢትዮጵያዊ : ጎደል የርዕዮተ መንግሥትንና ንድፈ ይመስለኛል
እንዲገኝ : ነፃና ውጤትም የ ይኼን የተነሳ
ያደረገ : እንቅፋቶች ቢያንስ ቢሆን ገለልተኝነትንና አሠራር
ምንዛሪውን : ቢሆንም ፓርቲ ደግሞ በ#ኛው ምርመራ
በመቶ : አነብናቢነት የቅድመ ንድፈ ይመስለኛል በሥልጣን
ከባንኮች : በእስያ መዝለፍ ቢኖርም የፈላጭ ምርመራ
በቅርቡ : ቢሉም የክልል ከአገዛዙ የሚዲያ ንድፈ
በሆኑ : ሥራን በ#ኛውና የሚባለው ይህ ቀጣይነት
ገንዘቡን : ውጭ ላይቤሪያና መርጦ ልበ በፊት
ካሟላ : እንዲገኝ ነፃና ይኼን የተነሳ ጉድለትን
በታች : የተገረመው እውነት ስለማይችል በአንፃሩ አይደሉም
መመርያዎች : ካሜራ ይህ ያለበት ይነገራል ንድፈ
የሻረ : ገንዘቡን ቃኝተው የከተሞች በፊት ጋዜጠኝነት
ለሚመለከተው : በንግድ ሊኖረው ወደ ሁኔታ ተጭኗቸው
መመንዘር : ከሙያዊ ሊተች የፕሬስ ቀጣይነት ንድፈ
ተመን : ለማለት ይህ ያለበት ቀጣይነት ይነገራል
የነበሩበትን : ለምን የርዕዮተ ቢሆን ዘመን ንድፈ
ቢሮዎች : ኢትዮጵያዊ መሠረታዊ የርዕዮተ ሊተች መመራታቸውና
እንኳን : አሳድዷል ነው
አብሮ : የተገረመው ተከናውነዋል እውነት አይደሉም ታሪክ
የጉዞ : መጽሐፍ ጦርነት ጠቃሚና ካልሆነው ሥልጣኔ
መቀየሪያ : ሲሠሩ ልማትን መቼም ቆራጭ ቀጣይነት
ካስተዋወቀችው : ጠየቀ ግንኙነቶችም ዋና የተስማሙበት ሐሳብበዓለም
ሕጋዊ : ወሰነ ጫፍ ከመጣ ነፃነትና ታሪክ
የሚባል : አስገኝቷል በፈላጭ ይታወቃል ግን በ#ኛው
አዲስ : ያዳግታል በመንግሥት ዓመታት አሳድዷል ነው
ነባራዊ : ለትችት ዋነኞቹ አይደሉም ዓላማም ታሪክ
መጠኑ : ጉምሩክ አውጪ የራቀ መገናኛ ሁኔታ
ተፈጻሚነቱም : ለባለሀብት ይታወቃል ዕገዳና በ#ኛው ምርመራ
እስከሚያገለግልበት : ጀርባ የትራፊክ አስፈጻሚ የሚወርደውን የፈላጭ
ከሆነና : ከቀረበ የተቋሙ ወደ ኤርትራን ተጭኗቸው
ከማለቃቸው : ፊላደልፊያ ፍቅር ይኼ አውሮፓዊያኑ ዕገዳና
ግለሰቡ : ዘመቻ እያደገ የሙያው የመንግሥት አስፈጻሚ
የሚችሉትን : ስለነበረ ሐሳብበዓለም ነፃነትና ማረጋገጥ ታሪክ
የምንዛሪ : ቢተኮስ ምንም ሊባል እ እንዴት
አገሪቱ : ሞዛይክነት እንጂ መሆኑ ብዙዎች ሥልጣንን
ማሳወቅና : አሜሪካን ቤቶች እዚህ ተሳትፎ ዓላማም
ቪዛው : ብሔራዊነት ሊያገኝ የሚመሩ አሜሪካ የልማትና
ግባ : እንዲኖርም ሁልጊዜም በማያፈናፍን የአገሪቱ ይበጅ
ሞልቶ : ክርስቲያን ሽብርተኝነትና እንዳይኖር አሠራር ይህ
የሚያውቁት : ለጠፉ ንጹህ የግልም ሲባል በቀጣዩ
ነን : እንደፍልሰፍና ሙስናን ፖሊሲው በመካከለኛው ንድፈ
ከዚህም : ጠየቀ ይመስሉኛል ሰው ሐሳብበዓለም በ#ኛው
ስንቶቻችን : መውጣቱ ይታዩና በኋላ ተደርጎ ዛሬም
በንግድ : ፈቃድ ወደ ሁኔታ ተጭኗቸው ዛሬም
ኦሮሞነት : እርጋታ እንዳጫወተኝ የጋዜጠኝነት የፓርቲው እንደነበረው
ሳቢያ : ከፍ መስተዳድርን የሆነ መሪዎችን ምርመራ
የእኔን : ባለሀብቶች ሥርዓቱ ዋናው ሳንሱር ሚና
አዳዲስ : ጥቅምን በእንግሊዝ የሚዲያ ንድፈ ይመስለኛል
አለማወቅ : ስም የሚገነባውና ብዙዎች በሥልጣን ነው
እንዲሁ : እያደነቃቸው በሙያተኛው ነው
የሚሆን : አለ ድክመት ብቃት በአንፃሩ መርሆ
ባለፈ : ከሪፖርተር የተስፋፋ ወጥቶና ድክመት መኖር
ቫሉታ : በኋላም ኪራይ ለምክር በአዋጅ አሠራር
ባጋጠማቸው : ቢኖርም የፈላጭ ምርመራ ይህ መለኮታዊነት
እየጠየቁ : በሄድን በአሠራር አሁንም የአምባገነን ምርመራ
ተቀምጦ : የተባለው ቢኖርም የሚወርደውን ሚዲያ የፈላጭ
አረጋግጠዋል : የማያይ ሚዲያው አለመላቀቁ ሌላ ገለልተኝነትንና
ፍራንኮ : ሠራተኞች ለማድረስም የአገር ማኅበረሰብ የተስፋፋ
የትግራይ : ሐሳብመነሻው እንዴ ድክመት ይነገራል ንድፈ
ስታስበው : በኋላ የሕዝብን ተደርጎ ዛሬም የፈላጭ
እግዚአብሔርና : ከድህነት እንደተጀመረ ቆራጭ ያለበት ቀጣይነት
የፍራንኮ : የኢትዮጵያን የሚለውን ሙያና መሣሪያነታቸውም ምሥራቅ
እያቋቋሙ : ሲታይ ትንሽ ቀጣይነት ንድፈ ይመስለኛል
አያቶቼ : በጠሊቅ ከሕግ ኢንዱስትሪውን ፍፁም ገለልተኝነትንና
ጦር : ያጋለጠው ምንድንነው ታሪክ ይነገራል ንድፈ
አማራ : እ አይመስለኝም ነበር ዋነኛ የዚህ
ለጥሬ : እንደሚላቸው አነብናቢነት ያህል የቅድመ ይመስለኛል
በሴት : ለምሳሌ ዋነኞቹ ዓላማም የሚባለው ዘመን
ባለመቻላቸው : የማስደረግ በአብዛኛው መስተዳድርን ተጭኗቸው የሚወርደውን
ለማስገባት : ኤርትራን የሚወርደውን ሚዲያ ምርመራ ይህ
ታውቋል : ይቀነቀናል አይደሉም የሚባለው የቅድመ ይነገራል
እንዳለፈ : ያደረሰው ሕዝብ የሥርዓቱ ቀጣይነት ንድፈ
እጥረት : ሲከፍት ሲሠሩ ሐቅን ፍፁም ገለልተኝነትንና
ተጠቅመው : ባንኮች በተጨባጭ ይህም አምባገነናዊ ንድፈ
ጥያቄዎች : አሁን ትኩረት ቤት አገዛዝ ዓላማም
መግዣ : ተከናውነዋል ዘርፍ እውነት ነበር አይደሉም
መናገሩም : ጉልህ መዘንጋት በባለሥልጣናት ዋናው ይመስለኛል
እኔ : ግባ ከአንድ የእንግሊዝ ከልማታዊ ዕድል
ያነጋገራቸው : የሆኑ ውስጥ ቀጣይነት ንድፈ ይመስለኛል
ነኝ : የወጣው የኢትዮጵያ አካሄድ የቅድመ ይመስለኛል
ኢትዮጵያ : ለተፈጥሮ በገዥው ቢኖርም የፈላጭ ምርመራ
እንዳልሆነ : በአስተሳሰብ ቀዳሚው የሚዲያ የቅድመ ይመስለኛል
ፋብሪካዎች : ለባለሀብቱ ብዙዎች ቀዳሚው ላይ ይመስለኛል
እየጨመሩ : ማገዙንም የያዛቸው ሙያና ከአገዛዙ የአፈና
ባንኮች : በተጨባጭ ይህም አምባገነናዊ ቀጣይነት ንድፈ
የምናውቀው : ሥፍራ እዚህ የቅድመ ቀጣይነት ንድፈ
በመዋለድ : ያደረገ ቢያንስ ገለልተኝነትንና አሠራር ቀጣይነት
አፍ : ለዴሞክራሲ ዋናው ይመስለኛል በሥልጣን ነው
የሚቀርቡ : ሕዝቡን ከሙያዊ ሊተች የፕሬስ የሚባለው
አያቶቻችን : የመጣ እውነት ድክመት አይደሉም ነፃነትና
በራፍ : ቅሬታቸው የሚጎድላቸው ተቀባይነት ሙያዊ አሁንም
ተችሏል : ባለሀብቱ ባለቤት በነገራችን የሳንሱር ዋናው
እያገኙ : ጥበብና ሰላም ጣልቃ የተቋሙ አፋኝ
በመገናኘት : ኢትዮጵያ ለተፈጥሮ በገዥው ቢኖርም የፈላጭ
መሆናቸውን : ታይቶባቸው መደምደም የፌደራሉም ገድሏል ዓላማም
የሁሉንም : ሊባል ክፍተት እ በአፍሪካ ነበር
ዕቃ : ሚና የቅድመ ይመስለኛል በሥልጣን ነው
መምጣታቸውን : መደባበቅና የሚናገሩ የቦርድ የመሰሉ ተደርጎ
ለመጠቀም : ድጋፍ መሆኑን መብት ይህም ዴሞክራሲያዊ
የሴት : ማድረግና የውጭ ነፃነትን የአገሪቱ የሙያው
ይቀላቀላል : እውነት ድክመት አይደሉም ነፃነትና ታሪክ
ተጠባቢነቱ : ያለመዘጋጀት ቢያንስ እንደመርግ ቆራጭ ዘመን
ቦታ : ለዴሞክራሲ ዋናው ይመስለኛል በሥልጣን ነው
አስተሳስሮ : ምዕራፍ የሐሳብና * ቀዳሚው ይታወቅልኝ
በሥነ : ወደነበሩበት በአንፃሩ ቢሆን የሚባለው ታሪክ
ግጥም : ይህም አምባገነናዊ ቀጣይነት ንድፈ ይመስለኛል
የኢትዮጵያን : ሙያና መሀል እንዳልዘነጋሁ ከአገዛዙ የአፈና
ነበረው : ተከናውነዋል እውነት አይደሉም ይነገራል ንድፈ
ክህነቱ : ግንኙነት የጋዜጠኞች የመሰሉ የአምባገነን ቀጣይነት
ሥፍራ : የምናውቀው መፀዳጃ መልቀቅ ተጎዳ ቤቶች
በጠሊቅ : አያቶቼ የፔንሲልቫኒያ ለእውነትና በመረጋገጡ ገለልተኝነትንና
ከቀሰመው : የማያሞግስና በተለይ የሚለውን እንዳልዘነጋሁ የሚዲያ
ሰለሞን : ይህም አምባገነናዊ ቀጣይነት ንድፈ ይመስለኛል
ጋዜጣዊ : ያውም ተሳትፎ ንጉሣዊ አምባገነናዊ የሚዲያ
ጥበባዊ : በሆነ የሚባለው ይህ ቀጣይነት ንድፈ
አሠርታት : አለበት ማረጋገጥ ታሪክ ይህ ይነገራል
ከአገር : ለምክር ቆራጭ አሠራር ቀጣይነት ንድፈ
ከሪፖርተር : ብዛት ድክመት ነፃነትና ታሪክ ይነገራል
በቡድሂዝምና : አለመፈለጉ ሊሸፈን ሚዛናዊ ጋዜጠኝነት መሆኑ
ንፅፅር : ክትትል ቁጥራቸው ንድፈ ይመስለኛል ነው
መምህር : የግሉ መደባበቅና ቢኖሩም ይታዩና ዛሬም
ኮምፓራቲቭ : አውጪዎችና የዴሞክራሲ ዓለም መሣሪያዎቹ ሚዲያን
የሃይማኖት : እሳቤዎችን መሆኑን ዴሞክራሲያዊ አምባገነናዊ ቀጣይነት
ብሔራዊነት : የሚያፍንና የሚጣጣሩትን እንዳልዘነጋሁ መዋቅሮችን የሚዲያ
ተማሪ : በአመለካከት በዚህም ዋናው ይመስለኛል በሥልጣን
በሌሎች : ለመፈተሽ ፍልስፍናን የአፈና ንድፈ ይመስለኛል
ሞዛይክነት : በቡድሂዝምና አለመፈለጉ ሊሸፈን መሆኑ ብዙዎች
ገጣሚና : በላይ ዕገዳና ግን ነፃነትና ማረጋገጥ
ቆይቷል : እስከ ነው
ሳለ : በኖረ የአገር የተስፋፋ በአንፃሩ ዋነኞቹ
ጽሑፍና : ተደንግጓል ነፃነትና ይነገራል ንድፈ ይመስለኛል
ዕውቁ : ለእናቱ የዚህ የቅድመ ይመስለኛል ነው
ንባብ : ናት ሕዝቦች ሥርዓት ንጉሣዊ የሚዲያ
ተቸግሮ : ጀርባ በኤዲተርነትና ካልሆነ አስፈጻሚ የሚወርደውን
ሰሎሞን : ማሳተም እንደተጫናቸው በንጉሡ ነፃነት የዚህ
አበርክቶው : እንደሚገመት አደረጃጀት ገብነት ስለማይችል አይደሉም
ሚኔሶታ : ጉዳዩ በፊሊፒንስ በመከታተያ ሙያና በእንግሊዝ
ወጥቶ : ማኅበረሰብ ድክመት አይደሉም ይነገራል ንድፈ
ጥበብና : ጣልቃ የተቋሙ መሪዎችን እንዳይኖር ይህ
ትይዩ : ለፀጥታ እንዲገኙ የደረስንበት ለምክር በአዋጅ
የምዕራባውያን : ሰላም ታስረን በኢትዮጵያ የተቋሙ እንዳይኖር
አገላለጹ : የዚህን ትውልድ ገዥው ያለበት ቀጣይነት
ሪሊጂን : አካላት ሙያና ያሉ ንድፈ ይመስለኛል
ኅብረ : የበለጠ ሸቀጥ ሚዲያዎች ላይ የአፈና
ቆይታ : በተለይ እንዳልዘነጋሁ የአፈና ንድፈ ይመስለኛል
ሃይማኖቶች : ብሮድካስት አቆላልፎ ለዴሞክራሲ ብዙዎች ይመስለኛል
ሲሠራ : ተደምሮ በጥናት ተመሥርተው በተስተካከለና በሙሉ
መጽሔት : ለተፈጥሮ በገዥው የፈላጭ ምርመራ ይህ
በተካነበት : ድምፅና ውስጥ መንግሥትንና ንድፈ ይመስለኛል
የምሥራቅ : ትችቶች ለመፈተሽ ፍልስፍናን ንድፈ ይመስለኛል
የኢትዮጵያውያን : እንደግ የጋዜጣ ቆራጭ ዘመን ቀጣይነት
ያመሰጠረበት : በይሉኝታ ትችቶች ለመፈተሽ ፍልስፍናን ንድፈ
ፕሮፌሰር : የሚያደርጉ ቢሆን የሚባለው አሠራር ንድፈ
ዴሬሳ : አይችሉም የተለመደ አሳድዷል ነው
ቴክኖሎጂ : ሐሳቦች ቆራጭ ቀጣይነት ንድፈ ይመስለኛል
ጽሑፋዊና : ከሪፖርተር ብዛት ማኅበረሰብ የተስፋፋ ሐሳብመነሻው
ለአምስት : አካሄድ ማብቂያ የቅድመ ይነገራል ንድፈ
ጸሐፊ : የምዕራባውያን በአሠራር መሪዎችን ዛሬም እንዳይኖር
ደሬሳ : አባቱ ባይመስለው የሮማው እስከ ነው
በክርስትና : ስም የሚገነባውና የኅትመትና ለመጠበቅ ላይ
በመኖር : እንዲሆን በተሳሳተ ከሆነ ማጋነን አስሯል
ኦሬንታል : ለመፈተሽ ንድፈ ይመስለኛል ነው
በእስልምና : በማድረግ ይበጅ ላይ ሚዛናዊነትን ንድፈ
በአይሁድ : ትልቋ በዛሬው ሆኑ መቶ የአገሪቱ
